CODREG;REG;CODDEP;CODARR;CODCAN;CODCOM;COM;PMUN;PCAP;PTOT
84;Auvergne-Rhône-Alpes;01;2;08;001;L'Abergement-Clémenciat;771;18;789
84;Auvergne-Rhône-Alpes;01;1;01;002;L'Abergement-de-Varey;253;1;254
84;Auvergne-Rhône-Alpes;01;1;01;004;Ambérieu-en-Bugey;14204;382;14586
84;Auvergne-Rhône-Alpes;01;2;22;005;Ambérieux-en-Dombes;1720;24;1744
84;Auvergne-Rhône-Alpes;01;1;04;006;Ambléon;112;6;118
84;Auvergne-Rhône-Alpes;01;1;01;007;Ambronay;2763;115;2878
84;Auvergne-Rhône-Alpes;01;1;01;008;Ambutrix;755;15;770
84;Auvergne-Rhône-Alpes;01;1;04;009;Andert-et-Condon;324;9;333
84;Auvergne-Rhône-Alpes;01;1;10;010;Anglefort;1113;17;1130
84;Auvergne-Rhône-Alpes;01;4;14;011;Apremont;373;11;384
84;Auvergne-Rhône-Alpes;01;1;10;012;Aranc;329;4;333
84;Auvergne-Rhône-Alpes;01;1;01;013;Arandas;144;4;148
84;Auvergne-Rhône-Alpes;01;4;15;014;Arbent;3356;93;3449
84;Auvergne-Rhône-Alpes;01;2;17;016;Arbigny;461;9;470
84;Auvergne-Rhône-Alpes;01;1;04;015;Arboys en Bugey;647;17;664
84;Auvergne-Rhône-Alpes;01;1;01;017;Argis;450;16;466
84;Auvergne-Rhône-Alpes;01;1;10;019;Armix;27;4;31
84;Auvergne-Rhône-Alpes;01;2;22;021;Ars-sur-Formans;1427;28;1455
84;Auvergne-Rhône-Alpes;01;1;10;022;Artemare;1244;18;1262
84;Auvergne-Rhône-Alpes;01;1;10;453;Arvière-en-Valromey ;709;22;731
84;Auvergne-Rhône-Alpes;01;2;17;023;Asnières-sur-Saône;71;0;71
84;Auvergne-Rhône-Alpes;01;2;02;024;Attignat;3196;63;3259
84;Auvergne-Rhône-Alpes;01;2;17;025;Bâgé-Dommartin;4078;107;4185
84;Auvergne-Rhône-Alpes;01;2;17;026;Bâgé-le-Châtel;948;64;1012
84;Auvergne-Rhône-Alpes;01;2;12;027;Balan;2513;52;2565
84;Auvergne-Rhône-Alpes;01;2;22;028;Baneins;610;17;627
84;Auvergne-Rhône-Alpes;01;4;14;170;Béard-Géovreissiat;1064;28;1092
84;Auvergne-Rhône-Alpes;01;2;18;029;Beaupont;687;8;695
84;Auvergne-Rhône-Alpes;01;2;21;030;Beauregard;848;15;863
84;Auvergne-Rhône-Alpes;01;2;12;032;Béligneux;3351;29;3380
84;Auvergne-Rhône-Alpes;01;1;04;034;Belley;9122;398;9520
84;Auvergne-Rhône-Alpes;01;4;14;035;Belleydoux;312;8;320
84;Auvergne-Rhône-Alpes;01;4;14;031;Bellignat;3632;233;3865
84;Auvergne-Rhône-Alpes;01;1;11;037;Bénonces;302;4;306
84;Auvergne-Rhône-Alpes;01;2;18;038;Bény;753;21;774
84;Auvergne-Rhône-Alpes;01;1;10;039;Béon;443;8;451
84;Auvergne-Rhône-Alpes;01;2;02;040;Béréziat;491;10;501
84;Auvergne-Rhône-Alpes;01;1;01;041;Bettant;745;21;766
84;Auvergne-Rhône-Alpes;01;2;23;042;Bey;281;13;294
84;Auvergne-Rhône-Alpes;01;2;13;043;Beynost;4684;111;4795
84;Auvergne-Rhône-Alpes;01;4;03;044;Billiat;632;15;647
84;Auvergne-Rhône-Alpes;01;2;22;045;Birieux;281;4;285
84;Auvergne-Rhône-Alpes;01;2;23;046;Biziat;884;8;892
84;Auvergne-Rhône-Alpes;01;1;11;047;Blyes;1094;29;1123
84;Auvergne-Rhône-Alpes;01;2;18;245;Bohas-Meyriat-Rignat;930;21;951
84;Auvergne-Rhône-Alpes;01;2;13;049;La Boisse;3230;72;3302
84;Auvergne-Rhône-Alpes;01;2;17;050;Boissey;351;4;355
84;Auvergne-Rhône-Alpes;01;4;16;051;Bolozon;91;1;92
84;Auvergne-Rhône-Alpes;01;2;22;052;Bouligneux;328;6;334
84;Auvergne-Rhône-Alpes;01;2;99;053;Bourg-en-Bresse;41248;1758;43006
84;Auvergne-Rhône-Alpes;01;1;12;054;Bourg-Saint-Christophe;1407;31;1438
84;Auvergne-Rhône-Alpes;01;4;16;056;Boyeux-Saint-Jérôme;346;5;351
84;Auvergne-Rhône-Alpes;01;2;17;057;Boz;523;16;539
84;Auvergne-Rhône-Alpes;01;1;04;058;Brégnier-Cordon;836;21;857
84;Auvergne-Rhône-Alpes;01;4;10;060;Brénod;500;21;521
84;Auvergne-Rhône-Alpes;01;1;04;061;Brens;1155;36;1191
84;Auvergne-Rhône-Alpes;01;2;02;130;Bresse Vallons ;2307;44;2351
84;Auvergne-Rhône-Alpes;01;2;12;062;Bressolles;931;22;953
84;Auvergne-Rhône-Alpes;01;4;14;063;Brion;531;7;538
84;Auvergne-Rhône-Alpes;01;1;11;064;Briord;1045;19;1064
84;Auvergne-Rhône-Alpes;01;2;02;065;Buellas;1797;63;1860
84;Auvergne-Rhône-Alpes;01;1;04;066;La Burbanche;83;1;84
84;Auvergne-Rhône-Alpes;01;4;16;067;Ceignes;254;13;267
84;Auvergne-Rhône-Alpes;01;4;16;068;Cerdon;779;16;795
84;Auvergne-Rhône-Alpes;01;2;07;069;Certines;1502;40;1542
84;Auvergne-Rhône-Alpes;01;3;09;071;Cessy;4843;117;4960
84;Auvergne-Rhône-Alpes;01;2;07;072;Ceyzériat;3177;61;3238
84;Auvergne-Rhône-Alpes;01;1;04;073;Ceyzérieu;1003;25;1028
84;Auvergne-Rhône-Alpes;01;2;07;074;Chalamont;2529;35;2564
84;Auvergne-Rhône-Alpes;01;2;22;075;Chaleins;1361;30;1391
84;Auvergne-Rhône-Alpes;01;1;10;076;Chaley;127;3;130
84;Auvergne-Rhône-Alpes;01;4;16;077;Challes-la-Montagne;192;3;195
84;Auvergne-Rhône-Alpes;01;3;20;078;Challex;1518;33;1551
84;Auvergne-Rhône-Alpes;01;1;10;079;Champagne-en-Valromey;816;31;847
84;Auvergne-Rhône-Alpes;01;1;10;080;Champdor-Corcelles;643;14;657
84;Auvergne-Rhône-Alpes;01;4;03;081;Champfromier;732;21;753
84;Auvergne-Rhône-Alpes;01;4;03;082;Chanay;627;14;641
84;Auvergne-Rhône-Alpes;01;2;22;083;Chaneins;912;17;929
84;Auvergne-Rhône-Alpes;01;2;23;084;Chanoz-Châtenay;868;18;886
84;Auvergne-Rhône-Alpes;01;2;08;085;La Chapelle-du-Châtelard;394;5;399
84;Auvergne-Rhône-Alpes;01;4;14;087;Charix;281;10;291
84;Auvergne-Rhône-Alpes;01;1;11;088;Charnoz-sur-Ain;904;27;931
84;Auvergne-Rhône-Alpes;01;1;01;089;Château-Gaillard;2195;49;2244
84;Auvergne-Rhône-Alpes;01;2;07;090;Châtenay;348;6;354
84;Auvergne-Rhône-Alpes;01;2;07;092;Châtillon-la-Palud;1594;63;1657
84;Auvergne-Rhône-Alpes;01;2;08;093;Châtillon-sur-Chalaronne;4881;202;5083
84;Auvergne-Rhône-Alpes;01;2;17;094;Chavannes-sur-Reyssouze;755;12;767
84;Auvergne-Rhône-Alpes;01;2;23;096;Chaveyriat;1011;29;1040
84;Auvergne-Rhône-Alpes;01;1;04;098;Chazey-Bons;1144;37;1181
84;Auvergne-Rhône-Alpes;01;1;11;099;Chazey-sur-Ain;1542;56;1598
84;Auvergne-Rhône-Alpes;01;1;04;100;Cheignieu-la-Balme;133;4;137
84;Auvergne-Rhône-Alpes;01;4;10;101;Chevillard;151;7;158
84;Auvergne-Rhône-Alpes;01;2;17;102;Chevroux;947;15;962
84;Auvergne-Rhône-Alpes;01;3;20;103;Chevry;1980;43;2023
84;Auvergne-Rhône-Alpes;01;3;20;104;Chézery-Forens;463;10;473
84;Auvergne-Rhône-Alpes;01;2;22;105;Civrieux;1755;54;1809
84;Auvergne-Rhône-Alpes;01;2;18;106;Cize;176;7;183
84;Auvergne-Rhône-Alpes;01;1;01;107;Cleyzieu;135;4;139
84;Auvergne-Rhône-Alpes;01;2;18;108;Coligny;1178;24;1202
84;Auvergne-Rhône-Alpes;01;3;20;109;Collonges;2222;46;2268
84;Auvergne-Rhône-Alpes;01;1;04;110;Colomieu;148;2;150
84;Auvergne-Rhône-Alpes;01;1;01;111;Conand;128;1;129
84;Auvergne-Rhône-Alpes;01;4;10;112;Condamine;432;18;450
84;Auvergne-Rhône-Alpes;01;2;08;113;Condeissiat;820;12;832
84;Auvergne-Rhône-Alpes;01;4;03;114;Confort;657;12;669
84;Auvergne-Rhône-Alpes;01;2;02;115;Confrançon;1337;30;1367
84;Auvergne-Rhône-Alpes;01;1;04;116;Contrevoz;499;11;510
84;Auvergne-Rhône-Alpes;01;1;04;117;Conzieu;149;2;151
84;Auvergne-Rhône-Alpes;01;1;10;118;Corbonod;1270;32;1302
84;Auvergne-Rhône-Alpes;01;1;10;121;Corlier;116;1;117
84;Auvergne-Rhône-Alpes;01;2;23;123;Cormoranche-sur-Saône;1154;35;1189
84;Auvergne-Rhône-Alpes;01;2;18;124;Cormoz;677;8;685
84;Auvergne-Rhône-Alpes;01;2;18;125;Corveissiat;616;13;629
84;Auvergne-Rhône-Alpes;01;2;18;127;Courmangoux;508;8;516
84;Auvergne-Rhône-Alpes;01;2;17;128;Courtes;309;1;310
84;Auvergne-Rhône-Alpes;01;2;07;129;Crans;278;6;284
84;Auvergne-Rhône-Alpes;01;1;04;133;Cressin-Rochefort;393;6;399
84;Auvergne-Rhône-Alpes;01;2;23;134;Crottet;1739;45;1784
84;Auvergne-Rhône-Alpes;01;3;20;135;Crozet;2149;63;2212
84;Auvergne-Rhône-Alpes;01;2;23;136;Cruzilles-lès-Mépillat;880;20;900
84;Auvergne-Rhône-Alpes;01;1;10;138;Culoz;3020;65;3085
84;Auvergne-Rhône-Alpes;01;2;17;139;Curciat-Dongalon;442;5;447
84;Auvergne-Rhône-Alpes;01;2;02;140;Curtafond;771;19;790
84;Auvergne-Rhône-Alpes;01;1;04;141;Cuzieu;449;15;464
84;Auvergne-Rhône-Alpes;01;2;12;142;Dagneux;4769;57;4826
84;Auvergne-Rhône-Alpes;01;3;09;143;Divonne-les-Bains;9787;235;10022
84;Auvergne-Rhône-Alpes;01;2;08;146;Dompierre-sur-Chalaronne;435;4;439
84;Auvergne-Rhône-Alpes;01;2;07;145;Dompierre-sur-Veyle;1169;21;1190
84;Auvergne-Rhône-Alpes;01;2;18;147;Domsure;489;3;492
84;Auvergne-Rhône-Alpes;01;4;16;148;Dortan;1854;46;1900
84;Auvergne-Rhône-Alpes;01;1;01;149;Douvres;1059;27;1086
84;Auvergne-Rhône-Alpes;01;2;18;150;Drom;215;5;220
84;Auvergne-Rhône-Alpes;01;2;07;151;Druillat;1152;27;1179
84;Auvergne-Rhône-Alpes;01;4;14;152;Échallon;750;20;770
84;Auvergne-Rhône-Alpes;01;3;20;153;Échenevex;2092;72;2164
84;Auvergne-Rhône-Alpes;01;1;10;155;Évosges;144;4;148
84;Auvergne-Rhône-Alpes;01;1;12;156;Faramans;810;12;822
84;Auvergne-Rhône-Alpes;01;2;22;157;Fareins;2213;41;2254
84;Auvergne-Rhône-Alpes;01;3;20;158;Farges;1043;17;1060
84;Auvergne-Rhône-Alpes;01;2;17;159;Feillens;3328;70;3398
84;Auvergne-Rhône-Alpes;01;3;19;160;Ferney-Voltaire;9895;161;10056
84;Auvergne-Rhône-Alpes;01;1;04;162;Flaxieu;66;3;69
84;Auvergne-Rhône-Alpes;01;2;02;163;Foissiat;2061;36;2097
84;Auvergne-Rhône-Alpes;01;2;22;165;Francheleins;1603;33;1636
84;Auvergne-Rhône-Alpes;01;2;21;166;Frans;2422;60;2482
84;Auvergne-Rhône-Alpes;01;2;08;167;Garnerans;639;25;664
84;Auvergne-Rhône-Alpes;01;2;08;169;Genouilleux;624;21;645
84;Auvergne-Rhône-Alpes;01;4;14;171;Géovreisset;856;42;898
84;Auvergne-Rhône-Alpes;01;3;09;173;Gex;13093;269;13362
84;Auvergne-Rhône-Alpes;01;4;03;174;Giron;180;2;182
84;Auvergne-Rhône-Alpes;01;2;17;175;Gorrevod;809;24;833
84;Auvergne-Rhône-Alpes;01;2;18;177;Grand-Corent;180;6;186
84;Auvergne-Rhône-Alpes;01;2;23;179;Grièges;1879;52;1931
84;Auvergne-Rhône-Alpes;01;3;09;180;Grilly;836;21;857
84;Auvergne-Rhône-Alpes;01;4;14;181;Groissiat;1235;51;1286
84;Auvergne-Rhône-Alpes;01;1;89;338;Groslée-Saint-Benoit;1203;36;1239
84;Auvergne-Rhône-Alpes;01;2;08;183;Guéreins;1448;28;1476
84;Auvergne-Rhône-Alpes;01;1;10;187;Haut Valromey;643;22;665
84;Auvergne-Rhône-Alpes;01;2;18;184;Hautecourt-Romanèche;770;25;795
84;Auvergne-Rhône-Alpes;01;2;08;188;Illiat;645;19;664
84;Auvergne-Rhône-Alpes;01;4;03;189;Injoux-Génissiat;1125;26;1151
84;Auvergne-Rhône-Alpes;01;1;11;190;Innimond;88;3;91
84;Auvergne-Rhône-Alpes;01;4;10;191;Izenave;157;4;161
84;Auvergne-Rhône-Alpes;01;4;16;192;Izernore;2255;61;2316
84;Auvergne-Rhône-Alpes;01;1;04;193;Izieu;229;7;236
84;Auvergne-Rhône-Alpes;01;2;21;194;Jassans-Riottier;6356;93;6449
84;Auvergne-Rhône-Alpes;01;2;18;195;Jasseron;1770;53;1823
84;Auvergne-Rhône-Alpes;01;2;02;196;Jayat;1196;12;1208
84;Auvergne-Rhône-Alpes;01;2;07;197;Journans;353;13;366
84;Auvergne-Rhône-Alpes;01;1;12;198;Joyeux;268;3;271
84;Auvergne-Rhône-Alpes;01;4;16;199;Jujurieux;2132;47;2179
84;Auvergne-Rhône-Alpes;01;4;16;200;Labalme;215;5;220
84;Auvergne-Rhône-Alpes;01;1;11;202;Lagnieu;7175;147;7322
84;Auvergne-Rhône-Alpes;01;2;23;203;Laiz;1313;42;1355
84;Auvergne-Rhône-Alpes;01;4;10;206;Lantenay;277;6;283
84;Auvergne-Rhône-Alpes;01;2;22;207;Lapeyrouse;316;12;328
84;Auvergne-Rhône-Alpes;01;1;04;208;Lavours;128;4;132
84;Auvergne-Rhône-Alpes;01;3;20;209;Léaz;758;16;774
84;Auvergne-Rhône-Alpes;01;3;20;210;Lélex;229;4;233
84;Auvergne-Rhône-Alpes;01;2;07;211;Lent;1393;35;1428
84;Auvergne-Rhône-Alpes;01;2;17;212;Lescheroux;725;9;734
84;Auvergne-Rhône-Alpes;01;1;11;213;Leyment;1321;28;1349
84;Auvergne-Rhône-Alpes;01;4;16;214;Leyssard;155;6;161
84;Auvergne-Rhône-Alpes;01;1;11;216;Lhuis;891;21;912
84;Auvergne-Rhône-Alpes;01;1;11;219;Lompnas;166;3;169
84;Auvergne-Rhône-Alpes;01;1;11;224;Loyettes;3176;31;3207
84;Auvergne-Rhône-Alpes;01;2;22;225;Lurcy;378;8;386
84;Auvergne-Rhône-Alpes;01;1;04;227;Magnieu;643;14;657
84;Auvergne-Rhône-Alpes;01;4;14;228;Maillat;648;14;662
84;Auvergne-Rhône-Alpes;01;2;02;229;Malafretaz;1243;24;1267
84;Auvergne-Rhône-Alpes;01;2;17;230;Mantenay-Montlin;315;7;322
84;Auvergne-Rhône-Alpes;01;2;17;231;Manziat;1949;48;1997
84;Auvergne-Rhône-Alpes;01;2;18;232;Marboz;2258;46;2304
84;Auvergne-Rhône-Alpes;01;1;11;233;Marchamp;131;3;134
84;Auvergne-Rhône-Alpes;01;1;04;234;Marignieu;170;3;173
84;Auvergne-Rhône-Alpes;01;2;08;235;Marlieux;1139;86;1225
84;Auvergne-Rhône-Alpes;01;2;02;236;Marsonnas;1001;29;1030
84;Auvergne-Rhône-Alpes;01;4;14;237;Martignat;1647;64;1711
84;Auvergne-Rhône-Alpes;01;2;21;238;Massieux;2632;55;2687
84;Auvergne-Rhône-Alpes;01;1;04;239;Massignieu-de-Rives;617;14;631
84;Auvergne-Rhône-Alpes;01;4;16;240;Matafelon-Granges;633;16;649
84;Auvergne-Rhône-Alpes;01;2;18;241;Meillonnas;1345;34;1379
84;Auvergne-Rhône-Alpes;01;4;16;242;Mérignat;135;2;137
84;Auvergne-Rhône-Alpes;01;2;22;243;Messimy-sur-Saône;1239;35;1274
84;Auvergne-Rhône-Alpes;01;1;12;244;Meximieux;7848;137;7985
84;Auvergne-Rhône-Alpes;01;2;23;246;Mézériat;2195;36;2231
84;Auvergne-Rhône-Alpes;01;3;20;247;Mijoux;325;14;339
84;Auvergne-Rhône-Alpes;01;2;22;248;Mionnay;2148;53;2201
84;Auvergne-Rhône-Alpes;01;2;13;249;Miribel;10043;150;10193
84;Auvergne-Rhône-Alpes;01;2;21;250;Misérieux;1944;251;2195
84;Auvergne-Rhône-Alpes;01;2;08;252;Mogneneins;782;22;804
84;Auvergne-Rhône-Alpes;01;2;07;254;Montagnat;2024;49;2073
84;Auvergne-Rhône-Alpes;01;1;11;255;Montagnieu;634;12;646
84;Auvergne-Rhône-Alpes;01;4;03;257;Montanges;348;10;358
84;Auvergne-Rhône-Alpes;01;2;08;258;Montceaux;1188;33;1221
84;Auvergne-Rhône-Alpes;01;2;02;259;Montcet;697;16;713
84;Auvergne-Rhône-Alpes;01;1;12;260;Le Montellier;299;5;304
84;Auvergne-Rhône-Alpes;01;2;22;261;Monthieux;643;22;665
84;Auvergne-Rhône-Alpes;01;2;12;262;Montluel;6925;85;7010
84;Auvergne-Rhône-Alpes;01;2;08;263;Montmerle-sur-Saône;3783;88;3871
84;Auvergne-Rhône-Alpes;01;2;02;264;Montracol;1028;20;1048
84;Auvergne-Rhône-Alpes;01;4;14;265;Montréal-la-Cluse;3419;71;3490
84;Auvergne-Rhône-Alpes;01;2;02;266;Montrevel-en-Bresse;2515;41;2556
84;Auvergne-Rhône-Alpes;01;1;04;268;Murs-et-Gélignieux;249;3;252
84;Auvergne-Rhône-Alpes;01;4;14;269;Nantua;3410;134;3544
84;Auvergne-Rhône-Alpes;01;2;08;272;Neuville-les-Dames;1510;20;1530
84;Auvergne-Rhône-Alpes;01;4;16;273;Neuville-sur-Ain;1772;26;1798
84;Auvergne-Rhône-Alpes;01;4;14;274;Les Neyrolles;642;15;657
84;Auvergne-Rhône-Alpes;01;2;13;275;Neyron;2549;49;2598
84;Auvergne-Rhône-Alpes;01;2;13;276;Niévroz;1624;27;1651
84;Auvergne-Rhône-Alpes;01;2;18;095;Nivigne et Suran ;818;11;829
84;Auvergne-Rhône-Alpes;01;1;01;277;Nivollet-Montgriffon;119;2;121
84;Auvergne-Rhône-Alpes;01;4;16;267;Nurieux-Volognat;1027;23;1050
84;Auvergne-Rhône-Alpes;01;1;01;279;Oncieu;84;6;90
84;Auvergne-Rhône-Alpes;01;1;11;280;Ordonnaz;139;1;140
84;Auvergne-Rhône-Alpes;01;3;19;281;Ornex;4419;167;4586
84;Auvergne-Rhône-Alpes;01;4;10;282;Outriaz;259;6;265
84;Auvergne-Rhône-Alpes;01;4;15;283;Oyonnax;22336;472;22808
84;Auvergne-Rhône-Alpes;01;2;17;284;Ozan;689;13;702
84;Auvergne-Rhône-Alpes;01;2;21;285;Parcieux;1221;29;1250
84;Auvergne-Rhône-Alpes;01;1;04;286;Parves et Nattages;946;38;984
84;Auvergne-Rhône-Alpes;01;3;20;288;Péron;2701;54;2755
84;Auvergne-Rhône-Alpes;01;2;06;289;Péronnas;6509;291;6800
84;Auvergne-Rhône-Alpes;01;1;12;290;Pérouges;1259;32;1291
84;Auvergne-Rhône-Alpes;01;2;23;291;Perrex;842;7;849
84;Auvergne-Rhône-Alpes;01;4;16;293;Peyriat;152;4;156
84;Auvergne-Rhône-Alpes;01;1;04;294;Peyrieu;879;16;895
84;Auvergne-Rhône-Alpes;01;2;08;295;Peyzieux-sur-Saône;676;13;689
84;Auvergne-Rhône-Alpes;01;2;18;296;Pirajoux;413;7;420
84;Auvergne-Rhône-Alpes;01;2;12;297;Pizay;843;15;858
84;Auvergne-Rhône-Alpes;01;4;03;298;Plagne;141;2;143
84;Auvergne-Rhône-Alpes;01;2;07;299;Le Plantay;569;8;577
84;Auvergne-Rhône-Alpes;01;1;10;185;Plateau d'Hauteville ;4856;177;5033
84;Auvergne-Rhône-Alpes;01;4;14;204;Le Poizat-Lalleyriat;729;15;744
84;Auvergne-Rhône-Alpes;01;2;02;301;Polliat;2526;60;2586
84;Auvergne-Rhône-Alpes;01;1;04;302;Pollieu;161;5;166
84;Auvergne-Rhône-Alpes;01;4;16;303;Poncin;1706;36;1742
84;Auvergne-Rhône-Alpes;01;4;16;304;Pont-d'Ain;2944;54;2998
84;Auvergne-Rhône-Alpes;01;2;17;305;Pont-de-Vaux;2235;43;2278
84;Auvergne-Rhône-Alpes;01;2;23;306;Pont-de-Veyle;1632;64;1696
84;Auvergne-Rhône-Alpes;01;4;14;307;Port;842;21;863
84;Auvergne-Rhône-Alpes;01;3;20;308;Pougny;810;15;825
84;Auvergne-Rhône-Alpes;01;2;18;309;Pouillat;86;0;86
84;Auvergne-Rhône-Alpes;01;1;04;310;Prémeyzel;250;4;254
84;Auvergne-Rhône-Alpes;01;1;10;311;Prémillieu;44;0;44
84;Auvergne-Rhône-Alpes;01;3;19;313;Prévessin-Moëns;8474;232;8706
84;Auvergne-Rhône-Alpes;01;4;16;314;Priay;1733;33;1766
84;Auvergne-Rhône-Alpes;01;2;18;317;Ramasse;327;6;333
84;Auvergne-Rhône-Alpes;01;2;22;318;Rancé;726;17;743
84;Auvergne-Rhône-Alpes;01;2;22;319;Relevant;464;9;473
84;Auvergne-Rhône-Alpes;01;2;17;320;Replonges;3748;90;3838
84;Auvergne-Rhône-Alpes;01;2;07;321;Revonnas;888;29;917
84;Auvergne-Rhône-Alpes;01;2;21;322;Reyrieux;4923;138;5061
84;Auvergne-Rhône-Alpes;01;2;17;323;Reyssouze;978;14;992
84;Auvergne-Rhône-Alpes;01;1;12;325;Rignieux-le-Franc;994;18;1012
84;Auvergne-Rhône-Alpes;01;2;08;328;Romans;589;4;593
84;Auvergne-Rhône-Alpes;01;1;04;329;Rossillon;149;6;155
84;Auvergne-Rhône-Alpes;01;1;10;330;Ruffieu;184;6;190
84;Auvergne-Rhône-Alpes;01;4;16;331;Saint-Alban;183;0;183
84;Auvergne-Rhône-Alpes;01;2;23;334;Saint-André-d'Huiriat;650;9;659
84;Auvergne-Rhône-Alpes;01;2;17;332;Saint-André-de-Bâgé;761;22;783
84;Auvergne-Rhône-Alpes;01;2;22;333;Saint-André-de-Corcy;3386;60;3446
84;Auvergne-Rhône-Alpes;01;2;08;335;Saint-André-le-Bouchoux;396;6;402
84;Auvergne-Rhône-Alpes;01;2;07;336;Saint-André-sur-Vieux-Jonc;1160;22;1182
84;Auvergne-Rhône-Alpes;01;2;17;337;Saint-Bénigne;1288;26;1314
84;Auvergne-Rhône-Alpes;01;2;21;339;Saint-Bernard;1432;42;1474
84;Auvergne-Rhône-Alpes;01;2;23;343;Saint-Cyr-sur-Menthon;1779;40;1819
84;Auvergne-Rhône-Alpes;01;1;01;345;Saint-Denis-en-Bugey;2288;34;2322
84;Auvergne-Rhône-Alpes;01;2;06;344;Saint-Denis-lès-Bourg;5845;165;6010
84;Auvergne-Rhône-Alpes;01;2;02;346;Saint-Didier-d'Aussiat;865;19;884
84;Auvergne-Rhône-Alpes;01;2;21;347;Saint-Didier-de-Formans;1997;62;2059
84;Auvergne-Rhône-Alpes;01;2;08;348;Saint-Didier-sur-Chalaronne;2918;64;2982
84;Auvergne-Rhône-Alpes;01;1;12;349;Saint-Éloi;476;5;481
84;Auvergne-Rhône-Alpes;01;2;18;350;Saint-Étienne-du-Bois;2537;40;2577
84;Auvergne-Rhône-Alpes;01;2;08;351;Saint-Étienne-sur-Chalaronne;1565;27;1592
84;Auvergne-Rhône-Alpes;01;2;17;352;Saint-Étienne-sur-Reyssouze;576;6;582
84;Auvergne-Rhône-Alpes;01;3;19;354;Saint-Genis-Pouilly;13243;191;13434
84;Auvergne-Rhône-Alpes;01;2;23;355;Saint-Genis-sur-Menthon;470;7;477
84;Auvergne-Rhône-Alpes;01;2;08;356;Saint-Georges-sur-Renon;209;5;214
84;Auvergne-Rhône-Alpes;01;4;03;357;Saint-Germain-de-Joux;501;7;508
84;Auvergne-Rhône-Alpes;01;1;04;358;Saint-Germain-les-Paroisses;431;3;434
84;Auvergne-Rhône-Alpes;01;2;08;359;Saint-Germain-sur-Renon;244;3;247
84;Auvergne-Rhône-Alpes;01;3;20;360;Saint-Jean-de-Gonville;1823;46;1869
84;Auvergne-Rhône-Alpes;01;1;11;361;Saint-Jean-de-Niost;1527;47;1574
84;Auvergne-Rhône-Alpes;01;2;22;362;Saint-Jean-de-Thurigneux;775;14;789
84;Auvergne-Rhône-Alpes;01;4;16;363;Saint-Jean-le-Vieux;1748;74;1822
84;Auvergne-Rhône-Alpes;01;2;17;364;Saint-Jean-sur-Reyssouze;750;7;757
84;Auvergne-Rhône-Alpes;01;2;23;365;Saint-Jean-sur-Veyle;1160;20;1180
84;Auvergne-Rhône-Alpes;01;2;17;367;Saint-Julien-sur-Reyssouze;748;4;752
84;Auvergne-Rhône-Alpes;01;2;23;368;Saint-Julien-sur-Veyle;836;15;851
84;Auvergne-Rhône-Alpes;01;2;07;369;Saint-Just;940;24;964
84;Auvergne-Rhône-Alpes;01;2;23;370;Saint-Laurent-sur-Saône;1689;28;1717
84;Auvergne-Rhône-Alpes;01;2;22;371;Saint-Marcel;1258;30;1288
84;Auvergne-Rhône-Alpes;01;1;04;372;Saint-Martin-de-Bavel;442;5;447
84;Auvergne-Rhône-Alpes;01;4;14;373;Saint-Martin-du-Frêne;1038;31;1069
84;Auvergne-Rhône-Alpes;01;2;07;374;Saint-Martin-du-Mont;1844;44;1888
84;Auvergne-Rhône-Alpes;01;2;02;375;Saint-Martin-le-Châtel;785;20;805
84;Auvergne-Rhône-Alpes;01;2;13;376;Saint-Maurice-de-Beynost;3977;39;4016
84;Auvergne-Rhône-Alpes;01;1;11;378;Saint-Maurice-de-Gourdans;2606;53;2659
84;Auvergne-Rhône-Alpes;01;1;01;379;Saint-Maurice-de-Rémens;758;11;769
84;Auvergne-Rhône-Alpes;01;2;17;380;Saint-Nizier-le-Bouchoux;651;14;665
84;Auvergne-Rhône-Alpes;01;2;07;381;Saint-Nizier-le-Désert;917;18;935
84;Auvergne-Rhône-Alpes;01;2;08;383;Saint-Paul-de-Varax;1555;21;1576
84;Auvergne-Rhône-Alpes;01;1;01;384;Saint-Rambert-en-Bugey;2228;34;2262
84;Auvergne-Rhône-Alpes;01;2;06;385;Saint-Rémy;990;23;1013
84;Auvergne-Rhône-Alpes;01;1;11;386;Saint-Sorlin-en-Bugey;1138;74;1212
84;Auvergne-Rhône-Alpes;01;2;02;387;Saint-Sulpice;257;3;260
84;Auvergne-Rhône-Alpes;01;2;17;388;Saint-Trivier-de-Courtes;1103;9;1112
84;Auvergne-Rhône-Alpes;01;2;22;389;Saint-Trivier-sur-Moignans;1843;43;1886
84;Auvergne-Rhône-Alpes;01;1;11;390;Saint-Vulbas;1266;21;1287
84;Auvergne-Rhône-Alpes;01;2;12;342;Sainte-Croix;561;11;572
84;Auvergne-Rhône-Alpes;01;2;21;353;Sainte-Euphémie;1676;27;1703
84;Auvergne-Rhône-Alpes;01;1;11;366;Sainte-Julie;1051;18;1069
84;Auvergne-Rhône-Alpes;01;2;22;382;Sainte-Olive;283;2;285
84;Auvergne-Rhône-Alpes;01;2;18;391;Salavre;267;8;275
84;Auvergne-Rhône-Alpes;01;4;16;392;Samognat;650;27;677
84;Auvergne-Rhône-Alpes;01;2;08;393;Sandrans;540;5;545
84;Auvergne-Rhône-Alpes;01;1;11;396;Sault-Brénaz;981;13;994
84;Auvergne-Rhône-Alpes;01;3;09;397;Sauverny;994;19;1013
84;Auvergne-Rhône-Alpes;01;2;22;398;Savigneux;1359;16;1375
84;Auvergne-Rhône-Alpes;01;3;20;399;Ségny;2089;50;2139
84;Auvergne-Rhône-Alpes;01;1;11;400;Seillonnaz;137;3;140
84;Auvergne-Rhône-Alpes;01;3;20;401;Sergy;2126;69;2195
84;Auvergne-Rhône-Alpes;01;2;17;402;Sermoyer;657;20;677
84;Auvergne-Rhône-Alpes;01;1;11;403;Serrières-de-Briord;1279;40;1319
84;Auvergne-Rhône-Alpes;01;4;16;404;Serrières-sur-Ain;134;2;136
84;Auvergne-Rhône-Alpes;01;2;07;405;Servas;1264;29;1293
84;Auvergne-Rhône-Alpes;01;2;17;406;Servignat;174;1;175
84;Auvergne-Rhône-Alpes;01;1;10;407;Seyssel;1000;18;1018
84;Auvergne-Rhône-Alpes;01;2;18;408;Simandre-sur-Suran;665;12;677
84;Auvergne-Rhône-Alpes;01;4;16;410;Sonthonnax-la-Montagne;306;7;313
84;Auvergne-Rhône-Alpes;01;1;11;411;Souclin;273;6;279
84;Auvergne-Rhône-Alpes;01;2;08;412;Sulignat;588;12;600
84;Auvergne-Rhône-Alpes;01;4;03;215;Surjoux-Lhopital ;137;3;140
84;Auvergne-Rhône-Alpes;01;1;10;415;Talissieu;475;6;481
84;Auvergne-Rhône-Alpes;01;1;10;416;Tenay;1026;11;1037
84;Auvergne-Rhône-Alpes;01;2;13;418;Thil;1081;27;1108
84;Auvergne-Rhône-Alpes;01;3;20;419;Thoiry;5981;174;6155
84;Auvergne-Rhône-Alpes;01;2;08;420;Thoissey;1715;8;1723
84;Auvergne-Rhône-Alpes;01;1;01;421;Torcieu;728;16;744
84;Auvergne-Rhône-Alpes;01;2;07;422;Tossiat;1359;36;1395
84;Auvergne-Rhône-Alpes;01;2;21;423;Toussieux;1114;20;1134
84;Auvergne-Rhône-Alpes;01;2;13;424;Tramoyes;1728;42;1770
84;Auvergne-Rhône-Alpes;01;2;07;425;La Tranclière;289;7;296
84;Auvergne-Rhône-Alpes;01;2;21;427;Trévoux;6882;162;7044
84;Auvergne-Rhône-Alpes;01;2;18;426;Val-Revermont;2570;59;2629
84;Auvergne-Rhône-Alpes;01;2;08;428;Valeins;128;1;129
84;Auvergne-Rhône-Alpes;01;1;10;036;Valromey-sur-Séran ;1320;19;1339
84;Auvergne-Rhône-Alpes;01;4;03;033;Valserhône ;16431;369;16800
84;Auvergne-Rhône-Alpes;01;2;02;429;Vandeins;689;13;702
84;Auvergne-Rhône-Alpes;01;4;16;430;Varambon;601;12;613
84;Auvergne-Rhône-Alpes;01;1;01;431;Vaux-en-Bugey;1221;30;1251
84;Auvergne-Rhône-Alpes;01;2;18;432;Verjon;311;2;313
84;Auvergne-Rhône-Alpes;01;2;17;433;Vernoux;320;4;324
84;Auvergne-Rhône-Alpes;01;2;07;434;Versailleux;455;10;465
84;Auvergne-Rhône-Alpes;01;3;09;435;Versonnex;2167;69;2236
84;Auvergne-Rhône-Alpes;01;3;09;436;Vesancy;475;11;486
84;Auvergne-Rhône-Alpes;01;2;17;437;Vescours;232;5;237
84;Auvergne-Rhône-Alpes;01;2;17;439;Vésines;99;4;103
84;Auvergne-Rhône-Alpes;01;4;10;441;Vieu-d'Izenave;713;17;730
84;Auvergne-Rhône-Alpes;01;2;22;443;Villars-les-Dombes;4962;95;5057
84;Auvergne-Rhône-Alpes;01;1;11;444;Villebois;1185;17;1202
84;Auvergne-Rhône-Alpes;01;2;18;445;Villemotier;636;22;658
84;Auvergne-Rhône-Alpes;01;2;22;446;Villeneuve;1521;36;1557
84;Auvergne-Rhône-Alpes;01;2;18;447;Villereversure;1308;33;1341
84;Auvergne-Rhône-Alpes;01;4;03;448;Villes;387;8;395
84;Auvergne-Rhône-Alpes;01;2;07;449;Villette-sur-Ain;757;14;771
84;Auvergne-Rhône-Alpes;01;1;11;450;Villieu-Loyes-Mollon;3684;67;3751
84;Auvergne-Rhône-Alpes;01;2;05;451;Viriat;6555;150;6705
84;Auvergne-Rhône-Alpes;01;1;04;452;Virieu-le-Grand;1107;23;1130
84;Auvergne-Rhône-Alpes;01;1;04;454;Virignin;1104;21;1125
84;Auvergne-Rhône-Alpes;01;1;04;456;Vongnes;71;2;73
84;Auvergne-Rhône-Alpes;01;2;23;457;Vonnas;3079;59;3138
32;Hauts-de-France;02;2;03;001;Abbécourt;500;11;511
32;Hauts-de-France;02;2;18;002;Achery;607;8;615
32;Hauts-de-France;02;4;17;003;Acy;1020;24;1044
32;Hauts-de-France;02;2;11;004;Agnicourt-et-Séchelles;180;5;185
32;Hauts-de-France;02;2;06;005;Aguilcourt;381;8;389
32;Hauts-de-France;02;5;07;006;Aisonville-et-Bernoville;258;9;267
32;Hauts-de-France;02;2;06;007;Aizelles;123;1;124
32;Hauts-de-France;02;4;05;008;Aizy-Jouy;293;4;297
32;Hauts-de-France;02;3;12;009;Alaincourt;540;6;546
32;Hauts-de-France;02;4;05;010;Allemant;175;4;179
32;Hauts-de-France;02;4;20;011;Ambleny;1151;54;1205
32;Hauts-de-France;02;4;21;012;Ambrief;70;0;70
32;Hauts-de-France;02;2;06;013;Amifontaine;395;9;404
32;Hauts-de-France;02;2;03;014;Amigny-Rouy;737;23;760
32;Hauts-de-France;02;4;21;015;Ancienville;73;1;74
32;Hauts-de-France;02;2;18;016;Andelain;222;9;231
32;Hauts-de-France;02;2;18;017;Anguilcourt-le-Sart;318;4;322
32;Hauts-de-France;02;2;09;018;Anizy-le-Grand ;2542;53;2595
32;Hauts-de-France;02;3;12;019;Annois;363;5;368
32;Hauts-de-France;02;5;08;020;Any-Martin-Rieux;456;8;464
32;Hauts-de-France;02;5;19;021;Archon;86;3;89
32;Hauts-de-France;02;4;21;022;Arcy-Sainte-Restitue;406;6;412
32;Hauts-de-France;02;1;21;023;Armentières-sur-Ourcq;102;3;105
32;Hauts-de-France;02;2;10;024;Arrancy;51;0;51
32;Hauts-de-France;02;3;12;025;Artemps;369;2;371
32;Hauts-de-France;02;2;11;027;Assis-sur-Serre;218;7;225
32;Hauts-de-France;02;2;10;028;Athies-sous-Laon;2605;60;2665
32;Hauts-de-France;02;3;13;029;Attilly;359;12;371
32;Hauts-de-France;02;3;01;030;Aubencheul-aux-Bois;263;4;267
32;Hauts-de-France;02;5;08;031;Aubenton;659;6;665
32;Hauts-de-France;02;3;12;032;Aubigny-aux-Kaisnes;254;4;258
32;Hauts-de-France;02;2;06;033;Aubigny-en-Laonnois;105;2;107
32;Hauts-de-France;02;4;20;034;Audignicourt;119;4;123
32;Hauts-de-France;02;5;07;035;Audigny;280;9;289
32;Hauts-de-France;02;4;05;036;Augy;77;1;78
32;Hauts-de-France;02;2;09;037;Aulnois-sous-Laon;1404;30;1434
32;Hauts-de-France;02;5;19;038;Les Autels;57;0;57
32;Hauts-de-France;02;2;11;039;Autremencourt;171;3;174
32;Hauts-de-France;02;5;19;040;Autreppes;178;3;181
32;Hauts-de-France;02;2;03;041;Autreville;807;15;822
32;Hauts-de-France;02;1;04;042;Azy-sur-Marne;385;2;387
32;Hauts-de-France;02;4;16;043;Bagneux;67;1;68
32;Hauts-de-France;02;5;19;044;Bancigny;25;0;25
32;Hauts-de-France;02;2;11;046;Barenton-Bugny;560;9;569
32;Hauts-de-France;02;2;11;047;Barenton-Cel;111;5;116
32;Hauts-de-France;02;2;11;048;Barenton-sur-Serre;133;4;137
32;Hauts-de-France;02;2;20;049;Barisis-aux-Bois;736;13;749
32;Hauts-de-France;02;5;07;050;Barzy-en-Thiérache;327;2;329
32;Hauts-de-France;02;1;04;051;Barzy-sur-Marne;388;6;394
32;Hauts-de-France;02;2;09;052;Bassoles-Aulers;136;6;142
32;Hauts-de-France;02;4;05;054;Bazoches-sur-Vesles;458;4;462
32;Hauts-de-France;02;5;08;055;Beaumé;89;2;91
32;Hauts-de-France;02;2;03;056;Beaumont-en-Beine;178;1;179
32;Hauts-de-France;02;3;01;057;Beaurevoir;1415;18;1433
32;Hauts-de-France;02;2;06;058;Beaurieux;851;10;861
32;Hauts-de-France;02;2;18;059;Beautor;2707;28;2735
32;Hauts-de-France;02;3;13;060;Beauvois-en-Vermandois;260;7;267
32;Hauts-de-France;02;3;01;061;Becquigny;248;7;255
32;Hauts-de-France;02;1;02;062;Belleau;137;4;141
32;Hauts-de-France;02;3;01;063;Bellenglise;379;8;387
32;Hauts-de-France;02;4;17;064;Belleu;3815;53;3868
32;Hauts-de-France;02;3;01;065;Bellicourt;598;13;611
32;Hauts-de-France;02;3;12;066;Benay;200;2;202
32;Hauts-de-France;02;5;07;067;Bergues-sur-Sambre;212;5;217
32;Hauts-de-France;02;5;11;068;Berlancourt;96;4;100
32;Hauts-de-France;02;5;19;069;Berlise;107;2;109
32;Hauts-de-France;02;5;07;070;Bernot;448;13;461
32;Hauts-de-France;02;4;20;071;Berny-Rivière;657;15;672
32;Hauts-de-France;02;2;06;072;Berrieux;188;2;190
32;Hauts-de-France;02;2;06;073;Berry-au-Bac;672;4;676
32;Hauts-de-France;02;2;18;074;Bertaucourt-Epourdon;598;10;608
32;Hauts-de-France;02;3;12;075;Berthenicourt;196;2;198
32;Hauts-de-France;02;2;06;076;Bertricourt;156;3;159
32;Hauts-de-France;02;4;17;077;Berzy-le-Sec;383;9;392
32;Hauts-de-France;02;2;20;078;Besmé;164;3;167
32;Hauts-de-France;02;5;08;079;Besmont;150;0;150
32;Hauts-de-France;02;2;09;080;Besny-et-Loizy;342;9;351
32;Hauts-de-France;02;2;03;081;Béthancourt-en-Vaux;438;8;446
32;Hauts-de-France;02;4;21;082;Beugneux;111;0;111
32;Hauts-de-France;02;1;05;083;Beuvardes;741;15;756
32;Hauts-de-France;02;1;04;084;Bézu-le-Guéry;258;5;263
32;Hauts-de-France;02;1;02;085;Bézu-Saint-Germain;1022;25;1047
32;Hauts-de-France;02;2;20;086;Bichancourt;1027;11;1038
32;Hauts-de-France;02;4;20;087;Bieuxy;32;1;33
32;Hauts-de-France;02;2;10;088;Bièvres;90;3;93
32;Hauts-de-France;02;4;17;089;Billy-sur-Aisne;1146;21;1167
32;Hauts-de-France;02;4;21;090;Billy-sur-Ourcq;210;10;220
32;Hauts-de-France;02;4;05;091;Blanzy-lès-Fismes;101;1;102
32;Hauts-de-France;02;2;20;093;Blérancourt;1295;59;1354
32;Hauts-de-France;02;1;02;094;Blesmes;457;9;466
32;Hauts-de-France;02;3;01;095;Bohain-en-Vermandois;5675;83;5758
32;Hauts-de-France;02;2;11;096;Bois-lès-Pargny;199;3;202
32;Hauts-de-France;02;2;06;097;Boncourt;258;2;260
32;Hauts-de-France;02;1;04;098;Bonneil;375;14;389
32;Hauts-de-France;02;1;21;099;Bonnesvalyn;228;5;233
32;Hauts-de-France;02;3;01;100;Bony;138;0;138
32;Hauts-de-France;02;2;11;101;Bosmont-sur-Serre;192;5;197
32;Hauts-de-France;02;2;06;102;Bouconville-Vauclair;189;6;195
32;Hauts-de-France;02;5;07;103;Boué;1331;16;1347
32;Hauts-de-France;02;2;06;104;Bouffignereux;100;4;104
32;Hauts-de-France;02;1;02;105;Bouresches;199;2;201
32;Hauts-de-France;02;2;06;106;Bourg-et-Comin;816;12;828
32;Hauts-de-France;02;2;20;107;Bourguignon-sous-Coucy;105;4;109
32;Hauts-de-France;02;2;09;108;Bourguignon-sous-Montbavin;157;4;161
32;Hauts-de-France;02;5;19;109;La Bouteille;480;10;490
32;Hauts-de-France;02;4;05;110;Braine;2239;25;2264
32;Hauts-de-France;02;2;09;111;Brancourt-en-Laonnois;711;11;722
32;Hauts-de-France;02;3;01;112;Brancourt-le-Grand;558;13;571
32;Hauts-de-France;02;1;02;114;Brasles;1573;38;1611
32;Hauts-de-France;02;3;12;117;Bray-Saint-Christophe;66;0;66
32;Hauts-de-France;02;4;05;118;Braye;127;2;129
32;Hauts-de-France;02;2;06;115;Braye-en-Laonnois;195;6;201
32;Hauts-de-France;02;5;19;116;Braye-en-Thiérache;146;1;147
32;Hauts-de-France;02;1;02;119;Brécy;332;6;338
32;Hauts-de-France;02;4;05;120;Brenelle;195;6;201
32;Hauts-de-France;02;4;21;121;Breny;243;4;247
32;Hauts-de-France;02;2;18;122;Brie;54;1;55
32;Hauts-de-France;02;3;12;123;Brissay-Choigny;303;5;308
32;Hauts-de-France;02;3;12;124;Brissy-Hamégicourt;653;10;663
32;Hauts-de-France;02;1;21;125;Brumetz;203;11;214
32;Hauts-de-France;02;5;19;126;Brunehamel;456;5;461
32;Hauts-de-France;02;2;10;128;Bruyères-et-Montbérault;1504;48;1552
32;Hauts-de-France;02;1;05;127;Bruyères-sur-Fère;192;5;197
32;Hauts-de-France;02;4;05;129;Bruys;19;0;19
32;Hauts-de-France;02;5;08;130;Bucilly;193;7;200
32;Hauts-de-France;02;4;05;131;Bucy-le-Long;1873;41;1914
32;Hauts-de-France;02;2;09;132;Bucy-lès-Cerny;197;3;200
32;Hauts-de-France;02;2;06;133;Bucy-lès-Pierrepont;406;9;415
32;Hauts-de-France;02;5;08;134;Buire;867;18;885
32;Hauts-de-France;02;5;19;135;Buironfosse;1162;17;1179
32;Hauts-de-France;02;5;19;136;Burelles;128;3;131
32;Hauts-de-France;02;1;21;137;Bussiares;155;0;155
32;Hauts-de-France;02;4;21;138;Buzancy;193;3;196
32;Hauts-de-France;02;2;03;139;Caillouël-Crépigny;442;5;447
32;Hauts-de-France;02;2;20;140;Camelin;453;7;460
32;Hauts-de-France;02;5;19;141;La Capelle;1782;79;1861
32;Hauts-de-France;02;3;15;142;Castres;247;5;252
32;Hauts-de-France;02;3;01;143;Le Catelet;189;6;195
32;Hauts-de-France;02;3;13;144;Caulaincourt;145;3;148
32;Hauts-de-France;02;2;03;145;Caumont;546;10;556
32;Hauts-de-France;02;1;04;146;Celles-lès-Condé;89;1;90
32;Hauts-de-France;02;4;05;148;Celles-sur-Aisne;256;2;258
32;Hauts-de-France;02;3;12;149;Cerizy;65;2;67
32;Hauts-de-France;02;2;10;150;Cerny-en-Laonnois;63;0;63
32;Hauts-de-France;02;2;09;151;Cerny-lès-Bucy;115;3;118
32;Hauts-de-France;02;4;05;152;Cerseuil;89;0;89
32;Hauts-de-France;02;2;09;153;Cessières-Suzy ;765;20;785
32;Hauts-de-France;02;4;21;154;Chacrise;363;7;370
32;Hauts-de-France;02;2;09;155;Chaillevois;170;5;175
32;Hauts-de-France;02;2;11;156;Chalandry;256;1;257
32;Hauts-de-France;02;2;09;157;Chambry;839;23;862
32;Hauts-de-France;02;2;10;158;Chamouille;278;2;280
32;Hauts-de-France;02;2;20;159;Champs;287;2;289
32;Hauts-de-France;02;5;19;160;Chaourse;544;12;556
32;Hauts-de-France;02;1;04;162;La Chapelle-sur-Chézy;285;8;293
32;Hauts-de-France;02;1;04;163;Charly-sur-Marne;2597;42;2639
32;Hauts-de-France;02;1;05;164;Le Charmel;323;7;330
32;Hauts-de-France;02;2;18;165;Charmes;1651;26;1677
32;Hauts-de-France;02;1;04;166;Chartèves;354;9;363
32;Hauts-de-France;02;4;05;167;Chassemy;885;14;899
32;Hauts-de-France;02;1;02;168;Château-Thierry;15351;366;15717
32;Hauts-de-France;02;2;11;169;Châtillon-lès-Sons;83;0;83
32;Hauts-de-France;02;3;12;170;Châtillon-sur-Oise;126;0;126
32;Hauts-de-France;02;2;06;171;Chaudardes;88;1;89
32;Hauts-de-France;02;4;21;172;Chaudun;250;9;259
32;Hauts-de-France;02;2;03;173;Chauny;11773;436;12209
32;Hauts-de-France;02;4;05;174;Chavignon;824;16;840
32;Hauts-de-France;02;4;16;175;Chavigny;158;4;162
32;Hauts-de-France;02;4;05;176;Chavonne;205;3;208
32;Hauts-de-France;02;2;10;177;Chérêt;141;2;143
32;Hauts-de-France;02;2;06;178;Chermizy-Ailles;106;2;108
32;Hauts-de-France;02;4;05;179;Chéry-Chartreuve;388;8;396
32;Hauts-de-France;02;2;11;180;Chéry-lès-Pouilly;715;14;729
32;Hauts-de-France;02;5;19;181;Chéry-lès-Rozoy;80;1;81
32;Hauts-de-France;02;5;11;182;Chevennes;121;3;124
32;Hauts-de-France;02;2;06;183;Chevregny;185;1;186
32;Hauts-de-France;02;3;12;184;Chevresis-Monceau;354;5;359
32;Hauts-de-France;02;1;21;185;Chézy-en-Orxois;397;15;412
32;Hauts-de-France;02;1;04;186;Chézy-sur-Marne;1351;45;1396
32;Hauts-de-France;02;1;02;187;Chierry;1120;15;1135
32;Hauts-de-France;02;5;07;188;Chigny;148;4;152
32;Hauts-de-France;02;2;06;189;Chivres-en-Laonnois;355;8;363
32;Hauts-de-France;02;4;05;190;Chivres-Val;524;12;536
32;Hauts-de-France;02;2;10;191;Chivy-lès-Étouvelles;508;5;513
32;Hauts-de-France;02;4;21;192;Chouy;371;7;378
32;Hauts-de-France;02;1;05;193;Cierges;64;1;65
32;Hauts-de-France;02;2;11;194;Cilly;188;8;196
32;Hauts-de-France;02;4;05;195;Ciry-Salsogne;920;26;946
32;Hauts-de-France;02;2;09;196;Clacy-et-Thierret;314;7;321
32;Hauts-de-France;02;5;19;197;Clairfontaine;543;94;637
32;Hauts-de-France;02;4;05;198;Clamecy;230;2;232
32;Hauts-de-France;02;3;12;199;Clastres;618;8;626
32;Hauts-de-France;02;5;19;200;Clermont-les-Fermes;113;1;114
32;Hauts-de-France;02;1;02;203;Coincy;1295;19;1314
32;Hauts-de-France;02;5;08;204;Coingt;67;2;69
32;Hauts-de-France;02;2;10;205;Colligis-Crandelain;239;3;242
32;Hauts-de-France;02;5;11;206;Colonfay;77;3;80
32;Hauts-de-France;02;2;03;207;Commenchon;215;3;218
32;Hauts-de-France;02;2;06;208;Concevreux;273;6;279
32;Hauts-de-France;02;1;04;209;Condé-en-Brie;697;11;708
32;Hauts-de-France;02;4;05;210;Condé-sur-Aisne;362;6;368
32;Hauts-de-France;02;2;06;211;Condé-sur-Suippe;290;3;293
32;Hauts-de-France;02;2;03;212;Condren;706;11;717
32;Hauts-de-France;02;1;04;213;Connigis;340;2;342
32;Hauts-de-France;02;3;15;214;Contescourt;61;1;62
32;Hauts-de-France;02;2;06;215;Corbeny;834;6;840
32;Hauts-de-France;02;4;21;216;Corcy;300;4;304
32;Hauts-de-France;02;2;20;219;Coucy-la-Ville;203;78;281
32;Hauts-de-France;02;2;20;217;Coucy-le-Château-Auffrique;1002;9;1011
32;Hauts-de-France;02;2;06;218;Coucy-lès-Eppes;626;12;638
32;Hauts-de-France;02;1;05;220;Coulonges-Cohan;435;15;450
32;Hauts-de-France;02;1;04;221;Coupru;151;4;155
32;Hauts-de-France;02;2;18;222;Courbes;31;0;31
32;Hauts-de-France;02;1;04;223;Courboin;300;12;312
32;Hauts-de-France;02;4;05;224;Courcelles-sur-Vesle;349;4;353
32;Hauts-de-France;02;1;21;225;Courchamps;86;2;88
32;Hauts-de-France;02;4;17;226;Courmelles;1861;30;1891
32;Hauts-de-France;02;1;05;227;Courmont;127;1;128
32;Hauts-de-France;02;1;04;228;Courtemont-Varennes;337;6;343
32;Hauts-de-France;02;2;06;229;Courtrizy-et-Fussigny;69;0;69
32;Hauts-de-France;02;4;05;230;Couvrelles;189;11;200
32;Hauts-de-France;02;2;11;231;Couvron-et-Aumencourt;937;9;946
32;Hauts-de-France;02;4;21;232;Coyolles;358;10;368
32;Hauts-de-France;02;4;21;233;Cramaille;145;8;153
32;Hauts-de-France;02;2;06;234;Craonne;83;1;84
32;Hauts-de-France;02;2;06;235;Craonnelle;116;3;119
32;Hauts-de-France;02;2;20;236;Crécy-au-Mont;338;3;341
32;Hauts-de-France;02;2;11;237;Crécy-sur-Serre;1500;16;1516
32;Hauts-de-France;02;2;09;238;Crépy;1830;31;1861
32;Hauts-de-France;02;1;04;239;Crézancy;1238;85;1323
32;Hauts-de-France;02;3;01;240;Croix-Fonsomme;238;4;242
32;Hauts-de-France;02;1;21;241;La Croix-sur-Ourcq;100;3;103
32;Hauts-de-France;02;1;04;242;Crouttes-sur-Marne;646;11;657
32;Hauts-de-France;02;4;16;243;Crouy;2912;47;2959
32;Hauts-de-France;02;5;07;244;Crupilly;63;3;66
32;Hauts-de-France;02;4;16;245;Cuffies;1786;35;1821
32;Hauts-de-France;02;3;12;246;Cugny;612;4;616
32;Hauts-de-France;02;2;11;248;Cuirieux;156;3;159
32;Hauts-de-France;02;4;21;249;Cuiry-Housse;101;0;101
32;Hauts-de-France;02;2;06;250;Cuiry-lès-Chaudardes;74;4;78
32;Hauts-de-France;02;5;19;251;Cuiry-lès-Iviers;27;1;28
32;Hauts-de-France;02;2;06;252;Cuissy-et-Geny;71;2;73
32;Hauts-de-France;02;4;16;253;Cuisy-en-Almont;358;3;361
32;Hauts-de-France;02;4;20;254;Cutry;130;5;135
32;Hauts-de-France;02;4;05;255;Cys-la-Commune;148;2;150
32;Hauts-de-France;02;4;20;201;Cœuvres-et-Valsery;438;6;444
32;Hauts-de-France;02;5;19;256;Dagny-Lambercy;126;3;129
32;Hauts-de-France;02;3;12;257;Dallon;435;13;448
32;Hauts-de-France;02;4;21;258;Dammard;370;13;383
32;Hauts-de-France;02;4;21;259;Dampleux;396;15;411
32;Hauts-de-France;02;2;18;260;Danizy;652;11;663
32;Hauts-de-France;02;2;11;261;Dercy;391;9;400
32;Hauts-de-France;02;2;18;262;Deuillet;214;3;217
32;Hauts-de-France;02;4;05;263;Dhuizel;113;0;113
32;Hauts-de-France;02;1;04;458;Dhuys et Morin-en-Brie ;819;17;836
32;Hauts-de-France;02;5;19;264;Dizy-le-Gros;738;16;754
32;Hauts-de-France;02;5;19;265;Dohis;99;2;101
32;Hauts-de-France;02;5;19;266;Dolignon;47;2;49
32;Hauts-de-France;02;4;20;267;Dommiers;290;10;300
32;Hauts-de-France;02;1;04;268;Domptin;648;13;661
32;Hauts-de-France;02;5;07;269;Dorengt;155;6;161
32;Hauts-de-France;02;3;13;270;Douchy;163;3;166
32;Hauts-de-France;02;1;05;271;Dravegny;131;2;133
32;Hauts-de-France;02;4;21;272;Droizy;77;2;79
32;Hauts-de-France;02;3;12;273;Dury;214;0;214
32;Hauts-de-France;02;2;06;274;Ébouleau;197;6;203
32;Hauts-de-France;02;5;08;275;Effry;321;6;327
32;Hauts-de-France;02;5;19;276;Englancourt;120;5;125
32;Hauts-de-France;02;4;20;277;Épagny;341;7;348
32;Hauts-de-France;02;5;08;278;Éparcy;28;5;33
32;Hauts-de-France;02;1;02;279;Épaux-Bézu;555;25;580
32;Hauts-de-France;02;1;02;280;Épieds;401;12;413
32;Hauts-de-France;02;1;04;281;L' Épine-aux-Bois;258;11;269
32;Hauts-de-France;02;2;10;282;Eppes;422;8;430
32;Hauts-de-France;02;2;11;283;Erlon;285;8;293
32;Hauts-de-France;02;5;19;284;Erloy;100;1;101
32;Hauts-de-France;02;5;07;286;Esquéhéries;861;11;872
32;Hauts-de-France;02;3;12;287;Essigny-le-Grand;1013;26;1039
32;Hauts-de-France;02;3;14;288;Essigny-le-Petit;346;8;354
32;Hauts-de-France;02;1;04;289;Essises;414;11;425
32;Hauts-de-France;02;1;04;290;Essômes-sur-Marne;2760;74;2834
32;Hauts-de-France;02;3;01;291;Estrées;411;8;419
32;Hauts-de-France;02;1;02;292;Étampes-sur-Marne;1279;27;1306
32;Hauts-de-France;02;3;01;293;Étaves-et-Bocquiaux;555;10;565
32;Hauts-de-France;02;2;10;294;Étouvelles;210;8;218
32;Hauts-de-France;02;5;19;295;Étréaupont;856;7;863
32;Hauts-de-France;02;3;13;296;Étreillers;1203;21;1224
32;Hauts-de-France;02;1;02;297;Étrépilly;120;2;122
32;Hauts-de-France;02;5;07;298;Étreux;1439;9;1448
32;Hauts-de-France;02;2;06;299;Évergnicourt;558;6;564
32;Hauts-de-France;02;4;21;302;Faverolles;322;12;334
32;Hauts-de-France;02;3;13;303;Fayet;667;15;682
32;Hauts-de-France;02;2;18;304;La Fère;2847;138;2985
32;Hauts-de-France;02;1;05;305;Fère-en-Tardenois;3032;55;3087
32;Hauts-de-France;02;3;12;306;La Ferté-Chevresis;526;9;535
32;Hauts-de-France;02;4;21;307;La Ferté-Milon;2077;159;2236
32;Hauts-de-France;02;5;07;308;Fesmy-le-Sart;480;8;488
32;Hauts-de-France;02;2;10;309;Festieux;677;5;682
32;Hauts-de-France;02;3;14;310;Fieulaine;252;7;259
32;Hauts-de-France;02;4;05;311;Filain;124;2;126
32;Hauts-de-France;02;5;19;312;La Flamengrie;1110;10;1120
32;Hauts-de-France;02;5;07;313;Flavigny-le-Grand-et-Beaurain;456;5;461
32;Hauts-de-France;02;3;12;315;Flavy-le-Martel;1678;34;1712
32;Hauts-de-France;02;4;21;316;Fleury;132;5;137
32;Hauts-de-France;02;3;13;317;Fluquières;220;4;224
32;Hauts-de-France;02;2;20;318;Folembray;1388;18;1406
32;Hauts-de-France;02;3;14;319;Fonsomme;479;8;487
32;Hauts-de-France;02;3;12;320;Fontaine-lès-Clercs;241;4;245
32;Hauts-de-France;02;5;19;321;Fontaine-lès-Vervins;907;186;1093
32;Hauts-de-France;02;3;14;322;Fontaine-Notre-Dame;385;3;388
32;Hauts-de-France;02;3;01;323;Fontaine-Uterte;131;3;134
32;Hauts-de-France;02;5;19;324;Fontenelle;280;3;283
32;Hauts-de-France;02;4;20;326;Fontenoy;479;8;487
32;Hauts-de-France;02;3;13;327;Foreste;164;1;165
32;Hauts-de-France;02;1;02;328;Fossoy;512;6;518
32;Hauts-de-France;02;2;18;329;Fourdrain;423;9;432
32;Hauts-de-France;02;3;13;330;Francilly-Selency;505;7;512
32;Hauts-de-France;02;5;11;331;Franqueville;113;3;116
32;Hauts-de-France;02;1;05;332;Fresnes-en-Tardenois;266;4;270
32;Hauts-de-France;02;2;20;333;Fresnes-sous-Coucy;163;0;163
32;Hauts-de-France;02;3;01;334;Fresnoy-le-Grand;2952;70;3022
32;Hauts-de-France;02;2;18;335;Fressancourt;187;8;195
32;Hauts-de-France;02;2;03;336;Frières-Faillouël;991;15;1006
32;Hauts-de-France;02;5;19;337;Froidestrées;172;4;176
32;Hauts-de-France;02;2;11;338;Froidmont-Cohartille;257;10;267
32;Hauts-de-France;02;1;21;339;Gandelu;686;9;695
32;Hauts-de-France;02;3;15;340;Gauchy;5254;74;5328
32;Hauts-de-France;02;5;19;341;Gercy;271;1;272
32;Hauts-de-France;02;5;19;342;Gergny;134;2;136
32;Hauts-de-France;02;3;13;343;Germaine;81;0;81
32;Hauts-de-France;02;3;12;345;Gibercourt;41;1;42
32;Hauts-de-France;02;2;06;346;Gizy;667;12;679
32;Hauts-de-France;02;1;02;347;Gland;448;6;454
32;Hauts-de-France;02;2;06;349;Goudelancourt-lès-Berrieux;57;0;57
32;Hauts-de-France;02;2;06;350;Goudelancourt-lès-Pierrepont;135;2;137
32;Hauts-de-France;02;1;05;351;Goussancourt;112;6;118
32;Hauts-de-France;02;3;01;352;Gouy;560;10;570
32;Hauts-de-France;02;4;21;665;Grand-Rozoy;302;5;307
32;Hauts-de-France;02;5;07;783;Grand-Verly;138;0;138
32;Hauts-de-France;02;2;11;353;Grandlup-et-Fay;294;10;304
32;Hauts-de-France;02;5;19;354;Grandrieux;82;2;84
32;Hauts-de-France;02;3;13;355;Gricourt;966;26;992
32;Hauts-de-France;02;1;02;356;Grisolles;246;2;248
32;Hauts-de-France;02;5;19;357;Gronard;72;2;74
32;Hauts-de-France;02;5;07;358;Grougis;346;3;349
32;Hauts-de-France;02;3;15;359;Grugies;1328;21;1349
32;Hauts-de-France;02;5;07;361;Guise;4731;82;4813
32;Hauts-de-France;02;2;03;362;Guivry;241;12;253
32;Hauts-de-France;02;2;20;363;Guny;407;3;410
32;Hauts-de-France;02;2;06;364;Guyencourt;257;5;262
32;Hauts-de-France;02;5;07;366;Hannapes;321;7;328
32;Hauts-de-France;02;3;12;367;Happencourt;132;4;136
32;Hauts-de-France;02;4;21;368;Haramont;578;7;585
32;Hauts-de-France;02;5;19;369;Harcigny;242;2;244
32;Hauts-de-France;02;3;01;370;Hargicourt;604;5;609
32;Hauts-de-France;02;3;15;371;Harly;1590;35;1625
32;Hauts-de-France;02;4;21;372;Hartennes-et-Taux;358;10;368
32;Hauts-de-France;02;5;19;373;Hary;200;5;205
32;Hauts-de-France;02;1;21;375;Hautevesnes;163;3;166
32;Hauts-de-France;02;5;07;376;Hauteville;170;5;175
32;Hauts-de-France;02;5;19;377;Haution;139;8;147
32;Hauts-de-France;02;5;08;378;La Hérie;136;5;141
32;Hauts-de-France;02;5;11;379;Le Hérie-la-Viéville;220;121;341
32;Hauts-de-France;02;3;12;380;Hinacourt;25;1;26
32;Hauts-de-France;02;5;08;381;Hirson;8800;189;8989
32;Hauts-de-France;02;3;13;382;Holnon;1375;39;1414
32;Hauts-de-France;02;3;15;383;Homblières;1456;46;1502
32;Hauts-de-France;02;5;19;384;Houry;55;2;57
32;Hauts-de-France;02;5;11;385;Housset;155;3;158
32;Hauts-de-France;02;5;07;386;Iron;232;2;234
32;Hauts-de-France;02;3;12;387;Itancourt;1028;35;1063
32;Hauts-de-France;02;5;08;388;Iviers;228;6;234
32;Hauts-de-France;02;1;04;389;Jaulgonne;652;16;668
32;Hauts-de-France;02;3;13;390;Jeancourt;269;2;271
32;Hauts-de-France;02;5;08;391;Jeantes;206;0;206
32;Hauts-de-France;02;3;01;392;Joncourt;305;6;311
32;Hauts-de-France;02;4;05;393;Jouaignes;143;5;148
32;Hauts-de-France;02;2;20;395;Jumencourt;143;6;149
32;Hauts-de-France;02;2;06;396;Jumigny;65;1;66
32;Hauts-de-France;02;3;12;397;Jussy;1254;20;1274
32;Hauts-de-France;02;4;16;398;Juvigny;281;4;285
32;Hauts-de-France;02;2;06;399;Juvincourt-et-Damary;607;5;612
32;Hauts-de-France;02;4;05;400;Laffaux;148;4;152
32;Hauts-de-France;02;5;19;401;Laigny;195;2;197
32;Hauts-de-France;02;3;13;402;Lanchy;37;2;39
32;Hauts-de-France;02;5;11;403;Landifay-et-Bertaignemont;263;7;270
32;Hauts-de-France;02;5;19;404;Landouzy-la-Cour;188;0;188
32;Hauts-de-France;02;5;08;405;Landouzy-la-Ville;538;5;543
32;Hauts-de-France;02;2;20;406;Landricourt;135;5;140
32;Hauts-de-France;02;2;09;407;Laniscourt;191;8;199
32;Hauts-de-France;02;2;97;408;Laon;24710;667;25377
32;Hauts-de-France;02;2;06;409;Lappion;265;4;269
32;Hauts-de-France;02;4;21;410;Largny-sur-Automne;245;10;255
32;Hauts-de-France;02;1;21;411;Latilly;205;4;209
32;Hauts-de-France;02;4;21;412;Launoy;100;1;101
32;Hauts-de-France;02;2;10;413;Laval-en-Laonnois;246;4;250
32;Hauts-de-France;02;5;07;414;Lavaqueresse;202;5;207
32;Hauts-de-France;02;4;20;415;Laversine;161;4;165
32;Hauts-de-France;02;3;01;374;Lehaucourt;868;9;877
32;Hauts-de-France;02;5;11;416;Lemé;424;10;434
32;Hauts-de-France;02;3;01;417;Lempire;108;0;108
32;Hauts-de-France;02;5;19;418;Lerzy;218;4;222
32;Hauts-de-France;02;5;07;419;Leschelle;269;9;278
32;Hauts-de-France;02;3;14;420;Lesdins;833;11;844
32;Hauts-de-France;02;4;05;421;Lesges;104;1;105
32;Hauts-de-France;02;5;07;422;Lesquielles-Saint-Germain;810;10;820
32;Hauts-de-France;02;2;20;423;Leuilly-sous-Coucy;421;8;429
32;Hauts-de-France;02;4;16;424;Leury;105;0;105
32;Hauts-de-France;02;5;08;425;Leuze;173;3;176
32;Hauts-de-France;02;3;01;426;Levergies;544;10;554
32;Hauts-de-France;02;4;05;427;Lhuys;140;1;141
32;Hauts-de-France;02;1;21;428;Licy-Clignon;74;2;76
32;Hauts-de-France;02;2;10;429;Lierval;121;1;122
32;Hauts-de-France;02;2;06;430;Liesse-Notre-Dame;1292;107;1399
32;Hauts-de-France;02;2;18;431;Liez;387;9;396
32;Hauts-de-France;02;4;05;432;Limé;188;5;193
32;Hauts-de-France;02;5;19;433;Lislet;223;8;231
32;Hauts-de-France;02;5;08;435;Logny-lès-Aubenton;77;0;77
32;Hauts-de-France;02;4;21;438;Longpont;255;9;264
32;Hauts-de-France;02;2;06;440;Lor;139;0;139
32;Hauts-de-France;02;4;21;441;Louâtre;194;3;197
32;Hauts-de-France;02;1;05;442;Loupeigne;91;1;92
32;Hauts-de-France;02;1;04;443;Lucy-le-Bocage;199;6;205
32;Hauts-de-France;02;5;11;444;Lugny;119;0;119
32;Hauts-de-France;02;5;19;445;Luzoir;283;6;289
32;Hauts-de-France;02;3;12;446;Ly-Fontaine;119;1;120
32;Hauts-de-France;02;4;21;447;Maast-et-Violaine;147;5;152
32;Hauts-de-France;02;2;06;448;Mâchecourt;121;4;125
32;Hauts-de-France;02;4;21;449;Macogny;70;3;73
32;Hauts-de-France;02;5;07;450;Macquigny;371;4;375
32;Hauts-de-France;02;3;01;451;Magny-la-Fosse;126;1;127
32;Hauts-de-France;02;3;13;452;Maissemy;238;10;248
32;Hauts-de-France;02;2;06;453;Maizy;403;8;411
32;Hauts-de-France;02;2;06;454;La Malmaison;408;3;411
32;Hauts-de-France;02;5;07;455;Malzy;203;1;204
32;Hauts-de-France;02;2;20;456;Manicamp;302;4;306
32;Hauts-de-France;02;2;06;457;Marchais;420;11;431
32;Hauts-de-France;02;3;14;459;Marcy;167;8;175
32;Hauts-de-France;02;2;11;460;Marcy-sous-Marle;196;1;197
32;Hauts-de-France;02;2;03;461;Marest-Dampcourt;377;6;383
32;Hauts-de-France;02;1;05;462;Mareuil-en-Dôle;236;2;238
32;Hauts-de-France;02;5;11;463;Marfontaine;87;2;89
32;Hauts-de-France;02;4;05;464;Margival;366;2;368
32;Hauts-de-France;02;1;04;465;Marigny-en-Orxois;499;7;506
32;Hauts-de-France;02;4;21;467;Marizy-Saint-Mard;50;1;51
32;Hauts-de-France;02;4;21;466;Marizy-Sainte-Geneviève;132;0;132
32;Hauts-de-France;02;2;11;468;Marle;2252;29;2281
32;Hauts-de-France;02;5;07;469;Marly-Gomont;482;13;495
32;Hauts-de-France;02;5;08;470;Martigny;437;12;449
32;Hauts-de-France;02;2;10;471;Martigny-Courpierre;130;2;132
32;Hauts-de-France;02;2;06;472;Mauregny-en-Haye;415;7;422
32;Hauts-de-France;02;2;18;473;Mayot;213;1;214
32;Hauts-de-France;02;2;18;474;Mennessis;397;4;401
32;Hauts-de-France;02;5;07;476;Mennevret;661;14;675
32;Hauts-de-France;02;4;17;477;Mercin-et-Vaux;964;21;985
32;Hauts-de-France;02;2;09;478;Merlieux-et-Fouquerolles;262;8;270
32;Hauts-de-France;02;2;11;480;Mesbrecourt-Richecourt;309;3;312
32;Hauts-de-France;02;3;15;481;Mesnil-Saint-Laurent;478;16;494
32;Hauts-de-France;02;2;06;482;Meurival;53;1;54
32;Hauts-de-France;02;3;12;483;Mézières-sur-Oise;514;10;524
32;Hauts-de-France;02;1;04;484;Mézy-Moulins;522;3;525
32;Hauts-de-France;02;4;17;485;Missy-aux-Bois;95;4;99
32;Hauts-de-France;02;2;06;486;Missy-lès-Pierrepont;107;1;108
32;Hauts-de-France;02;4;05;487;Missy-sur-Aisne;633;9;642
32;Hauts-de-France;02;5;07;488;Molain;154;2;156
32;Hauts-de-France;02;2;09;489;Molinchart;335;7;342
32;Hauts-de-France;02;4;05;490;Monampteuil;129;3;132
32;Hauts-de-France;02;5;11;491;Monceau-le-Neuf-et-Faucouzy;321;9;330
32;Hauts-de-France;02;2;11;493;Monceau-le-Waast;224;6;230
32;Hauts-de-France;02;2;18;492;Monceau-lès-Leups;464;8;472
32;Hauts-de-France;02;5;07;494;Monceau-sur-Oise;127;2;129
32;Hauts-de-France;02;5;08;495;Mondrepuis;1041;15;1056
32;Hauts-de-France;02;4;21;496;Monnes;102;1;103
32;Hauts-de-France;02;2;09;497;Mons-en-Laonnois;1151;29;1180
32;Hauts-de-France;02;3;12;503;Mont-d'Origny;830;2;832
32;Hauts-de-France;02;4;05;520;Mont-Notre-Dame;735;7;742
32;Hauts-de-France;02;5;08;522;Mont-Saint-Jean;74;2;76
32;Hauts-de-France;02;4;05;523;Mont-Saint-Martin;73;1;74
32;Hauts-de-France;02;1;02;524;Mont-Saint-Père;698;16;714
32;Hauts-de-France;02;2;06;498;Montaigu;763;13;776
32;Hauts-de-France;02;2;09;499;Montbavin;43;2;45
32;Hauts-de-France;02;3;01;500;Montbrehain;809;19;828
32;Hauts-de-France;02;2;10;501;Montchâlons;89;2;91
32;Hauts-de-France;02;5;19;502;Montcornet;1328;9;1337
32;Hauts-de-France;02;3;12;504;Montescourt-Lizerolles;1632;28;1660
32;Hauts-de-France;02;1;04;505;Montfaucon;204;5;209
32;Hauts-de-France;02;4;21;506;Montgobert;194;6;200
32;Hauts-de-France;02;4;21;507;Montgru-Saint-Hilaire;32;1;33
32;Hauts-de-France;02;2;10;508;Monthenault;150;6;156
32;Hauts-de-France;02;1;21;509;Monthiers;159;0;159
32;Hauts-de-France;02;1;04;510;Monthurel;150;2;152
32;Hauts-de-France;02;3;01;511;Montigny-en-Arrouaise;290;4;294
32;Hauts-de-France;02;1;21;512;Montigny-l'Allier;273;5;278
32;Hauts-de-France;02;2;11;513;Montigny-le-Franc;139;2;141
32;Hauts-de-France;02;4;20;514;Montigny-Lengrain;709;15;724
32;Hauts-de-France;02;1;04;515;Montigny-lès-Condé;57;6;63
32;Hauts-de-France;02;2;11;516;Montigny-sous-Marle;66;1;67
32;Hauts-de-France;02;2;11;517;Montigny-sur-Crécy;302;5;307
32;Hauts-de-France;02;1;04;518;Montlevon;304;3;307
32;Hauts-de-France;02;5;19;519;Montloué;187;4;191
32;Hauts-de-France;02;1;04;521;Montreuil-aux-Lions;1370;14;1384
32;Hauts-de-France;02;3;14;525;Morcourt;579;13;592
32;Hauts-de-France;02;5;19;526;Morgny-en-Thiérache;94;3;97
32;Hauts-de-France;02;4;20;527;Morsain;455;9;464
32;Hauts-de-France;02;4;20;528;Mortefontaine;229;5;234
32;Hauts-de-France;02;2;11;529;Mortiers;181;1;182
32;Hauts-de-France;02;2;06;530;Moulins;77;1;78
32;Hauts-de-France;02;2;06;531;Moussy-Verneuil;120;1;121
32;Hauts-de-France;02;3;12;532;Moÿ-de-l'Aisne;981;18;999
32;Hauts-de-France;02;4;21;533;Muret-et-Crouttes;114;8;122
32;Hauts-de-France;02;2;06;534;Muscourt;49;1;50
32;Hauts-de-France;02;5;19;535;Nampcelles-la-Cour;114;5;119
32;Hauts-de-France;02;4;21;536;Nampteuil-sous-Muret;104;1;105
32;Hauts-de-France;02;4;05;537;Nanteuil-la-Fosse;196;1;197
32;Hauts-de-France;02;1;05;538;Nanteuil-Notre-Dame;66;0;66
32;Hauts-de-France;02;3;01;539;Nauroy;700;8;708
32;Hauts-de-France;02;1;02;540;Nesles-la-Montagne;1233;35;1268
32;Hauts-de-France;02;2;06;541;Neufchâtel-sur-Aisne;422;6;428
32;Hauts-de-France;02;2;03;542;Neuflieux;87;2;89
32;Hauts-de-France;02;1;21;543;Neuilly-Saint-Front;2075;34;2109
32;Hauts-de-France;02;5;08;544;Neuve-Maison;614;14;628
32;Hauts-de-France;02;2;11;545;La Neuville-Bosmont;187;2;189
32;Hauts-de-France;02;2;03;546;La Neuville-en-Beine;193;4;197
32;Hauts-de-France;02;5;11;547;La Neuville-Housset;67;1;68
32;Hauts-de-France;02;5;07;548;La Neuville-lès-Dorengt;379;7;386
32;Hauts-de-France;02;3;15;549;Neuville-Saint-Amand;844;25;869
32;Hauts-de-France;02;2;06;550;Neuville-sur-Ailette;110;3;113
32;Hauts-de-France;02;4;05;551;Neuville-sur-Margival;116;0;116
32;Hauts-de-France;02;3;12;552;Neuvillette;186;9;195
32;Hauts-de-France;02;2;06;553;Nizy-le-Comte;244;4;248
32;Hauts-de-France;02;1;04;555;Nogent-l'Artaud;2138;47;2185
32;Hauts-de-France;02;1;04;554;Nogentel;1041;22;1063
32;Hauts-de-France;02;5;19;556;Noircourt;81;1;82
32;Hauts-de-France;02;4;21;557;Noroy-sur-Ourcq;128;0;128
32;Hauts-de-France;02;5;07;558;Le Nouvion-en-Thiérache;2584;28;2612
32;Hauts-de-France;02;2;11;559;Nouvion-et-Catillon;467;4;471
32;Hauts-de-France;02;2;11;560;Nouvion-le-Comte;247;4;251
32;Hauts-de-France;02;2;10;561;Nouvion-le-Vineux;159;4;163
32;Hauts-de-France;02;4;20;562;Nouvron-Vingré;218;2;220
32;Hauts-de-France;02;5;07;563;Noyales;166;3;169
32;Hauts-de-France;02;4;17;564;Noyant-et-Aconin;500;5;505
32;Hauts-de-France;02;2;03;566;Ognes;1109;23;1132
32;Hauts-de-France;02;5;08;567;Ohis;291;8;299
32;Hauts-de-France;02;4;21;568;Oigny-en-Valois;158;4;162
32;Hauts-de-France;02;5;07;569;Oisy;466;3;469
32;Hauts-de-France;02;3;12;570;Ollezy;180;0;180
32;Hauts-de-France;02;3;14;571;Omissy;724;75;799
32;Hauts-de-France;02;2;06;572;Orainville;501;9;510
32;Hauts-de-France;02;2;10;573;Orgeval;63;1;64
32;Hauts-de-France;02;5;08;574;Origny-en-Thiérache;1438;28;1466
32;Hauts-de-France;02;3;12;575;Origny-Sainte-Benoite;1683;14;1697
32;Hauts-de-France;02;4;16;576;Osly-Courtil;332;8;340
32;Hauts-de-France;02;4;05;577;Ostel;85;1;86
32;Hauts-de-France;02;2;06;578;Oulches-la-Vallée-Foulon;85;1;86
32;Hauts-de-France;02;4;21;579;Oulchy-la-Ville;125;9;134
32;Hauts-de-France;02;4;21;580;Oulchy-le-Château;819;10;829
32;Hauts-de-France;02;4;05;581;Paars;320;1;321
32;Hauts-de-France;02;2;06;582;Paissy;76;2;78
32;Hauts-de-France;02;2;06;583;Pancy-Courtecon;54;2;56
32;Hauts-de-France;02;5;19;584;Papleux;124;6;130
32;Hauts-de-France;02;4;21;585;Parcy-et-Tigny;258;7;265
32;Hauts-de-France;02;5;19;586;Parfondeval;141;6;147
32;Hauts-de-France;02;2;10;587;Parfondru;349;7;356
32;Hauts-de-France;02;2;06;588;Pargnan;71;2;73
32;Hauts-de-France;02;4;05;589;Pargny-Filain;260;0;260
32;Hauts-de-France;02;1;04;590;Pargny-la-Dhuys;170;4;174
32;Hauts-de-France;02;2;11;591;Pargny-les-Bois;134;1;135
32;Hauts-de-France;02;3;12;592;Parpeville;190;4;194
32;Hauts-de-France;02;4;16;593;Pasly;1042;21;1063
32;Hauts-de-France;02;4;21;594;Passy-en-Valois;140;6;146
32;Hauts-de-France;02;1;04;595;Passy-sur-Marne;129;0;129
32;Hauts-de-France;02;1;04;596;Pavant;772;15;787
32;Hauts-de-France;02;4;20;598;Pernant;660;17;677
32;Hauts-de-France;02;5;07;784;Petit-Verly;144;0;144
32;Hauts-de-France;02;2;03;599;Pierremande;267;3;270
32;Hauts-de-France;02;2;11;600;Pierrepont;355;5;360
32;Hauts-de-France;02;2;06;601;Pignicourt;197;2;199
32;Hauts-de-France;02;2;09;602;Pinon;1728;27;1755
32;Hauts-de-France;02;3;12;604;Pithon;84;1;85
32;Hauts-de-France;02;3;12;605;Pleine-Selve;182;5;187
32;Hauts-de-France;02;4;21;606;Le Plessier-Huleu;70;3;73
32;Hauts-de-France;02;4;17;607;Ploisy;79;2;81
32;Hauts-de-France;02;5;19;608;Plomion;468;2;470
32;Hauts-de-France;02;2;06;609;Ployart-et-Vaurseine;21;0;21
32;Hauts-de-France;02;4;16;610;Pommiers;729;11;740
32;Hauts-de-France;02;4;05;612;Pont-Arcy;128;1;129
32;Hauts-de-France;02;2;20;616;Pont-Saint-Mard;208;3;211
32;Hauts-de-France;02;2;06;613;Pontavert;608;11;619
32;Hauts-de-France;02;3;13;614;Pontru;258;7;265
32;Hauts-de-France;02;3;13;615;Pontruet;348;5;353
32;Hauts-de-France;02;2;11;617;Pouilly-sur-Serre;505;3;508
32;Hauts-de-France;02;3;01;618;Prémont;697;12;709
32;Hauts-de-France;02;2;09;619;Prémontré;656;0;656
32;Hauts-de-France;02;4;05;620;Presles-et-Boves;352;9;361
32;Hauts-de-France;02;2;10;621;Presles-et-Thierny;381;15;396
32;Hauts-de-France;02;1;21;622;Priez;53;0;53
32;Hauts-de-France;02;5;19;623;Prisces;99;3;102
32;Hauts-de-France;02;5;07;624;Proisy;281;66;347
32;Hauts-de-France;02;5;07;625;Proix;142;2;144
32;Hauts-de-France;02;2;06;626;Prouvais;326;7;333
32;Hauts-de-France;02;2;06;627;Proviseux-et-Plesnoy;123;3;126
32;Hauts-de-France;02;4;21;628;Puiseux-en-Retz;215;6;221
32;Hauts-de-France;02;5;11;629;Puisieux-et-Clanlieu;300;12;312
32;Hauts-de-France;02;2;20;631;Quierzy;415;5;420
32;Hauts-de-France;02;2;20;632;Quincy-Basse;59;1;60
32;Hauts-de-France;02;4;05;633;Quincy-sous-le-Mont;60;0;60
32;Hauts-de-France;02;5;19;634;Raillimont;81;4;85
32;Hauts-de-France;02;3;01;635;Ramicourt;148;5;153
32;Hauts-de-France;02;3;12;636;Regny;201;5;206
32;Hauts-de-France;02;3;14;637;Remaucourt;296;10;306
32;Hauts-de-France;02;2;11;638;Remies;236;1;237
32;Hauts-de-France;02;3;12;639;Remigny;346;7;353
32;Hauts-de-France;02;3;12;640;Renansart;159;4;163
32;Hauts-de-France;02;5;19;641;Renneval;112;4;116
32;Hauts-de-France;02;5;19;642;Résigny;179;3;182
32;Hauts-de-France;02;4;20;643;Ressons-le-Long;773;8;781
32;Hauts-de-France;02;4;21;644;Retheuil;349;13;362
32;Hauts-de-France;02;1;04;645;Reuilly-Sauvigny;197;9;206
32;Hauts-de-France;02;5;07;647;Ribeauville;62;0;62
32;Hauts-de-France;02;3;12;648;Ribemont;1959;39;1998
32;Hauts-de-France;02;1;02;649;Rocourt-Saint-Martin;305;4;309
32;Hauts-de-France;02;5;19;650;Rocquigny;359;6;365
32;Hauts-de-France;02;2;18;651;Rogécourt;105;1;106
32;Hauts-de-France;02;5;11;652;Rogny;108;1;109
32;Hauts-de-France;02;1;04;653;Romeny-sur-Marne;502;13;515
32;Hauts-de-France;02;5;07;654;Romery;82;1;83
32;Hauts-de-France;02;1;05;655;Ronchères;123;0;123
32;Hauts-de-France;02;2;06;656;Roucy;394;10;404
32;Hauts-de-France;02;5;11;657;Rougeries;247;4;251
32;Hauts-de-France;02;3;13;658;Roupy;235;8;243
32;Hauts-de-France;02;3;14;659;Rouvroy;507;13;520
32;Hauts-de-France;02;5;19;660;Rouvroy-sur-Serre;39;2;41
32;Hauts-de-France;02;2;09;661;Royaucourt-et-Chailvet;252;3;255
32;Hauts-de-France;02;1;21;662;Rozet-Saint-Albin;315;9;324
32;Hauts-de-France;02;4;21;663;Rozières-sur-Crise;224;5;229
32;Hauts-de-France;02;1;04;664;Rozoy-Bellevalle;120;3;123
32;Hauts-de-France;02;5;19;666;Rozoy-sur-Serre;1001;17;1018
32;Hauts-de-France;02;4;20;667;Saconin-et-Breuil;215;6;221
32;Hauts-de-France;02;5;11;668;Sains-Richaumont;1050;21;1071
32;Hauts-de-France;02;5;19;670;Saint-Algis;152;0;152
32;Hauts-de-France;02;2;20;671;Saint-Aubin;287;5;292
32;Hauts-de-France;02;4;20;672;Saint-Bandry;264;4;268
32;Hauts-de-France;02;4;20;673;Saint-Christophe-à-Berry;445;7;452
32;Hauts-de-France;02;5;08;674;Saint-Clément;48;0;48
32;Hauts-de-France;02;2;06;676;Saint-Erme-Outre-et-Ramecourt;1722;40;1762
32;Hauts-de-France;02;1;04;677;Saint-Eugène;242;3;245
32;Hauts-de-France;02;1;21;679;Saint-Gengoulph;149;4;153
32;Hauts-de-France;02;2;18;680;Saint-Gobain;2288;37;2325
32;Hauts-de-France;02;5;11;681;Saint-Gobert;273;5;278
32;Hauts-de-France;02;4;05;682;Saint-Mard;113;3;116
32;Hauts-de-France;02;5;07;683;Saint-Martin-Rivière;113;3;116
32;Hauts-de-France;02;5;08;684;Saint-Michel;3365;58;3423
32;Hauts-de-France;02;2;18;685;Saint-Nicolas-aux-Bois;119;1;120
32;Hauts-de-France;02;2;20;686;Saint-Paul-aux-Bois;381;4;385
32;Hauts-de-France;02;4;20;687;Saint-Pierre-Aigle;332;9;341
32;Hauts-de-France;02;5;11;688;Saint-Pierre-lès-Franqueville;50;4;54
32;Hauts-de-France;02;2;11;689;Saint-Pierremont;42;1;43
32;Hauts-de-France;02;3;98;691;Saint-Quentin;53856;1260;55116
32;Hauts-de-France;02;4;21;693;Saint-Rémy-Blanzy;221;3;224
32;Hauts-de-France;02;3;12;694;Saint-Simon;639;9;648
32;Hauts-de-France;02;4;05;695;Saint-Thibaut;80;0;80
32;Hauts-de-France;02;2;06;696;Saint-Thomas;78;3;81
32;Hauts-de-France;02;2;06;675;Sainte-Croix;133;1;134
32;Hauts-de-France;02;5;19;678;Sainte-Geneviève;68;0;68
32;Hauts-de-France;02;2;06;690;Sainte-Preuve;81;1;82
32;Hauts-de-France;02;2;10;697;Samoussy;385;5;390
32;Hauts-de-France;02;4;05;698;Sancy-les-Cheminots;101;2;103
32;Hauts-de-France;02;1;05;699;Saponay;285;3;288
32;Hauts-de-France;02;1;04;701;Saulchery;716;8;724
32;Hauts-de-France;02;3;13;702;Savy;607;22;629
32;Hauts-de-France;02;3;01;703;Seboncourt;1091;13;1104
32;Hauts-de-France;02;2;20;704;Selens;248;4;252
32;Hauts-de-France;02;2;06;705;La Selve;214;6;220
32;Hauts-de-France;02;4;17;706;Septmonts;563;11;574
32;Hauts-de-France;02;4;05;439;Septvallons ;1181;20;1201
32;Hauts-de-France;02;2;20;707;Septvaux;180;0;180
32;Hauts-de-France;02;3;01;708;Sequehart;212;8;220
32;Hauts-de-France;02;3;01;709;Serain;407;8;415
32;Hauts-de-France;02;3;12;710;Seraucourt-le-Grand;756;19;775
32;Hauts-de-France;02;4;17;711;Serches;301;7;308
32;Hauts-de-France;02;1;05;712;Sergy;146;3;149
32;Hauts-de-France;02;1;05;713;Seringes-et-Nesles;273;4;277
32;Hauts-de-France;02;4;17;714;Sermoise;352;2;354
32;Hauts-de-France;02;2;18;716;Servais;285;5;290
32;Hauts-de-France;02;4;05;715;Serval;49;3;52
32;Hauts-de-France;02;3;12;717;Séry-lès-Mézières;583;13;596
32;Hauts-de-France;02;4;21;718;Silly-la-Poterie;124;3;127
32;Hauts-de-France;02;2;03;719;Sinceny;2034;41;2075
32;Hauts-de-France;02;2;06;720;Sissonne;2034;74;2108
32;Hauts-de-France;02;3;12;721;Sissy;477;2;479
32;Hauts-de-France;02;4;99;722;Soissons;28522;651;29173
32;Hauts-de-France;02;5;19;723;Soize;100;1;101
32;Hauts-de-France;02;1;21;724;Sommelans;61;1;62
32;Hauts-de-France;02;5;19;725;Sommeron;140;6;146
32;Hauts-de-France;02;3;12;726;Sommette-Eaucourt;187;3;190
32;Hauts-de-France;02;2;11;727;Sons-et-Ronchères;230;3;233
32;Hauts-de-France;02;5;19;728;Sorbais;265;4;269
32;Hauts-de-France;02;4;21;729;Soucy;89;1;90
32;Hauts-de-France;02;4;05;730;Soupir;270;6;276
32;Hauts-de-France;02;5;11;731;Le Sourd;169;2;171
32;Hauts-de-France;02;3;12;732;Surfontaine;104;0;104
32;Hauts-de-France;02;4;21;734;Taillefontaine;277;6;283
32;Hauts-de-France;02;4;05;735;Tannières;17;0;17
32;Hauts-de-France;02;4;20;736;Tartiers;166;5;171
32;Hauts-de-France;02;2;11;737;Tavaux-et-Pontséricourt;560;12;572
32;Hauts-de-France;02;2;18;738;Tergnier;13547;201;13748
32;Hauts-de-France;02;4;05;739;Terny-Sorny;333;7;340
32;Hauts-de-France;02;5;19;740;Thenailles;220;6;226
32;Hauts-de-France;02;3;12;741;Thenelles;542;5;547
32;Hauts-de-France;02;2;11;742;Thiernu;104;0;104
32;Hauts-de-France;02;5;19;743;Le Thuel;161;1;162
32;Hauts-de-France;02;1;21;744;Torcy-en-Valois;71;2;73
32;Hauts-de-France;02;2;11;745;Toulis-et-Attencourt;124;1;125
32;Hauts-de-France;02;2;18;746;Travecy;665;8;673
32;Hauts-de-France;02;3;13;747;Trefcon;85;0;85
32;Hauts-de-France;02;1;04;748;Trélou-sur-Marne;943;24;967
32;Hauts-de-France;02;4;21;749;Troësnes;221;7;228
32;Hauts-de-France;02;2;20;750;Trosly-Loire;598;8;606
32;Hauts-de-France;02;2;06;751;Trucy;144;2;146
32;Hauts-de-France;02;3;12;752;Tugny-et-Pont;278;5;283
32;Hauts-de-France;02;5;07;753;Tupigny;329;4;333
32;Hauts-de-France;02;2;03;754;Ugny-le-Gay;185;3;188
32;Hauts-de-France;02;2;09;755;Urcel;586;9;595
32;Hauts-de-France;02;3;12;756;Urvillers;668;12;680
32;Hauts-de-France;02;5;07;757;Vadencourt;531;8;539
32;Hauts-de-France;02;4;05;758;Vailly-sur-Aisne;2008;37;2045
32;Hauts-de-France;02;5;11;759;La Vallée-au-Blé;366;3;369
32;Hauts-de-France;02;5;07;760;La Vallée-Mulâtre;145;3;148
32;Hauts-de-France;02;1;04;053;Vallées en Champagne;570;6;576
32;Hauts-de-France;02;2;06;761;Variscourt;204;4;208
32;Hauts-de-France;02;4;20;762;Vassens;145;5;150
32;Hauts-de-France;02;4;05;763;Vasseny;215;4;219
32;Hauts-de-France;02;2;06;764;Vassogne;88;3;91
32;Hauts-de-France;02;2;09;765;Vaucelles-et-Beffecourt;256;11;267
32;Hauts-de-France;02;4;05;766;Vaudesson;237;6;243
32;Hauts-de-France;02;5;07;769;Vaux-Andigny;911;14;925
32;Hauts-de-France;02;3;13;772;Vaux-en-Vermandois;156;1;157
32;Hauts-de-France;02;2;09;768;Vauxaillon;539;6;545
32;Hauts-de-France;02;4;17;770;Vauxbuin;785;20;805
32;Hauts-de-France;02;4;16;767;Vauxrezis;323;3;326
32;Hauts-de-France;02;4;05;773;Vauxtin;39;0;39
32;Hauts-de-France;02;3;13;774;Vendelles;116;1;117
32;Hauts-de-France;02;3;12;775;Vendeuil;944;17;961
32;Hauts-de-France;02;3;01;776;Vendhuile;552;12;564
32;Hauts-de-France;02;1;04;777;Vendières;151;7;158
32;Hauts-de-France;02;2;06;778;Vendresse-Beaulne;99;1;100
32;Hauts-de-France;02;5;07;779;Vénérolles;220;3;223
32;Hauts-de-France;02;4;16;780;Venizel;1379;17;1396
32;Hauts-de-France;02;1;02;781;Verdilly;457;16;473
32;Hauts-de-France;02;3;13;782;Le Verguier;220;2;222
32;Hauts-de-France;02;3;13;785;Vermand;1097;30;1127
32;Hauts-de-France;02;2;20;786;Verneuil-sous-Coucy;128;2;130
32;Hauts-de-France;02;2;11;787;Verneuil-sur-Serre;258;2;260
32;Hauts-de-France;02;2;18;788;Versigny;464;7;471
32;Hauts-de-France;02;5;19;789;Vervins;2579;96;2675
32;Hauts-de-France;02;2;11;790;Vesles-et-Caumont;234;3;237
32;Hauts-de-France;02;2;10;791;Veslud;251;6;257
32;Hauts-de-France;02;1;04;792;Veuilly-la-Poterie;157;7;164
32;Hauts-de-France;02;4;20;793;Vézaponin;121;1;122
32;Hauts-de-France;02;1;05;794;Vézilly;186;4;190
32;Hauts-de-France;02;4;20;795;Vic-sur-Aisne;1631;18;1649
32;Hauts-de-France;02;1;21;796;Vichel-Nanteuil;83;0;83
32;Hauts-de-France;02;4;05;797;Viel-Arcy;176;1;177
32;Hauts-de-France;02;1;04;798;Viels-Maisons;1227;19;1246
32;Hauts-de-France;02;4;21;799;Vierzy;421;9;430
32;Hauts-de-France;02;1;04;800;Viffort;317;5;322
32;Hauts-de-France;02;5;19;801;Vigneux-Hocquet;270;3;273
32;Hauts-de-France;02;5;19;802;La Ville-aux-Bois-lès-Dizy;208;0;208
32;Hauts-de-France;02;2;06;803;La Ville-aux-Bois-lès-Pontavert;146;5;151
32;Hauts-de-France;02;4;05;817;Ville-Savoye;82;1;83
32;Hauts-de-France;02;4;21;804;Villemontoire;185;3;188
32;Hauts-de-France;02;4;16;805;Villeneuve-Saint-Germain;2464;43;2507
32;Hauts-de-France;02;2;06;360;Villeneuve-sur-Aisne ;2722;39;2761
32;Hauts-de-France;02;1;02;806;Villeneuve-sur-Fère;289;5;294
32;Hauts-de-France;02;2;03;807;Villequier-Aumont;651;24;675
32;Hauts-de-France;02;3;01;808;Villeret;295;5;300
32;Hauts-de-France;02;1;05;809;Villers-Agron-Aiguizy;71;3;74
32;Hauts-de-France;02;4;21;810;Villers-Cotterêts;10676;428;11104
32;Hauts-de-France;02;4;21;812;Villers-Hélon;212;6;218
32;Hauts-de-France;02;3;12;813;Villers-le-Sec;260;8;268
32;Hauts-de-France;02;5;07;814;Villers-lès-Guise;166;0;166
32;Hauts-de-France;02;3;12;815;Villers-Saint-Christophe;432;17;449
32;Hauts-de-France;02;1;05;816;Villers-sur-Fère;530;6;536
32;Hauts-de-France;02;1;04;818;Villiers-Saint-Denis;1170;11;1181
32;Hauts-de-France;02;5;19;819;Vincy-Reuil-et-Magny;116;1;117
32;Hauts-de-France;02;2;03;820;Viry-Noureuil;1693;43;1736
32;Hauts-de-France;02;2;09;821;Vivaise;688;21;709
32;Hauts-de-France;02;4;21;822;Vivières;392;12;404
32;Hauts-de-France;02;5;11;823;Voharies;74;0;74
32;Hauts-de-France;02;2;10;824;Vorges;373;8;381
32;Hauts-de-France;02;5;11;826;Voulpaix;366;7;373
32;Hauts-de-France;02;2;11;827;Voyenne;318;5;323
32;Hauts-de-France;02;4;16;828;Vregny;93;0;93
32;Hauts-de-France;02;4;05;829;Vuillery;42;1;43
32;Hauts-de-France;02;5;07;830;Wassigny;953;16;969
32;Hauts-de-France;02;5;08;831;Watigny;378;6;384
32;Hauts-de-France;02;5;11;832;Wiège-Faty;193;5;198
32;Hauts-de-France;02;5;08;833;Wimy;497;7;504
32;Hauts-de-France;02;2;09;834;Wissignicourt;168;6;174
32;Hauts-de-France;02;2;06;565;Œuilly;290;3;293
84;Auvergne-Rhône-Alpes;03;3;18;001;Abrest;2908;60;2968
84;Auvergne-Rhône-Alpes;03;2;16;002;Agonges;309;12;321
84;Auvergne-Rhône-Alpes;03;1;02;003;Ainay-le-Château;983;26;1009
84;Auvergne-Rhône-Alpes;03;3;08;004;Andelaroche;255;7;262
84;Auvergne-Rhône-Alpes;03;1;07;005;Archignat;337;3;340
84;Auvergne-Rhône-Alpes;03;3;08;006;Arfeuilles;635;17;652
84;Auvergne-Rhône-Alpes;03;1;11;007;Arpheuilles-Saint-Priest;357;7;364
84;Auvergne-Rhône-Alpes;03;3;08;008;Arronnes;373;14;387
84;Auvergne-Rhône-Alpes;03;2;13;009;Aubigny;134;37;171
84;Auvergne-Rhône-Alpes;03;1;07;010;Audes;429;13;442
84;Auvergne-Rhône-Alpes;03;2;19;011;Aurouër;409;9;418
84;Auvergne-Rhône-Alpes;03;2;16;012;Autry-Issards;324;5;329
84;Auvergne-Rhône-Alpes;03;2;13;013;Avermes;3960;96;4056
84;Auvergne-Rhône-Alpes;03;3;05;014;Avrilly;135;3;138
84;Auvergne-Rhône-Alpes;03;2;13;015;Bagneux;325;11;336
84;Auvergne-Rhône-Alpes;03;2;06;016;Barberier;143;2;145
84;Auvergne-Rhône-Alpes;03;3;08;017;Barrais-Bussolles;191;6;197
84;Auvergne-Rhône-Alpes;03;2;15;018;Bayet;692;14;706
84;Auvergne-Rhône-Alpes;03;2;05;019;Beaulon;1638;24;1662
84;Auvergne-Rhône-Alpes;03;1;03;020;Beaune-d'Allier;293;7;300
84;Auvergne-Rhône-Alpes;03;3;06;021;Bègues;226;2;228
84;Auvergne-Rhône-Alpes;03;3;06;022;Bellenaves;1010;17;1027
84;Auvergne-Rhône-Alpes;03;3;01;023;Bellerive-sur-Allier;8638;228;8866
84;Auvergne-Rhône-Alpes;03;3;14;024;Bert;240;6;246
84;Auvergne-Rhône-Alpes;03;2;14;025;Bessay-sur-Allier;1327;31;1358
84;Auvergne-Rhône-Alpes;03;2;16;026;Besson;765;18;783
84;Auvergne-Rhône-Alpes;03;1;03;027;Bézenet;938;23;961
84;Auvergne-Rhône-Alpes;03;3;08;028;Billezois;372;7;379
84;Auvergne-Rhône-Alpes;03;3;15;029;Billy;777;12;789
84;Auvergne-Rhône-Alpes;03;3;06;030;Biozat;849;15;864
84;Auvergne-Rhône-Alpes;03;1;07;031;Bizeneuille;292;9;301
84;Auvergne-Rhône-Alpes;03;1;03;032;Blomard;245;2;247
84;Auvergne-Rhône-Alpes;03;3;04;033;Bost;185;4;189
84;Auvergne-Rhône-Alpes;03;3;15;034;Boucé;502;12;514
84;Auvergne-Rhône-Alpes;03;3;05;035;Le Bouchaud;213;4;217
84;Auvergne-Rhône-Alpes;03;2;02;036;Bourbon-l'Archambault;2566;72;2638
84;Auvergne-Rhône-Alpes;03;1;02;037;Braize;259;2;261
84;Auvergne-Rhône-Alpes;03;2;16;038;Bransat;515;8;523
84;Auvergne-Rhône-Alpes;03;2;16;039;Bresnay;388;7;395
84;Auvergne-Rhône-Alpes;03;2;16;040;Bressolles;1119;38;1157
84;Auvergne-Rhône-Alpes;03;1;07;041;Le Brethon;323;12;335
84;Auvergne-Rhône-Alpes;03;3;08;042;Le Breuil;529;17;546
84;Auvergne-Rhône-Alpes;03;3;01;043;Broût-Vernet;1180;75;1255
84;Auvergne-Rhône-Alpes;03;3;01;044;Brugheas;1497;36;1533
84;Auvergne-Rhône-Alpes;03;3;08;045;Busset;879;19;898
84;Auvergne-Rhône-Alpes;03;2;02;046;Buxières-les-Mines;1043;23;1066
84;Auvergne-Rhône-Alpes;03;1;11;047;La Celle;409;9;418
84;Auvergne-Rhône-Alpes;03;1;02;048;Cérilly;1307;24;1331
84;Auvergne-Rhône-Alpes;03;2;16;049;Cesset;427;10;437
84;Auvergne-Rhône-Alpes;03;3;08;050;La Chabanne;183;10;193
84;Auvergne-Rhône-Alpes;03;1;07;051;Chambérat;303;6;309
84;Auvergne-Rhône-Alpes;03;1;03;052;Chamblet;1094;29;1123
84;Auvergne-Rhône-Alpes;03;2;06;053;Chantelle;1091;24;1115
84;Auvergne-Rhône-Alpes;03;2;14;054;Chapeau;235;6;241
84;Auvergne-Rhône-Alpes;03;1;07;055;La Chapelaude;986;18;1004
84;Auvergne-Rhône-Alpes;03;3;08;056;La Chapelle;376;7;383
84;Auvergne-Rhône-Alpes;03;2;05;057;La Chapelle-aux-Chasses;205;6;211
84;Auvergne-Rhône-Alpes;03;1;03;058;Chappes;237;6;243
84;Auvergne-Rhône-Alpes;03;2;06;059;Chareil-Cintrat;357;7;364
84;Auvergne-Rhône-Alpes;03;3;17;060;Charmeil;1010;16;1026
84;Auvergne-Rhône-Alpes;03;3;06;061;Charmes;396;6;402
84;Auvergne-Rhône-Alpes;03;2;06;062;Charroux;357;18;375
84;Auvergne-Rhône-Alpes;03;2;05;063;Chassenard;1008;20;1028
84;Auvergne-Rhône-Alpes;03;2;02;064;Château-sur-Allier;180;1;181
84;Auvergne-Rhône-Alpes;03;2;16;065;Châtel-de-Neuvre;543;9;552
84;Auvergne-Rhône-Alpes;03;3;08;066;Châtel-Montagne;336;5;341
84;Auvergne-Rhône-Alpes;03;3;14;067;Châtelperron;142;4;146
84;Auvergne-Rhône-Alpes;03;3;08;068;Châtelus;106;1;107
84;Auvergne-Rhône-Alpes;03;2;16;069;Châtillon;313;6;319
84;Auvergne-Rhône-Alpes;03;1;03;070;Chavenon;134;1;135
84;Auvergne-Rhône-Alpes;03;3;14;071;Chavroches;247;3;250
84;Auvergne-Rhône-Alpes;03;1;07;072;Chazemais;493;12;505
84;Auvergne-Rhône-Alpes;03;2;16;073;Chemilly;639;11;650
84;Auvergne-Rhône-Alpes;03;2;05;074;Chevagnes;658;15;673
84;Auvergne-Rhône-Alpes;03;3;06;075;Chezelle;169;2;171
84;Auvergne-Rhône-Alpes;03;2;05;076;Chézy;235;8;243
84;Auvergne-Rhône-Alpes;03;3;06;077;Chirat-l'Église;128;3;131
84;Auvergne-Rhône-Alpes;03;3;06;078;Chouvigny;233;8;241
84;Auvergne-Rhône-Alpes;03;3;14;079;Cindré;303;8;311
84;Auvergne-Rhône-Alpes;03;3;01;080;Cognat-Lyonne;687;11;698
84;Auvergne-Rhône-Alpes;03;1;03;081;Colombier;331;12;343
84;Auvergne-Rhône-Alpes;03;1;03;082;Commentry;6159;188;6347
84;Auvergne-Rhône-Alpes;03;2;16;083;Contigny;584;13;597
84;Auvergne-Rhône-Alpes;03;1;07;084;Cosne-d'Allier;2036;30;2066
84;Auvergne-Rhône-Alpes;03;2;13;085;Coulandon;648;58;706
84;Auvergne-Rhône-Alpes;03;2;05;086;Coulanges;338;9;347
84;Auvergne-Rhône-Alpes;03;2;02;087;Couleuvre;589;7;596
84;Auvergne-Rhône-Alpes;03;1;07;088;Courçais;325;2;327
84;Auvergne-Rhône-Alpes;03;3;06;089;Coutansouze;153;1;154
84;Auvergne-Rhône-Alpes;03;2;02;090;Couzon;302;8;310
84;Auvergne-Rhône-Alpes;03;3;15;091;Créchy;446;9;455
84;Auvergne-Rhône-Alpes;03;2;16;092;Cressanges;627;13;640
84;Auvergne-Rhône-Alpes;03;3;04;093;Creuzier-le-Neuf;1176;27;1203
84;Auvergne-Rhône-Alpes;03;3;04;094;Creuzier-le-Vieux;3301;102;3403
84;Auvergne-Rhône-Alpes;03;3;04;095;Cusset;12685;486;13171
84;Auvergne-Rhône-Alpes;03;2;06;096;Deneuille-lès-Chantelle;83;1;84
84;Auvergne-Rhône-Alpes;03;1;03;097;Deneuille-les-Mines;361;9;370
84;Auvergne-Rhône-Alpes;03;1;10;098;Désertines;4432;87;4519
84;Auvergne-Rhône-Alpes;03;2;16;099;Deux-Chaises;394;11;405
84;Auvergne-Rhône-Alpes;03;2;05;100;Diou;1390;35;1425
84;Auvergne-Rhône-Alpes;03;1;09;101;Domérat;8742;165;8907
84;Auvergne-Rhône-Alpes;03;2;05;102;Dompierre-sur-Besbre;3038;59;3097
84;Auvergne-Rhône-Alpes;03;3;05;103;Le Donjon;1068;25;1093
84;Auvergne-Rhône-Alpes;03;1;03;104;Doyet;1175;32;1207
84;Auvergne-Rhône-Alpes;03;3;08;105;Droiturier;346;7;353
84;Auvergne-Rhône-Alpes;03;1;11;106;Durdat-Larequille;1322;112;1434
84;Auvergne-Rhône-Alpes;03;3;06;107;Ébreuil;1271;27;1298
84;Auvergne-Rhône-Alpes;03;3;06;108;Échassières;381;6;387
84;Auvergne-Rhône-Alpes;03;3;01;109;Escurolles;778;32;810
84;Auvergne-Rhône-Alpes;03;3;01;110;Espinasse-Vozelle;980;26;1006
84;Auvergne-Rhône-Alpes;03;1;07;111;Estivareilles;1108;23;1131
84;Auvergne-Rhône-Alpes;03;2;06;112;Étroussat;662;9;671
84;Auvergne-Rhône-Alpes;03;3;08;113;Ferrières-sur-Sichon;544;17;561
84;Auvergne-Rhône-Alpes;03;2;14;114;La Ferté-Hauterive;288;7;295
84;Auvergne-Rhône-Alpes;03;2;06;115;Fleuriel;338;7;345
84;Auvergne-Rhône-Alpes;03;2;06;116;Fourilles;194;5;199
84;Auvergne-Rhône-Alpes;03;2;02;117;Franchesse;475;12;487
84;Auvergne-Rhône-Alpes;03;3;06;118;Gannat;5824;197;6021
84;Auvergne-Rhône-Alpes;03;2;05;119;Gannay-sur-Loire;412;4;416
84;Auvergne-Rhône-Alpes;03;2;05;120;Garnat-sur-Engièvre;710;12;722
84;Auvergne-Rhône-Alpes;03;2;19;121;Gennetines;659;18;677
84;Auvergne-Rhône-Alpes;03;2;16;122;Gipcy;237;6;243
84;Auvergne-Rhône-Alpes;03;2;14;124;Gouise;218;3;221
84;Auvergne-Rhône-Alpes;03;3;08;125;La Guillermie;126;2;128
84;Auvergne-Rhône-Alpes;03;1;07;158;Haut-Bocage ;879;19;898
84;Auvergne-Rhône-Alpes;03;3;01;126;Hauterive;1169;13;1182
84;Auvergne-Rhône-Alpes;03;1;07;127;Hérisson;622;10;632
84;Auvergne-Rhône-Alpes;03;1;07;128;Huriel;2642;57;2699
84;Auvergne-Rhône-Alpes;03;1;03;129;Hyds;316;13;329
84;Auvergne-Rhône-Alpes;03;1;02;130;Isle-et-Bardais;278;6;284
84;Auvergne-Rhône-Alpes;03;3;08;131;Isserpent;544;13;557
84;Auvergne-Rhône-Alpes;03;3;14;132;Jaligny-sur-Besbre;563;15;578
84;Auvergne-Rhône-Alpes;03;3;06;133;Jenzat;513;10;523
84;Auvergne-Rhône-Alpes;03;2;16;134;Laféline;192;3;195
84;Auvergne-Rhône-Alpes;03;3;06;135;Lalizolle;402;9;411
84;Auvergne-Rhône-Alpes;03;1;12;136;Lamaids;230;5;235
84;Auvergne-Rhône-Alpes;03;3;15;137;Langy;268;6;274
84;Auvergne-Rhône-Alpes;03;3;08;138;Lapalisse;3141;73;3214
84;Auvergne-Rhône-Alpes;03;3;08;139;Laprugne;315;11;326
84;Auvergne-Rhône-Alpes;03;1;12;140;Lavault-Sainte-Anne;1159;33;1192
84;Auvergne-Rhône-Alpes;03;3;08;141;Lavoine;147;2;149
84;Auvergne-Rhône-Alpes;03;3;05;142;Lenax;245;5;250
84;Auvergne-Rhône-Alpes;03;1;02;143;Lételon;99;3;102
84;Auvergne-Rhône-Alpes;03;3;14;144;Liernolles;212;8;220
84;Auvergne-Rhône-Alpes;03;1;12;145;Lignerolles;738;13;751
84;Auvergne-Rhône-Alpes;03;2;02;146;Limoise;155;35;190
84;Auvergne-Rhône-Alpes;03;3;05;147;Loddes;167;2;169
84;Auvergne-Rhône-Alpes;03;2;15;148;Loriges;349;6;355
84;Auvergne-Rhône-Alpes;03;2;15;149;Louchy-Montfand;440;16;456
84;Auvergne-Rhône-Alpes;03;1;07;150;Louroux-Bourbonnais;207;7;214
84;Auvergne-Rhône-Alpes;03;1;03;151;Louroux-de-Beaune;161;3;164
84;Auvergne-Rhône-Alpes;03;3;06;152;Louroux-de-Bouble;235;7;242
84;Auvergne-Rhône-Alpes;03;3;05;154;Luneau;284;3;287
84;Auvergne-Rhône-Alpes;03;2;02;155;Lurcy-Lévis;1879;42;1921
84;Auvergne-Rhône-Alpes;03;2;05;156;Lusigny;1692;54;1746
84;Auvergne-Rhône-Alpes;03;3;15;157;Magnet;1004;22;1026
84;Auvergne-Rhône-Alpes;03;1;03;159;Malicorne;783;15;798
84;Auvergne-Rhône-Alpes;03;2;15;160;Marcenat;407;4;411
84;Auvergne-Rhône-Alpes;03;1;11;161;Marcillat-en-Combraille;903;29;932
84;Auvergne-Rhône-Alpes;03;2;16;162;Marigny;204;6;210
84;Auvergne-Rhône-Alpes;03;3;08;163;Mariol;774;22;796
84;Auvergne-Rhône-Alpes;03;3;06;164;Le Mayet-d'École;272;2;274
84;Auvergne-Rhône-Alpes;03;3;08;165;Le Mayet-de-Montagne;1383;85;1468
84;Auvergne-Rhône-Alpes;03;3;06;166;Mazerier;304;5;309
84;Auvergne-Rhône-Alpes;03;1;11;167;Mazirat;284;4;288
84;Auvergne-Rhône-Alpes;03;1;02;168;Meaulne-Vitray;904;15;919
84;Auvergne-Rhône-Alpes;03;2;16;169;Meillard;328;6;334
84;Auvergne-Rhône-Alpes;03;2;16;170;Meillers;134;6;140
84;Auvergne-Rhône-Alpes;03;2;14;171;Mercy;255;6;261
84;Auvergne-Rhône-Alpes;03;1;07;172;Mesples;121;2;123
84;Auvergne-Rhône-Alpes;03;2;05;173;Molinet;1138;33;1171
84;Auvergne-Rhône-Alpes;03;3;08;174;Molles;909;25;934
84;Auvergne-Rhône-Alpes;03;3;06;175;Monestier;281;12;293
84;Auvergne-Rhône-Alpes;03;2;16;176;Monétay-sur-Allier;543;10;553
84;Auvergne-Rhône-Alpes;03;2;05;177;Monétay-sur-Loire;258;3;261
84;Auvergne-Rhône-Alpes;03;3;15;179;Montaigu-le-Blin;299;10;309
84;Auvergne-Rhône-Alpes;03;3;05;178;Montaiguët-en-Forez;305;6;311
84;Auvergne-Rhône-Alpes;03;2;14;180;Montbeugny;672;11;683
84;Auvergne-Rhône-Alpes;03;3;05;181;Montcombroux-les-Mines;304;3;307
84;Auvergne-Rhône-Alpes;03;3;06;182;Monteignet-sur-l'Andelot;264;1;265
84;Auvergne-Rhône-Alpes;03;2;16;183;Le Montet;468;4;472
84;Auvergne-Rhône-Alpes;03;2;13;184;Montilly;505;8;513
84;Auvergne-Rhône-Alpes;03;1;97;185;Montluçon;34938;1077;36015
84;Auvergne-Rhône-Alpes;03;1;03;186;Montmarault;1524;21;1545
84;Auvergne-Rhône-Alpes;03;3;15;187;Montoldre;631;9;640
84;Auvergne-Rhône-Alpes;03;2;15;188;Montord;215;1;216
84;Auvergne-Rhône-Alpes;03;1;03;189;Montvicq;724;24;748
84;Auvergne-Rhône-Alpes;03;2;98;190;Moulins;19563;554;20117
84;Auvergne-Rhône-Alpes;03;1;03;191;Murat;287;8;295
84;Auvergne-Rhône-Alpes;03;3;06;192;Nades;152;3;155
84;Auvergne-Rhône-Alpes;03;1;07;193;Nassigny;184;4;188
84;Auvergne-Rhône-Alpes;03;3;06;194;Naves;123;2;125
84;Auvergne-Rhône-Alpes;03;1;11;195;Néris-les-Bains;2544;94;2638
84;Auvergne-Rhône-Alpes;03;3;05;196;Neuilly-en-Donjon;222;3;225
84;Auvergne-Rhône-Alpes;03;2;14;197;Neuilly-le-Réal;1455;32;1487
84;Auvergne-Rhône-Alpes;03;2;02;198;Neure;188;0;188
84;Auvergne-Rhône-Alpes;03;2;13;200;Neuvy;1547;253;1800
84;Auvergne-Rhône-Alpes;03;3;08;201;Nizerolles;308;13;321
84;Auvergne-Rhône-Alpes;03;2;16;202;Noyant-d'Allier;614;16;630
84;Auvergne-Rhône-Alpes;03;2;05;203;Paray-le-Frésil;387;9;396
84;Auvergne-Rhône-Alpes;03;2;15;204;Paray-sous-Briailles;627;18;645
84;Auvergne-Rhône-Alpes;03;3;08;205;Périgny;439;11;450
84;Auvergne-Rhône-Alpes;03;1;11;206;La Petite-Marche;172;6;178
84;Auvergne-Rhône-Alpes;03;2;05;207;Pierrefitte-sur-Loire;511;13;524
84;Auvergne-Rhône-Alpes;03;3;05;208;Le Pin;417;9;426
84;Auvergne-Rhône-Alpes;03;3;06;209;Poëzat;149;3;152
84;Auvergne-Rhône-Alpes;03;2;02;210;Pouzy-Mésangy;399;10;409
84;Auvergne-Rhône-Alpes;03;1;12;211;Prémilhat;2482;49;2531
84;Auvergne-Rhône-Alpes;03;1;12;212;Quinssaines;1499;25;1524
84;Auvergne-Rhône-Alpes;03;1;07;213;Reugny;250;4;254
84;Auvergne-Rhône-Alpes;03;2;16;214;Rocles;381;3;384
84;Auvergne-Rhône-Alpes;03;3;15;215;Rongères;558;8;566
84;Auvergne-Rhône-Alpes;03;1;11;216;Ronnet;173;3;176
84;Auvergne-Rhône-Alpes;03;1;03;217;Saint-Angel;758;35;793
84;Auvergne-Rhône-Alpes;03;2;02;218;Saint-Aubin-le-Monial;269;8;277
84;Auvergne-Rhône-Alpes;03;1;03;219;Saint-Bonnet-de-Four;213;5;218
84;Auvergne-Rhône-Alpes;03;3;06;220;Saint-Bonnet-de-Rochefort;704;15;719
84;Auvergne-Rhône-Alpes;03;1;02;221;Saint-Bonnet-Tronçais;727;8;735
84;Auvergne-Rhône-Alpes;03;1;07;222;Saint-Caprais;91;5;96
84;Auvergne-Rhône-Alpes;03;3;08;223;Saint-Christophe;454;14;468
84;Auvergne-Rhône-Alpes;03;3;08;224;Saint-Clément;291;7;298
84;Auvergne-Rhône-Alpes;03;1;07;225;Saint-Désiré;453;9;462
84;Auvergne-Rhône-Alpes;03;3;05;226;Saint-Didier-en-Donjon;250;5;255
84;Auvergne-Rhône-Alpes;03;3;01;227;Saint-Didier-la-Forêt;373;8;381
84;Auvergne-Rhône-Alpes;03;1;07;228;Saint-Éloy-d'Allier;40;0;40
84;Auvergne-Rhône-Alpes;03;2;19;229;Saint-Ennemond;619;18;637
84;Auvergne-Rhône-Alpes;03;3;08;230;Saint-Étienne-de-Vicq;527;16;543
84;Auvergne-Rhône-Alpes;03;1;11;231;Saint-Fargeol;189;5;194
84;Auvergne-Rhône-Alpes;03;3;15;232;Saint-Félix;307;9;316
84;Auvergne-Rhône-Alpes;03;1;11;233;Saint-Genest;401;8;409
84;Auvergne-Rhône-Alpes;03;2;14;234;Saint-Gérand-de-Vaux;375;11;386
84;Auvergne-Rhône-Alpes;03;3;15;235;Saint-Gérand-le-Puy;976;10;986
84;Auvergne-Rhône-Alpes;03;2;06;237;Saint-Germain-de-Salles;426;9;435
84;Auvergne-Rhône-Alpes;03;3;17;236;Saint-Germain-des-Fossés;3618;69;3687
84;Auvergne-Rhône-Alpes;03;2;02;238;Saint-Hilaire;536;9;545
84;Auvergne-Rhône-Alpes;03;3;05;239;Saint-Léger-sur-Vouzance;263;9;272
84;Auvergne-Rhône-Alpes;03;3;14;240;Saint-Léon;545;11;556
84;Auvergne-Rhône-Alpes;03;2;02;241;Saint-Léopardin-d'Augy;367;46;413
84;Auvergne-Rhône-Alpes;03;3;15;242;Saint-Loup;568;14;582
84;Auvergne-Rhône-Alpes;03;1;11;244;Saint-Marcel-en-Marcillat;129;2;131
84;Auvergne-Rhône-Alpes;03;1;03;243;Saint-Marcel-en-Murat;123;6;129
84;Auvergne-Rhône-Alpes;03;2;05;245;Saint-Martin-des-Lais;124;1;125
84;Auvergne-Rhône-Alpes;03;1;07;246;Saint-Martinien;596;12;608
84;Auvergne-Rhône-Alpes;03;2;16;247;Saint-Menoux;1076;32;1108
84;Auvergne-Rhône-Alpes;03;3;08;248;Saint-Nicolas-des-Biefs;168;2;170
84;Auvergne-Rhône-Alpes;03;1;07;249;Saint-Palais;163;2;165
84;Auvergne-Rhône-Alpes;03;3;08;250;Saint-Pierre-Laval;351;6;357
84;Auvergne-Rhône-Alpes;03;2;02;251;Saint-Plaisir;378;10;388
84;Auvergne-Rhône-Alpes;03;3;01;252;Saint-Pont;668;15;683
84;Auvergne-Rhône-Alpes;03;2;05;253;Saint-Pourçain-sur-Besbre;398;10;408
84;Auvergne-Rhône-Alpes;03;2;15;254;Saint-Pourçain-sur-Sioule;5182;118;5300
84;Auvergne-Rhône-Alpes;03;3;06;255;Saint-Priest-d'Andelot;144;4;148
84;Auvergne-Rhône-Alpes;03;1;03;256;Saint-Priest-en-Murat;219;5;224
84;Auvergne-Rhône-Alpes;03;3;08;257;Saint-Prix;799;23;822
84;Auvergne-Rhône-Alpes;03;3;17;258;Saint-Rémy-en-Rollat;1716;25;1741
84;Auvergne-Rhône-Alpes;03;1;07;259;Saint-Sauvier;341;3;344
84;Auvergne-Rhône-Alpes;03;2;16;260;Saint-Sornin;224;5;229
84;Auvergne-Rhône-Alpes;03;1;09;262;Saint-Victor;2083;38;2121
84;Auvergne-Rhône-Alpes;03;2;14;263;Saint-Voir;186;8;194
84;Auvergne-Rhône-Alpes;03;3;18;264;Saint-Yorre;2560;53;2613
84;Auvergne-Rhône-Alpes;03;1;11;261;Sainte-Thérence;182;7;189
84;Auvergne-Rhône-Alpes;03;2;05;265;Saligny-sur-Roudon;676;78;754
84;Auvergne-Rhône-Alpes;03;3;15;266;Sanssat;265;7;272
84;Auvergne-Rhône-Alpes;03;2;15;267;Saulcet;678;24;702
84;Auvergne-Rhône-Alpes;03;3;06;268;Saulzet;385;3;388
84;Auvergne-Rhône-Alpes;03;1;07;269;Sauvagny;86;2;88
84;Auvergne-Rhône-Alpes;03;1;03;270;Sazeret;145;5;150
84;Auvergne-Rhône-Alpes;03;3;01;271;Serbannes;812;33;845
84;Auvergne-Rhône-Alpes;03;3;08;272;Servilly;288;7;295
84;Auvergne-Rhône-Alpes;03;3;15;273;Seuillet;500;15;515
84;Auvergne-Rhône-Alpes;03;3;14;274;Sorbier;316;6;322
84;Auvergne-Rhône-Alpes;03;2;16;275;Souvigny;1788;50;1838
84;Auvergne-Rhône-Alpes;03;3;06;276;Sussat;100;6;106
84;Auvergne-Rhône-Alpes;03;3;06;277;Target;254;5;259
84;Auvergne-Rhône-Alpes;03;2;06;278;Taxat-Senat;194;4;198
84;Auvergne-Rhône-Alpes;03;1;12;279;Teillet-Argenty;555;10;565
84;Auvergne-Rhône-Alpes;03;1;11;280;Terjat;184;9;193
84;Auvergne-Rhône-Alpes;03;2;16;281;Le Theil;397;3;400
84;Auvergne-Rhône-Alpes;03;1;02;282;Theneuille;364;13;377
84;Auvergne-Rhône-Alpes;03;2;05;283;Thiel-sur-Acolin;1095;19;1114
84;Auvergne-Rhône-Alpes;03;3;14;284;Thionne;302;9;311
84;Auvergne-Rhône-Alpes;03;1;07;285;Tortezais;177;8;185
84;Auvergne-Rhône-Alpes;03;2;14;286;Toulon-sur-Allier;1137;20;1157
84;Auvergne-Rhône-Alpes;03;2;16;287;Treban;380;9;389
84;Auvergne-Rhône-Alpes;03;1;07;288;Treignat;390;8;398
84;Auvergne-Rhône-Alpes;03;3;14;289;Treteau;517;12;529
84;Auvergne-Rhône-Alpes;03;2;19;290;Trévol;1636;59;1695
84;Auvergne-Rhône-Alpes;03;3;14;291;Trézelles;409;13;422
84;Auvergne-Rhône-Alpes;03;2;16;292;Tronget;888;12;900
84;Auvergne-Rhône-Alpes;03;1;02;293;Urçay;274;10;284
84;Auvergne-Rhône-Alpes;03;2;06;294;Ussel-d'Allier;165;1;166
84;Auvergne-Rhône-Alpes;03;3;06;295;Valignat;76;0;76
84;Auvergne-Rhône-Alpes;03;1;02;296;Valigny;377;12;389
84;Auvergne-Rhône-Alpes;03;1;07;297;Vallon-en-Sully;1551;26;1577
84;Auvergne-Rhône-Alpes;03;3;15;298;Varennes-sur-Allier;3593;73;3666
84;Auvergne-Rhône-Alpes;03;3;14;299;Varennes-sur-Tèche;237;8;245
84;Auvergne-Rhône-Alpes;03;2;05;300;Vaumas;537;10;547
84;Auvergne-Rhône-Alpes;03;1;09;301;Vaux;1143;26;1169
84;Auvergne-Rhône-Alpes;03;3;06;302;Veauce;39;1;40
84;Auvergne-Rhône-Alpes;03;1;07;303;Venas;236;10;246
84;Auvergne-Rhône-Alpes;03;3;01;304;Vendat;2232;59;2291
84;Auvergne-Rhône-Alpes;03;1;03;305;Verneix;599;15;614
84;Auvergne-Rhône-Alpes;03;3;08;306;Le Vernet;1929;52;1981
84;Auvergne-Rhône-Alpes;03;2;16;307;Verneuil-en-Bourbonnais;238;3;241
84;Auvergne-Rhône-Alpes;03;1;03;308;Vernusse;152;4;156
84;Auvergne-Rhône-Alpes;03;2;02;309;Le Veurdre;455;10;465
84;Auvergne-Rhône-Alpes;03;3;99;310;Vichy;24854;330;25184
84;Auvergne-Rhône-Alpes;03;3;06;311;Vicq;313;7;320
84;Auvergne-Rhône-Alpes;03;2;02;312;Vieure;277;10;287
84;Auvergne-Rhône-Alpes;03;1;02;313;Le Vilhain;275;9;284
84;Auvergne-Rhône-Alpes;03;1;11;314;Villebret;1319;36;1355
84;Auvergne-Rhône-Alpes;03;1;03;315;Villefranche-d'Allier;1305;39;1344
84;Auvergne-Rhône-Alpes;03;2;19;316;Villeneuve-sur-Allier;1073;16;1089
84;Auvergne-Rhône-Alpes;03;1;07;317;Viplaix;297;8;305
84;Auvergne-Rhône-Alpes;03;2;06;319;Voussac;480;10;490
84;Auvergne-Rhône-Alpes;03;2;02;320;Ygrande;776;16;792
84;Auvergne-Rhône-Alpes;03;2;19;321;Yzeure;12899;520;13419
93;Provence-Alpes-Côte d'Azur;04;3;05;001;Aiglun;1432;28;1460
93;Provence-Alpes-Côte d'Azur;04;4;15;004;Allemagne-en-Provence;544;29;573
93;Provence-Alpes-Côte d'Azur;04;2;02;005;Allons;138;2;140
93;Provence-Alpes-Côte d'Azur;04;2;02;006;Allos;811;8;819
93;Provence-Alpes-Côte d'Azur;04;2;02;007;Angles;68;0;68
93;Provence-Alpes-Côte d'Azur;04;2;02;008;Annot;1036;35;1071
93;Provence-Alpes-Côte d'Azur;04;3;13;009;Archail;15;0;15
93;Provence-Alpes-Côte d'Azur;04;4;11;012;Aubenas-les-Alpes;96;0;96
93;Provence-Alpes-Côte d'Azur;04;4;03;013;Aubignosc;599;15;614
93;Provence-Alpes-Côte d'Azur;04;4;14;016;Authon;63;0;63
93;Provence-Alpes-Côte d'Azur;04;3;13;017;Auzet;98;5;103
93;Provence-Alpes-Côte d'Azur;04;4;11;018;Banon;999;14;1013
93;Provence-Alpes-Côte d'Azur;04;1;01;019;Barcelonnette;2575;198;2773
93;Provence-Alpes-Côte d'Azur;04;3;13;020;Barles;132;2;134
93;Provence-Alpes-Côte d'Azur;04;3;05;021;Barras;145;4;149
93;Provence-Alpes-Côte d'Azur;04;2;12;022;Barrême;424;8;432
93;Provence-Alpes-Côte d'Azur;04;4;13;023;Bayons;186;4;190
93;Provence-Alpes-Côte d'Azur;04;3;13;024;Beaujeu;128;3;131
93;Provence-Alpes-Côte d'Azur;04;2;02;025;Beauvezer;381;14;395
93;Provence-Alpes-Côte d'Azur;04;4;13;026;Bellaffaire;140;6;146
93;Provence-Alpes-Côte d'Azur;04;4;14;027;Bevons;247;55;302
93;Provence-Alpes-Côte d'Azur;04;3;12;028;Beynes;123;9;132
93;Provence-Alpes-Côte d'Azur;04;2;12;030;Blieux;58;0;58
93;Provence-Alpes-Côte d'Azur;04;3;12;031;Bras-d'Asse;562;10;572
93;Provence-Alpes-Côte d'Azur;04;2;02;032;Braux;126;0;126
93;Provence-Alpes-Côte d'Azur;04;4;06;034;La Brillanne;1137;15;1152
93;Provence-Alpes-Côte d'Azur;04;4;15;035;Brunet;290;6;296
93;Provence-Alpes-Côte d'Azur;04;3;13;036;Le Brusquet;959;28;987
93;Provence-Alpes-Côte d'Azur;04;4;13;037;Le Caire;74;2;76
93;Provence-Alpes-Côte d'Azur;04;2;02;039;Castellane;1497;39;1536
93;Provence-Alpes-Côte d'Azur;04;3;04;040;Le Castellard-Mélan;63;1;64
93;Provence-Alpes-Côte d'Azur;04;4;12;041;Le Castellet;296;6;302
93;Provence-Alpes-Côte d'Azur;04;2;02;042;Castellet-lès-Sausses;141;1;142
93;Provence-Alpes-Côte d'Azur;04;4;11;045;Céreste;1203;21;1224
93;Provence-Alpes-Côte d'Azur;04;3;12;046;Le Chaffaut-Saint-Jurson;686;111;797
93;Provence-Alpes-Côte d'Azur;04;3;05;047;Champtercier;850;20;870
93;Provence-Alpes-Côte d'Azur;04;3;03;049;Château-Arnoux-Saint-Auban;5120;109;5229
93;Provence-Alpes-Côte d'Azur;04;4;13;050;Châteaufort;28;0;28
93;Provence-Alpes-Côte d'Azur;04;4;14;051;Châteauneuf-Miravail;70;2;72
93;Provence-Alpes-Côte d'Azur;04;4;03;053;Châteauneuf-Val-Saint-Donat;497;20;517
93;Provence-Alpes-Côte d'Azur;04;3;12;054;Châteauredon;74;1;75
93;Provence-Alpes-Côte d'Azur;04;2;12;055;Chaudon-Norante;185;0;185
93;Provence-Alpes-Côte d'Azur;04;4;13;057;Clamensane;174;3;177
93;Provence-Alpes-Côte d'Azur;04;4;13;058;Claret;271;6;277
93;Provence-Alpes-Côte d'Azur;04;2;12;059;Clumanc;217;1;218
93;Provence-Alpes-Côte d'Azur;04;2;02;061;Colmars;490;5;495
93;Provence-Alpes-Côte d'Azur;04;1;01;062;La Condamine-Châtelard;152;4;156
93;Provence-Alpes-Côte d'Azur;04;4;09;063;Corbières-en-Provence;1196;32;1228
93;Provence-Alpes-Côte d'Azur;04;4;06;065;Cruis;641;6;647
93;Provence-Alpes-Côte d'Azur;04;4;13;066;Curbans;573;12;585
93;Provence-Alpes-Côte d'Azur;04;4;14;067;Curel;52;1;53
93;Provence-Alpes-Côte d'Azur;04;4;11;068;Dauphin;834;14;848
93;Provence-Alpes-Côte d'Azur;04;2;02;069;Demandolx;134;3;137
93;Provence-Alpes-Côte d'Azur;04;3;98;070;Digne-les-Bains;16333;907;17240
93;Provence-Alpes-Côte d'Azur;04;3;13;072;Draix;113;2;115
93;Provence-Alpes-Côte d'Azur;04;1;01;073;Enchastrayes;392;12;404
93;Provence-Alpes-Côte d'Azur;04;3;04;074;Entrages;103;2;105
93;Provence-Alpes-Côte d'Azur;04;4;14;075;Entrepierres;373;11;384
93;Provence-Alpes-Côte d'Azur;04;2;02;076;Entrevaux;834;22;856
93;Provence-Alpes-Côte d'Azur;04;4;12;077;Entrevennes;170;3;173
93;Provence-Alpes-Côte d'Azur;04;3;03;079;L' Escale;1380;37;1417
93;Provence-Alpes-Côte d'Azur;04;4;15;081;Esparron-de-Verdon;396;4;400
93;Provence-Alpes-Côte d'Azur;04;3;12;084;Estoublon;490;7;497
93;Provence-Alpes-Côte d'Azur;04;1;01;086;Faucon-de-Barcelonnette;312;17;329
93;Provence-Alpes-Côte d'Azur;04;4;13;085;Faucon-du-Caire;56;2;58
93;Provence-Alpes-Côte d'Azur;04;4;06;087;Fontienne;130;2;132
93;Provence-Alpes-Côte d'Azur;04;4;06;088;Forcalquier;5069;87;5156
93;Provence-Alpes-Côte d'Azur;04;2;02;090;Le Fugeret;206;4;210
93;Provence-Alpes-Côte d'Azur;04;3;03;091;Ganagobie;92;0;92
93;Provence-Alpes-Côte d'Azur;04;2;02;092;La Garde;104;4;108
93;Provence-Alpes-Côte d'Azur;04;4;13;093;Gigors;61;1;62
93;Provence-Alpes-Côte d'Azur;04;4;15;094;Gréoux-les-Bains;2635;48;2683
93;Provence-Alpes-Côte d'Azur;04;3;04;177;Hautes-Duyes;44;0;44
93;Provence-Alpes-Côte d'Azur;04;4;11;095;L' Hospitalet;91;0;91
93;Provence-Alpes-Côte d'Azur;04;1;01;096;Jausiers;1131;26;1157
93;Provence-Alpes-Côte d'Azur;04;3;13;097;La Javie;394;5;399
93;Provence-Alpes-Côte d'Azur;04;2;02;099;Lambruisse;91;5;96
93;Provence-Alpes-Côte d'Azur;04;4;06;101;Lardiers;133;3;136
93;Provence-Alpes-Côte d'Azur;04;1;01;102;Le Lauzet-Ubaye;181;3;184
93;Provence-Alpes-Côte d'Azur;04;4;06;104;Limans;380;11;391
93;Provence-Alpes-Côte d'Azur;04;4;06;106;Lurs;381;10;391
93;Provence-Alpes-Côte d'Azur;04;3;12;107;Majastres;4;0;4
93;Provence-Alpes-Côte d'Azur;04;3;05;108;Malijai;1967;30;1997
93;Provence-Alpes-Côte d'Azur;04;3;06;109;Mallefougasse-Augès;328;4;332
93;Provence-Alpes-Côte d'Azur;04;3;05;110;Mallemoisson;1029;29;1058
93;Provence-Alpes-Côte d'Azur;04;4;11;111;Mane;1354;28;1382
93;Provence-Alpes-Côte d'Azur;04;4;99;112;Manosque;22485;672;23157
93;Provence-Alpes-Côte d'Azur;04;3;04;113;Marcoux;457;15;472
93;Provence-Alpes-Côte d'Azur;04;2;02;115;Méailles;118;2;120
93;Provence-Alpes-Côte d'Azur;04;3;10;116;Les Mées;3740;44;3784
93;Provence-Alpes-Côte d'Azur;04;4;13;118;Melve;123;1;124
93;Provence-Alpes-Côte d'Azur;04;1;01;161;Méolans-Revel;334;8;342
93;Provence-Alpes-Côte d'Azur;04;3;12;121;Mézel;646;11;657
93;Provence-Alpes-Côte d'Azur;04;3;05;122;Mirabeau;511;10;521
93;Provence-Alpes-Côte d'Azur;04;4;14;123;Mison;1125;29;1154
93;Provence-Alpes-Côte d'Azur;04;4;15;124;Montagnac-Montpezat;420;6;426
93;Provence-Alpes-Côte d'Azur;04;3;13;126;Montclar;409;15;424
93;Provence-Alpes-Côte d'Azur;04;4;03;127;Montfort;326;3;329
93;Provence-Alpes-Côte d'Azur;04;4;07;128;Montfuron;216;9;225
93;Provence-Alpes-Côte d'Azur;04;4;11;129;Montjustin;59;1;60
93;Provence-Alpes-Côte d'Azur;04;4;06;130;Montlaux;199;2;201
93;Provence-Alpes-Côte d'Azur;04;4;11;132;Montsalier;142;1;143
93;Provence-Alpes-Côte d'Azur;04;2;02;133;Moriez;237;1;238
93;Provence-Alpes-Côte d'Azur;04;4;13;134;La Motte-du-Caire;557;16;573
93;Provence-Alpes-Côte d'Azur;04;3;12;135;Moustiers-Sainte-Marie;711;15;726
93;Provence-Alpes-Côte d'Azur;04;2;02;136;La Mure-Argens;319;8;327
93;Provence-Alpes-Côte d'Azur;04;4;13;137;Nibles;41;0;41
93;Provence-Alpes-Côte d'Azur;04;4;06;138;Niozelles;278;6;284
93;Provence-Alpes-Côte d'Azur;04;4;14;139;Noyers-sur-Jabron;524;9;533
93;Provence-Alpes-Côte d'Azur;04;4;14;140;Les Omergues;128;3;131
93;Provence-Alpes-Côte d'Azur;04;4;06;141;Ongles;367;9;376
93;Provence-Alpes-Côte d'Azur;04;4;11;142;Oppedette;53;0;53
93;Provence-Alpes-Côte d'Azur;04;4;10;143;Oraison;5891;74;5965
93;Provence-Alpes-Côte d'Azur;04;2;12;144;La Palud-sur-Verdon;350;1;351
93;Provence-Alpes-Côte d'Azur;04;4;14;145;Peipin;1455;37;1492
93;Provence-Alpes-Côte d'Azur;04;2;02;148;Peyroules;247;9;256
93;Provence-Alpes-Côte d'Azur;04;3;03;149;Peyruis;2824;43;2867
93;Provence-Alpes-Côte d'Azur;04;4;13;150;Piégut;194;4;198
93;Provence-Alpes-Côte d'Azur;04;4;06;151;Pierrerue;506;13;519
93;Provence-Alpes-Côte d'Azur;04;4;07;152;Pierrevert;3890;125;4015
93;Provence-Alpes-Côte d'Azur;04;1;01;154;Pontis;88;1;89
93;Provence-Alpes-Côte d'Azur;04;3;13;155;Prads-Haute-Bléone;180;1;181
93;Provence-Alpes-Côte d'Azur;04;4;12;156;Puimichel;257;1;258
93;Provence-Alpes-Côte d'Azur;04;4;12;157;Puimoisson;707;8;715
93;Provence-Alpes-Côte d'Azur;04;4;15;158;Quinson;407;8;415
93;Provence-Alpes-Côte d'Azur;04;4;11;159;Redortiers;86;5;91
93;Provence-Alpes-Côte d'Azur;04;4;11;160;Reillanne;1679;37;1716
93;Provence-Alpes-Côte d'Azur;04;4;11;162;Revest-des-Brousses;263;6;269
93;Provence-Alpes-Côte d'Azur;04;4;11;163;Revest-du-Bion;544;12;556
93;Provence-Alpes-Côte d'Azur;04;4;06;164;Revest-Saint-Martin;87;1;88
93;Provence-Alpes-Côte d'Azur;04;4;12;166;Riez;1791;41;1832
93;Provence-Alpes-Côte d'Azur;04;3;04;167;La Robine-sur-Galabre;293;5;298
93;Provence-Alpes-Côte d'Azur;04;4;11;169;La Rochegiron;104;3;107
93;Provence-Alpes-Côte d'Azur;04;2;02;170;La Rochette;72;0;72
93;Provence-Alpes-Côte d'Azur;04;2;02;171;Rougon;116;0;116
93;Provence-Alpes-Côte d'Azur;04;4;12;172;Roumoules;742;10;752
93;Provence-Alpes-Côte d'Azur;04;2;02;173;Saint-André-les-Alpes;1007;21;1028
93;Provence-Alpes-Côte d'Azur;04;2;02;174;Saint-Benoît;147;2;149
93;Provence-Alpes-Côte d'Azur;04;4;06;178;Saint-Étienne-les-Orgues;1320;35;1355
93;Provence-Alpes-Côte d'Azur;04;4;14;179;Saint-Geniez;101;2;103
93;Provence-Alpes-Côte d'Azur;04;2;12;180;Saint-Jacques;78;4;82
93;Provence-Alpes-Côte d'Azur;04;3;12;181;Saint-Jeannet;50;1;51
93;Provence-Alpes-Côte d'Azur;04;3;12;182;Saint-Julien-d'Asse;213;2;215
93;Provence-Alpes-Côte d'Azur;04;2;02;183;Saint-Julien-du-Verdon;143;3;146
93;Provence-Alpes-Côte d'Azur;04;3;12;184;Saint-Jurs;138;3;141
93;Provence-Alpes-Côte d'Azur;04;4;15;186;Saint-Laurent-du-Verdon;99;4;103
93;Provence-Alpes-Côte d'Azur;04;2;12;187;Saint-Lions;45;1;46
93;Provence-Alpes-Côte d'Azur;04;4;11;188;Saint-Maime;867;8;875
93;Provence-Alpes-Côte d'Azur;04;4;15;189;Saint-Martin-de-Brômes;608;14;622
93;Provence-Alpes-Côte d'Azur;04;4;08;190;Saint-Martin-les-Eaux;113;3;116
93;Provence-Alpes-Côte d'Azur;04;3;13;191;Saint-Martin-lès-Seyne;13;2;15
93;Provence-Alpes-Côte d'Azur;04;4;11;192;Saint-Michel-l'Observatoire;1238;24;1262
93;Provence-Alpes-Côte d'Azur;04;1;01;193;Saint-Paul-sur-Ubaye;179;7;186
93;Provence-Alpes-Côte d'Azur;04;2;02;194;Saint-Pierre;95;2;97
93;Provence-Alpes-Côte d'Azur;04;1;01;195;Saint-Pons;611;13;624
93;Provence-Alpes-Côte d'Azur;04;4;14;199;Saint-Vincent-sur-Jabron;184;4;188
93;Provence-Alpes-Côte d'Azur;04;4;11;175;Sainte-Croix-à-Lauze;91;1;92
93;Provence-Alpes-Côte d'Azur;04;3;15;176;Sainte-Croix-du-Verdon;119;4;123
93;Provence-Alpes-Côte d'Azur;04;4;09;197;Sainte-Tulle;3407;78;3485
93;Provence-Alpes-Côte d'Azur;04;4;14;200;Salignac;635;21;656
93;Provence-Alpes-Côte d'Azur;04;4;11;201;Saumane;122;3;125
93;Provence-Alpes-Côte d'Azur;04;2;02;202;Sausses;129;2;131
93;Provence-Alpes-Côte d'Azur;04;3;13;203;Selonnet;478;9;487
93;Provence-Alpes-Côte d'Azur;04;2;12;204;Senez;165;4;169
93;Provence-Alpes-Côte d'Azur;04;3;13;205;Seyne;1371;27;1398
93;Provence-Alpes-Côte d'Azur;04;4;06;206;Sigonce;425;8;433
93;Provence-Alpes-Côte d'Azur;04;4;13;207;Sigoyer;104;4;108
93;Provence-Alpes-Côte d'Azur;04;4;11;208;Simiane-la-Rotonde;599;16;615
93;Provence-Alpes-Côte d'Azur;04;4;14;209;Sisteron;7579;238;7817
93;Provence-Alpes-Côte d'Azur;04;2;02;210;Soleilhas;90;4;94
93;Provence-Alpes-Côte d'Azur;04;4;14;211;Sourribes;178;3;181
93;Provence-Alpes-Côte d'Azur;04;2;12;214;Tartonne;133;1;134
93;Provence-Alpes-Côte d'Azur;04;4;13;216;Thèze;233;5;238
93;Provence-Alpes-Côte d'Azur;04;3;04;217;Thoard;735;19;754
93;Provence-Alpes-Côte d'Azur;04;2;02;218;Thorame-Basse;228;3;231
93;Provence-Alpes-Côte d'Azur;04;2;02;219;Thorame-Haute;243;6;249
93;Provence-Alpes-Côte d'Azur;04;1;01;220;Les Thuiles;388;11;399
93;Provence-Alpes-Côte d'Azur;04;4;13;222;Turriers;326;8;334
93;Provence-Alpes-Côte d'Azur;04;1;01;033;Ubaye-Serre-Ponçon;754;19;773
93;Provence-Alpes-Côte d'Azur;04;2;02;224;Ubraye;96;1;97
93;Provence-Alpes-Côte d'Azur;04;1;01;226;Uvernet-Fours;587;14;601
93;Provence-Alpes-Côte d'Azur;04;4;11;227;Vachères;285;7;292
93;Provence-Alpes-Côte d'Azur;04;1;01;120;Val d'Oronaye;119;1;120
93;Provence-Alpes-Côte d'Azur;04;2;02;043;Val-de-Chalvagne;87;3;90
93;Provence-Alpes-Côte d'Azur;04;4;13;228;Valavoire;39;0;39
93;Provence-Alpes-Côte d'Azur;04;4;14;229;Valbelle;265;5;270
93;Provence-Alpes-Côte d'Azur;04;4;15;230;Valensole;3188;63;3251
93;Provence-Alpes-Côte d'Azur;04;4;13;231;Valernes;247;6;253
93;Provence-Alpes-Côte d'Azur;04;4;13;233;Vaumeilh;265;8;273
93;Provence-Alpes-Côte d'Azur;04;4;13;234;Venterol;234;2;236
93;Provence-Alpes-Côte d'Azur;04;3;13;235;Verdaches;60;1;61
93;Provence-Alpes-Côte d'Azur;04;2;02;236;Vergons;109;0;109
93;Provence-Alpes-Côte d'Azur;04;3;13;237;Le Vernet;127;3;130
93;Provence-Alpes-Côte d'Azur;04;2;02;240;Villars-Colmars;248;5;253
93;Provence-Alpes-Côte d'Azur;04;4;11;241;Villemus;192;5;197
93;Provence-Alpes-Côte d'Azur;04;4;10;242;Villeneuve;4259;77;4336
93;Provence-Alpes-Côte d'Azur;04;3;03;244;Volonne;1643;37;1680
93;Provence-Alpes-Côte d'Azur;04;4;08;245;Volx;3152;73;3225
93;Provence-Alpes-Côte d'Azur;05;1;10;001;Abriès-Ristolas ;384;6;390
93;Provence-Alpes-Côte d'Azur;05;1;10;003;Aiguilles;411;12;423
93;Provence-Alpes-Côte d'Azur;05;2;12;004;Ancelle;921;15;936
93;Provence-Alpes-Côte d'Azur;05;1;01;006;L' Argentière-la-Bessée;2268;87;2355
93;Provence-Alpes-Côte d'Azur;05;1;10;007;Arvieux;361;8;369
93;Provence-Alpes-Côte d'Azur;05;2;13;008;Aspremont;363;5;368
93;Provence-Alpes-Côte d'Azur;05;2;12;009;Aspres-lès-Corps;102;3;105
93;Provence-Alpes-Côte d'Azur;05;2;13;010;Aspres-sur-Buëch;812;12;824
93;Provence-Alpes-Côte d'Azur;05;2;12;039;Aubessagne ;704;12;716
93;Provence-Alpes-Côte d'Azur;05;2;14;011;Avançon;411;9;420
93;Provence-Alpes-Côte d'Azur;05;2;05;012;Baratier;612;14;626
93;Provence-Alpes-Côte d'Azur;05;2;14;013;Barcillonnette;132;5;137
93;Provence-Alpes-Côte d'Azur;05;2;11;014;Barret-sur-Méouge;220;2;222
93;Provence-Alpes-Côte d'Azur;05;2;13;016;La Bâtie-Montsaléon;255;2;257
93;Provence-Alpes-Côte d'Azur;05;2;04;017;La Bâtie-Neuve;2544;56;2600
93;Provence-Alpes-Côte d'Azur;05;2;14;018;La Bâtie-Vieille;333;10;343
93;Provence-Alpes-Côte d'Azur;05;2;13;019;La Beaume;152;4;156
93;Provence-Alpes-Côte d'Azur;05;2;13;021;Le Bersac;145;1;146
93;Provence-Alpes-Côte d'Azur;05;2;04;022;Bréziers;234;3;237
93;Provence-Alpes-Côte d'Azur;05;1;98;023;Briançon;11084;322;11406
93;Provence-Alpes-Côte d'Azur;05;2;12;025;Buissard;214;7;221
93;Provence-Alpes-Côte d'Azur;05;1;10;026;Ceillac;287;3;290
93;Provence-Alpes-Côte d'Azur;05;1;02;027;Cervières;193;4;197
93;Provence-Alpes-Côte d'Azur;05;2;13;028;Chabestan;142;3;145
93;Provence-Alpes-Côte d'Azur;05;2;12;029;Chabottes;856;24;880
93;Provence-Alpes-Côte d'Azur;05;1;01;031;Champcella;186;1;187
93;Provence-Alpes-Côte d'Azur;05;2;12;032;Champoléon;136;3;139
93;Provence-Alpes-Côte d'Azur;05;2;13;033;Chanousse;40;0;40
93;Provence-Alpes-Côte d'Azur;05;2;12;064;La Chapelle-en-Valgaudémar;105;3;108
93;Provence-Alpes-Côte d'Azur;05;1;10;038;Château-Ville-Vieille;332;17;349
93;Provence-Alpes-Côte d'Azur;05;2;15;035;Châteauneuf-d'Oze;30;3;33
93;Provence-Alpes-Côte d'Azur;05;2;05;036;Châteauroux-les-Alpes;1193;33;1226
93;Provence-Alpes-Côte d'Azur;05;2;14;037;Châteauvieux;496;20;516
93;Provence-Alpes-Côte d'Azur;05;2;04;040;Chorges;3055;79;3134
93;Provence-Alpes-Côte d'Azur;05;2;05;044;Crévoux;125;3;128
93;Provence-Alpes-Côte d'Azur;05;2;05;045;Crots;1097;31;1128
93;Provence-Alpes-Côte d'Azur;05;2;15;139;Dévoluy;941;27;968
93;Provence-Alpes-Côte d'Azur;05;2;05;046;Embrun;6236;409;6645
93;Provence-Alpes-Côte d'Azur;05;2;11;047;Éourres;130;4;134
93;Provence-Alpes-Côte d'Azur;05;2;13;048;L' Épine;200;6;206
93;Provence-Alpes-Côte d'Azur;05;2;14;049;Esparron;56;0;56
93;Provence-Alpes-Côte d'Azur;05;2;04;050;Espinasses;808;9;817
93;Provence-Alpes-Côte d'Azur;05;2;13;051;Étoile-Saint-Cyrice;30;1;31
93;Provence-Alpes-Côte d'Azur;05;1;10;052;Eygliers;806;12;818
93;Provence-Alpes-Côte d'Azur;05;2;12;054;La Fare-en-Champsaur;434;4;438
93;Provence-Alpes-Côte d'Azur;05;2;13;055;La Faurie;326;4;330
93;Provence-Alpes-Côte d'Azur;05;2;12;056;Forest-Saint-Julien;333;11;344
93;Provence-Alpes-Côte d'Azur;05;2;14;057;Fouillouse;249;6;255
93;Provence-Alpes-Côte d'Azur;05;1;01;058;Freissinières;213;5;218
93;Provence-Alpes-Côte d'Azur;05;2;14;059;La Freissinouse;876;18;894
93;Provence-Alpes-Côte d'Azur;05;2;15;060;Furmeyer;173;8;181
93;Provence-Alpes-Côte d'Azur;05;2;99;061;Gap;40559;1555;42114
93;Provence-Alpes-Côte d'Azur;05;2;13;053;Garde-Colombe;530;11;541
93;Provence-Alpes-Côte d'Azur;05;2;12;062;Le Glaizil;163;1;164
93;Provence-Alpes-Côte d'Azur;05;1;02;063;La Grave;482;10;492
93;Provence-Alpes-Côte d'Azur;05;1;10;065;Guillestre;2334;86;2420
93;Provence-Alpes-Côte d'Azur;05;2;13;066;La Haute-Beaume;8;0;8
93;Provence-Alpes-Côte d'Azur;05;2;14;068;Jarjayes;454;13;467
93;Provence-Alpes-Côte d'Azur;05;2;11;070;Laragne-Montéglin;3537;51;3588
93;Provence-Alpes-Côte d'Azur;05;2;14;071;Lardier-et-Valença;334;19;353
93;Provence-Alpes-Côte d'Azur;05;2;12;072;Laye;239;7;246
93;Provence-Alpes-Côte d'Azur;05;2;11;073;Lazer;351;13;364
93;Provence-Alpes-Côte d'Azur;05;2;14;074;Lettret;187;0;187
93;Provence-Alpes-Côte d'Azur;05;2;15;075;Manteyer;427;7;434
93;Provence-Alpes-Côte d'Azur;05;2;13;076;Méreuil;85;3;88
93;Provence-Alpes-Côte d'Azur;05;1;10;077;Molines-en-Queyras;299;5;304
93;Provence-Alpes-Côte d'Azur;05;2;11;078;Monêtier-Allemont;282;10;292
93;Provence-Alpes-Côte d'Azur;05;1;02;079;Le Monêtier-les-Bains;1056;23;1079
93;Provence-Alpes-Côte d'Azur;05;1;10;082;Mont-Dauphin;174;2;176
93;Provence-Alpes-Côte d'Azur;05;2;13;080;Montbrand;60;0;60
93;Provence-Alpes-Côte d'Azur;05;2;13;081;Montclus;54;4;58
93;Provence-Alpes-Côte d'Azur;05;2;04;084;Montgardin;460;6;466
93;Provence-Alpes-Côte d'Azur;05;1;03;085;Montgenèvre;456;14;470
93;Provence-Alpes-Côte d'Azur;05;2;13;086;Montjay;104;2;106
93;Provence-Alpes-Côte d'Azur;05;2;15;087;Montmaur;520;13;533
93;Provence-Alpes-Côte d'Azur;05;2;13;089;Montrond;80;1;81
93;Provence-Alpes-Côte d'Azur;05;2;12;090;La Motte-en-Champsaur;214;8;222
93;Provence-Alpes-Côte d'Azur;05;2;13;091;Moydans;42;3;45
93;Provence-Alpes-Côte d'Azur;05;2;14;092;Neffes;756;15;771
93;Provence-Alpes-Côte d'Azur;05;1;03;093;Névache;356;10;366
93;Provence-Alpes-Côte d'Azur;05;2;13;094;Nossage-et-Bénévent;16;1;17
93;Provence-Alpes-Côte d'Azur;05;2;12;095;Le Noyer;297;2;299
93;Provence-Alpes-Côte d'Azur;05;2;12;096;Orcières;670;18;688
93;Provence-Alpes-Côte d'Azur;05;2;13;097;Orpierre;355;35;390
93;Provence-Alpes-Côte d'Azur;05;2;05;098;Les Orres;556;13;569
93;Provence-Alpes-Côte d'Azur;05;2;13;099;Oze;104;1;105
93;Provence-Alpes-Côte d'Azur;05;2;14;100;Pelleautier;731;28;759
93;Provence-Alpes-Côte d'Azur;05;2;13;102;La Piarre;92;2;94
93;Provence-Alpes-Côte d'Azur;05;2;11;103;Le Poët;788;21;809
93;Provence-Alpes-Côte d'Azur;05;2;12;104;Poligny;310;16;326
93;Provence-Alpes-Côte d'Azur;05;2;04;106;Prunières;298;7;305
93;Provence-Alpes-Côte d'Azur;05;1;02;107;Puy-Saint-André;457;23;480
93;Provence-Alpes-Côte d'Azur;05;2;04;108;Puy-Saint-Eusèbe;152;5;157
93;Provence-Alpes-Côte d'Azur;05;1;02;109;Puy-Saint-Pierre;532;20;552
93;Provence-Alpes-Côte d'Azur;05;1;01;110;Puy-Saint-Vincent;296;5;301
93;Provence-Alpes-Côte d'Azur;05;2;04;111;Puy-Sanières;279;9;288
93;Provence-Alpes-Côte d'Azur;05;2;15;112;Rabou;83;0;83
93;Provence-Alpes-Côte d'Azur;05;2;14;113;Rambaud;376;17;393
93;Provence-Alpes-Côte d'Azur;05;2;04;114;Réallon;253;1;254
93;Provence-Alpes-Côte d'Azur;05;2;04;115;Remollon;447;9;456
93;Provence-Alpes-Côte d'Azur;05;1;10;116;Réotier;204;2;206
93;Provence-Alpes-Côte d'Azur;05;2;13;117;Ribeyret;113;0;113
93;Provence-Alpes-Côte d'Azur;05;1;10;119;Risoul;647;18;665
93;Provence-Alpes-Côte d'Azur;05;1;01;122;La Roche-de-Rame;813;27;840
93;Provence-Alpes-Côte d'Azur;05;2;15;123;La Roche-des-Arnauds;1528;38;1566
93;Provence-Alpes-Côte d'Azur;05;2;04;121;Rochebrune;173;4;177
93;Provence-Alpes-Côte d'Azur;05;2;04;124;La Rochette;470;9;479
93;Provence-Alpes-Côte d'Azur;05;2;13;126;Rosans;468;9;477
93;Provence-Alpes-Côte d'Azur;05;2;04;127;Rousset;182;7;189
93;Provence-Alpes-Côte d'Azur;05;2;05;128;Saint-André-d'Embrun;677;21;698
93;Provence-Alpes-Côte d'Azur;05;2;13;129;Saint-André-de-Rosans;152;2;154
93;Provence-Alpes-Côte d'Azur;05;2;04;130;Saint-Apollinaire;160;4;164
93;Provence-Alpes-Côte d'Azur;05;2;13;131;Saint-Auban-d'Oze;86;4;90
93;Provence-Alpes-Côte d'Azur;05;2;12;132;Saint-Bonnet-en-Champsaur;2048;75;2123
93;Provence-Alpes-Côte d'Azur;05;1;02;133;Saint-Chaffrey;1567;46;1613
93;Provence-Alpes-Côte d'Azur;05;1;10;134;Saint-Clément-sur-Durance;318;5;323
93;Provence-Alpes-Côte d'Azur;05;1;10;136;Saint-Crépin;735;15;750
93;Provence-Alpes-Côte d'Azur;05;2;14;140;Saint-Étienne-le-Laus;280;7;287
93;Provence-Alpes-Côte d'Azur;05;2;12;142;Saint-Firmin;450;17;467
93;Provence-Alpes-Côte d'Azur;05;2;12;144;Saint-Jacques-en-Valgodemard;145;2;147
93;Provence-Alpes-Côte d'Azur;05;2;12;145;Saint-Jean-Saint-Nicolas;1063;93;1156
93;Provence-Alpes-Côte d'Azur;05;2;13;146;Saint-Julien-en-Beauchêne;132;1;133
93;Provence-Alpes-Côte d'Azur;05;2;12;147;Saint-Julien-en-Champsaur;361;5;366
93;Provence-Alpes-Côte d'Azur;05;2;12;148;Saint-Laurent-du-Cros;533;18;551
93;Provence-Alpes-Côte d'Azur;05;2;12;149;Saint-Léger-les-Mélèzes;356;11;367
93;Provence-Alpes-Côte d'Azur;05;1;01;151;Saint-Martin-de-Queyrières;1130;37;1167
93;Provence-Alpes-Côte d'Azur;05;2;12;152;Saint-Maurice-en-Valgodemard;127;4;131
93;Provence-Alpes-Côte d'Azur;05;2;12;153;Saint-Michel-de-Chaillol;346;13;359
93;Provence-Alpes-Côte d'Azur;05;2;11;155;Saint-Pierre-Avez;29;1;30
93;Provence-Alpes-Côte d'Azur;05;2;13;154;Saint-Pierre-d'Argençon;160;0;160
93;Provence-Alpes-Côte d'Azur;05;2;05;156;Saint-Sauveur;507;11;518
93;Provence-Alpes-Côte d'Azur;05;1;10;157;Saint-Véran;214;6;220
93;Provence-Alpes-Côte d'Azur;05;2;13;135;Sainte-Colombe;53;0;53
93;Provence-Alpes-Côte d'Azur;05;2;13;158;Le Saix;112;1;113
93;Provence-Alpes-Côte d'Azur;05;2;13;159;Saléon;89;3;92
93;Provence-Alpes-Côte d'Azur;05;2;11;160;Salérans;87;0;87
93;Provence-Alpes-Côte d'Azur;05;1;02;161;La Salle-les-Alpes;959;24;983
93;Provence-Alpes-Côte d'Azur;05;2;14;162;La Saulce;1490;37;1527
93;Provence-Alpes-Côte d'Azur;05;2;04;163;Le Sauze-du-Lac;145;4;149
93;Provence-Alpes-Côte d'Azur;05;2;04;164;Savines-le-Lac;1066;42;1108
93;Provence-Alpes-Côte d'Azur;05;2;13;165;Savournon;256;7;263
93;Provence-Alpes-Côte d'Azur;05;2;13;166;Serres;1285;26;1311
93;Provence-Alpes-Côte d'Azur;05;2;13;167;Sigottier;90;2;92
93;Provence-Alpes-Côte d'Azur;05;2;14;168;Sigoyer;688;21;709
93;Provence-Alpes-Côte d'Azur;05;2;13;169;Sorbiers;35;1;36
93;Provence-Alpes-Côte d'Azur;05;2;14;170;Tallard;2246;51;2297
93;Provence-Alpes-Côte d'Azur;05;2;04;171;Théus;207;4;211
93;Provence-Alpes-Côte d'Azur;05;2;13;172;Trescléoux;313;5;318
93;Provence-Alpes-Côte d'Azur;05;2;11;173;Upaix;454;10;464
93;Provence-Alpes-Côte d'Azur;05;2;11;118;Val Buëch-Méouge;1345;28;1373
93;Provence-Alpes-Côte d'Azur;05;1;03;174;Val-des-Prés;628;22;650
93;Provence-Alpes-Côte d'Azur;05;2;13;024;Valdoule ;221;8;229
93;Provence-Alpes-Côte d'Azur;05;1;01;101;Vallouise-Pelvoux;1178;41;1219
93;Provence-Alpes-Côte d'Azur;05;2;14;176;Valserres;267;4;271
93;Provence-Alpes-Côte d'Azur;05;1;10;177;Vars;525;9;534
93;Provence-Alpes-Côte d'Azur;05;2;11;178;Ventavon;584;40;624
93;Provence-Alpes-Côte d'Azur;05;2;15;179;Veynes;3199;146;3345
93;Provence-Alpes-Côte d'Azur;05;1;01;180;Les Vigneaux;539;14;553
93;Provence-Alpes-Côte d'Azur;05;1;02;181;Villar-d'Arêne;300;13;313
93;Provence-Alpes-Côte d'Azur;05;2;12;182;Villar-Loubière;42;3;45
93;Provence-Alpes-Côte d'Azur;05;1;02;183;Villar-Saint-Pancrace;1476;54;1530
93;Provence-Alpes-Côte d'Azur;05;2;14;184;Vitrolles;204;8;212
93;Provence-Alpes-Côte d'Azur;06;1;26;001;Aiglun;93;0;93
93;Provence-Alpes-Côte d'Azur;06;1;11;002;Amirat;60;0;60
93;Provence-Alpes-Côte d'Azur;06;1;11;003;Andon;650;5;655
93;Provence-Alpes-Côte d'Azur;06;1;94;004;Antibes;72915;1132;74047
93;Provence-Alpes-Côte d'Azur;06;2;26;005;Ascros;172;0;172
93;Provence-Alpes-Côte d'Azur;06;2;24;006;Aspremont;2230;31;2261
93;Provence-Alpes-Côte d'Azur;06;1;13;007;Auribeau-sur-Siagne;3224;68;3292
93;Provence-Alpes-Côte d'Azur;06;2;26;008;Auvare;31;2;33
93;Provence-Alpes-Côte d'Azur;06;2;26;009;Bairols;107;1;108
93;Provence-Alpes-Côte d'Azur;06;1;25;010;Le Bar-sur-Loup;2896;62;2958
93;Provence-Alpes-Côte d'Azur;06;2;04;011;Beaulieu-sur-Mer;3731;28;3759
93;Provence-Alpes-Côte d'Azur;06;2;04;012;Beausoleil;13576;137;13713
93;Provence-Alpes-Côte d'Azur;06;2;24;013;Belvédère;686;11;697
93;Provence-Alpes-Côte d'Azur;06;2;10;014;Bendejun;951;6;957
93;Provence-Alpes-Côte d'Azur;06;2;10;015;Berre-les-Alpes;1246;21;1267
93;Provence-Alpes-Côte d'Azur;06;2;26;016;Beuil;538;4;542
93;Provence-Alpes-Côte d'Azur;06;1;26;017;Bézaudun-les-Alpes;252;4;256
93;Provence-Alpes-Côte d'Azur;06;1;03;018;Biot;9746;351;10097
93;Provence-Alpes-Côte d'Azur;06;2;10;019;Blausasc;1651;19;1670
93;Provence-Alpes-Côte d'Azur;06;2;24;020;La Bollène-Vésubie;570;11;581
93;Provence-Alpes-Côte d'Azur;06;2;26;021;Bonson;737;4;741
93;Provence-Alpes-Côte d'Azur;06;1;26;022;Bouyon;560;6;566
93;Provence-Alpes-Côte d'Azur;06;2;10;023;Breil-sur-Roya;2151;52;2203
93;Provence-Alpes-Côte d'Azur;06;1;11;024;Briançonnet;219;2;221
93;Provence-Alpes-Côte d'Azur;06;2;10;162;La Brigue;696;10;706
93;Provence-Alpes-Côte d'Azur;06;1;17;025;Le Broc;1416;7;1423
93;Provence-Alpes-Côte d'Azur;06;1;11;026;Cabris;1352;26;1378
93;Provence-Alpes-Côte d'Azur;06;1;95;027;Cagnes-sur-Mer;51411;484;51895
93;Provence-Alpes-Côte d'Azur;06;1;11;028;Caille;416;4;420
93;Provence-Alpes-Côte d'Azur;06;1;96;029;Cannes;73965;819;74784
93;Provence-Alpes-Côte d'Azur;06;1;97;030;Le Cannet;41471;353;41824
93;Provence-Alpes-Côte d'Azur;06;2;10;031;Cantaron;1306;11;1317
93;Provence-Alpes-Côte d'Azur;06;2;04;032;Cap-d'Ail;4529;73;4602
93;Provence-Alpes-Côte d'Azur;06;1;17;033;Carros;12489;136;12625
93;Provence-Alpes-Côte d'Azur;06;2;24;034;Castagniers;1635;15;1650
93;Provence-Alpes-Côte d'Azur;06;2;14;035;Castellar;1116;9;1125
93;Provence-Alpes-Côte d'Azur;06;2;14;036;Castillon;384;4;388
93;Provence-Alpes-Côte d'Azur;06;1;25;037;Caussols;294;3;297
93;Provence-Alpes-Côte d'Azur;06;2;26;040;Châteauneuf-d'Entraunes;63;0;63
93;Provence-Alpes-Côte d'Azur;06;1;25;038;Châteauneuf-Grasse;3646;59;3705
93;Provence-Alpes-Côte d'Azur;06;2;10;039;Châteauneuf-Villevieille;932;8;940
93;Provence-Alpes-Côte d'Azur;06;1;25;041;Cipières;398;6;404
93;Provence-Alpes-Côte d'Azur;06;2;24;042;Clans;662;12;674
93;Provence-Alpes-Côte d'Azur;06;2;10;043;Coaraze;825;4;829
93;Provence-Alpes-Côte d'Azur;06;1;27;044;La Colle-sur-Loup;7887;155;8042
93;Provence-Alpes-Côte d'Azur;06;1;11;045;Collongues;75;2;77
93;Provence-Alpes-Côte d'Azur;06;2;24;046;Colomars;3453;41;3494
93;Provence-Alpes-Côte d'Azur;06;1;26;047;Conségudes;95;1;96
93;Provence-Alpes-Côte d'Azur;06;2;10;048;Contes;7429;80;7509
93;Provence-Alpes-Côte d'Azur;06;1;25;049;Courmes;115;2;117
93;Provence-Alpes-Côte d'Azur;06;1;26;050;Coursegoules;535;6;541
93;Provence-Alpes-Côte d'Azur;06;2;26;051;La Croix-sur-Roudoule;97;2;99
93;Provence-Alpes-Côte d'Azur;06;2;26;052;Cuébris;176;2;178
93;Provence-Alpes-Côte d'Azur;06;2;26;053;Daluis;144;1;145
93;Provence-Alpes-Côte d'Azur;06;2;10;054;Drap;4660;37;4697
93;Provence-Alpes-Côte d'Azur;06;2;24;055;Duranus;145;3;148
93;Provence-Alpes-Côte d'Azur;06;2;26;056;Entraunes;141;2;143
93;Provence-Alpes-Côte d'Azur;06;2;10;057;L' Escarène;2537;18;2555
93;Provence-Alpes-Côte d'Azur;06;1;11;058;Escragnolles;610;15;625
93;Provence-Alpes-Côte d'Azur;06;2;04;059;Èze;2225;59;2284
93;Provence-Alpes-Côte d'Azur;06;2;24;060;Falicon;1994;34;2028
93;Provence-Alpes-Côte d'Azur;06;1;26;061;Les Ferres;101;3;104
93;Provence-Alpes-Côte d'Azur;06;2;10;062;Fontan;329;1;330
93;Provence-Alpes-Côte d'Azur;06;1;11;063;Gars;72;0;72
93;Provence-Alpes-Côte d'Azur;06;1;17;064;Gattières;4134;55;4189
93;Provence-Alpes-Côte d'Azur;06;1;06;065;La Gaude;6816;102;6918
93;Provence-Alpes-Côte d'Azur;06;2;26;066;Gilette;1594;11;1605
93;Provence-Alpes-Côte d'Azur;06;2;14;067;Gorbio;1547;13;1560
93;Provence-Alpes-Côte d'Azur;06;1;25;068;Gourdon;374;10;384
93;Provence-Alpes-Côte d'Azur;06;1;98;069;Grasse;48865;939;49804
93;Provence-Alpes-Côte d'Azur;06;1;25;070;Gréolières;579;13;592
93;Provence-Alpes-Côte d'Azur;06;2;26;071;Guillaumes;616;7;623
93;Provence-Alpes-Côte d'Azur;06;2;24;072;Ilonse;178;1;179
93;Provence-Alpes-Côte d'Azur;06;2;24;073;Isola;667;12;679
93;Provence-Alpes-Côte d'Azur;06;2;24;074;Lantosque;1277;10;1287
93;Provence-Alpes-Côte d'Azur;06;2;24;075;Levens;4726;46;4772
93;Provence-Alpes-Côte d'Azur;06;2;26;076;Lieuche;46;3;49
93;Provence-Alpes-Côte d'Azur;06;2;10;077;Lucéram;1288;12;1300
93;Provence-Alpes-Côte d'Azur;06;2;26;078;Malaussène;316;7;323
93;Provence-Alpes-Côte d'Azur;06;1;13;079;Mandelieu-la-Napoule;21836;285;22121
93;Provence-Alpes-Côte d'Azur;06;2;24;080;Marie;105;4;109
93;Provence-Alpes-Côte d'Azur;06;1;11;081;Le Mas;136;3;139
93;Provence-Alpes-Côte d'Azur;06;2;26;082;Massoins;102;1;103
93;Provence-Alpes-Côte d'Azur;06;2;14;083;Menton;30231;486;30717
93;Provence-Alpes-Côte d'Azur;06;1;12;084;Mouans-Sartoux;9911;296;10207
93;Provence-Alpes-Côte d'Azur;06;1;09;085;Mougins;19489;426;19915
93;Provence-Alpes-Côte d'Azur;06;2;10;086;Moulinet;262;2;264
93;Provence-Alpes-Côte d'Azur;06;1;11;087;Les Mujouls;48;0;48
93;Provence-Alpes-Côte d'Azur;06;2;99;088;Nice;341032;2857;343889
93;Provence-Alpes-Côte d'Azur;06;1;25;089;Opio;2255;73;2328
93;Provence-Alpes-Côte d'Azur;06;1;13;090;Pégomas;7992;88;8080
93;Provence-Alpes-Côte d'Azur;06;2;10;091;Peille;2373;18;2391
93;Provence-Alpes-Côte d'Azur;06;2;10;092;Peillon;1462;13;1475
93;Provence-Alpes-Côte d'Azur;06;2;26;093;La Penne;214;1;215
93;Provence-Alpes-Côte d'Azur;06;2;26;094;Péone;780;9;789
93;Provence-Alpes-Côte d'Azur;06;1;11;095;Peymeinade;8173;186;8359
93;Provence-Alpes-Côte d'Azur;06;2;26;096;Pierlas;105;0;105
93;Provence-Alpes-Côte d'Azur;06;2;26;097;Pierrefeu;332;0;332
93;Provence-Alpes-Côte d'Azur;06;2;26;098;Puget-Rostang;127;1;128
93;Provence-Alpes-Côte d'Azur;06;2;26;099;Puget-Théniers;1860;72;1932
93;Provence-Alpes-Côte d'Azur;06;2;26;100;Revest-les-Roches;233;0;233
93;Provence-Alpes-Côte d'Azur;06;2;26;101;Rigaud;197;2;199
93;Provence-Alpes-Côte d'Azur;06;2;24;102;Rimplas;91;5;96
93;Provence-Alpes-Côte d'Azur;06;1;26;107;La Roque-en-Provence;73;1;74
93;Provence-Alpes-Côte d'Azur;06;2;24;103;Roquebillière;1836;49;1885
93;Provence-Alpes-Côte d'Azur;06;2;14;104;Roquebrune-Cap-Martin;12824;214;13038
93;Provence-Alpes-Côte d'Azur;06;1;27;105;Roquefort-les-Pins;6942;188;7130
93;Provence-Alpes-Côte d'Azur;06;2;26;106;Roquestéron;579;7;586
93;Provence-Alpes-Côte d'Azur;06;1;13;108;La Roquette-sur-Siagne;5387;93;5480
93;Provence-Alpes-Côte d'Azur;06;2;24;109;La Roquette-sur-Var;945;4;949
93;Provence-Alpes-Côte d'Azur;06;2;24;110;Roubion;120;3;123
93;Provence-Alpes-Côte d'Azur;06;2;24;111;Roure;146;4;150
93;Provence-Alpes-Côte d'Azur;06;1;25;112;Le Rouret;3962;118;4080
93;Provence-Alpes-Côte d'Azur;06;2;21;114;Saint-André-de-la-Roche;5577;28;5605
93;Provence-Alpes-Côte d'Azur;06;2;26;115;Saint-Antonin;90;0;90
93;Provence-Alpes-Côte d'Azur;06;1;11;116;Saint-Auban;216;3;219
93;Provence-Alpes-Côte d'Azur;06;2;24;117;Saint-Blaise;1130;8;1138
93;Provence-Alpes-Côte d'Azur;06;1;11;118;Saint-Cézaire-sur-Siagne;3905;100;4005
93;Provence-Alpes-Côte d'Azur;06;2;24;119;Saint-Dalmas-le-Selvage;113;2;115
93;Provence-Alpes-Côte d'Azur;06;2;24;120;Saint-Étienne-de-Tinée;1513;160;1673
93;Provence-Alpes-Côte d'Azur;06;2;04;121;Saint-Jean-Cap-Ferrat;1533;8;1541
93;Provence-Alpes-Côte d'Azur;06;1;26;122;Saint-Jeannet;4157;110;4267
93;Provence-Alpes-Côte d'Azur;06;1;06;123;Saint-Laurent-du-Var;28511;179;28690
93;Provence-Alpes-Côte d'Azur;06;2;26;124;Saint-Léger;50;0;50
93;Provence-Alpes-Côte d'Azur;06;2;26;125;Saint-Martin-d'Entraunes;152;7;159
93;Provence-Alpes-Côte d'Azur;06;2;24;126;Saint-Martin-du-Var;3059;19;3078
93;Provence-Alpes-Côte d'Azur;06;2;24;127;Saint-Martin-Vésubie;1427;12;1439
93;Provence-Alpes-Côte d'Azur;06;1;27;128;Saint-Paul-de-Vence;3324;72;3396
93;Provence-Alpes-Côte d'Azur;06;2;24;129;Saint-Sauveur-sur-Tinée;307;82;389
93;Provence-Alpes-Côte d'Azur;06;1;11;130;Saint-Vallier-de-Thiey;3597;102;3699
93;Provence-Alpes-Côte d'Azur;06;2;14;113;Sainte-Agnès;1341;24;1365
93;Provence-Alpes-Côte d'Azur;06;1;26;131;Sallagriffon;49;2;51
93;Provence-Alpes-Côte d'Azur;06;2;10;132;Saorge;459;10;469
93;Provence-Alpes-Côte d'Azur;06;2;26;133;Sauze;70;1;71
93;Provence-Alpes-Côte d'Azur;06;1;11;134;Séranon;545;8;553
93;Provence-Alpes-Côte d'Azur;06;2;26;135;Sigale;197;2;199
93;Provence-Alpes-Côte d'Azur;06;2;10;136;Sospel;3818;85;3903
93;Provence-Alpes-Côte d'Azur;06;1;11;137;Spéracèdes;1213;25;1238
93;Provence-Alpes-Côte d'Azur;06;2;10;163;Tende;2179;49;2228
93;Provence-Alpes-Côte d'Azur;06;1;13;138;Théoule-sur-Mer;1350;14;1364
93;Provence-Alpes-Côte d'Azur;06;2;26;139;Thiéry;108;3;111
93;Provence-Alpes-Côte d'Azur;06;1;11;140;Le Tignet;3063;53;3116
93;Provence-Alpes-Côte d'Azur;06;2;26;141;Toudon;345;1;346
93;Provence-Alpes-Côte d'Azur;06;2;10;142;Touët-de-l'Escarène;290;2;292
93;Provence-Alpes-Côte d'Azur;06;2;26;143;Touët-sur-Var;667;11;678
93;Provence-Alpes-Côte d'Azur;06;2;26;144;La Tour;561;4;565
93;Provence-Alpes-Côte d'Azur;06;2;26;145;Tourette-du-Château;132;1;133
93;Provence-Alpes-Côte d'Azur;06;2;26;146;Tournefort;161;1;162
93;Provence-Alpes-Côte d'Azur;06;2;24;147;Tourrette-Levens;4960;45;5005
93;Provence-Alpes-Côte d'Azur;06;1;25;148;Tourrettes-sur-Loup;4019;100;4119
93;Provence-Alpes-Côte d'Azur;06;2;21;149;La Trinité;9985;64;10049
93;Provence-Alpes-Côte d'Azur;06;2;04;150;La Turbie;3022;55;3077
93;Provence-Alpes-Côte d'Azur;06;2;24;151;Utelle;871;1;872
93;Provence-Alpes-Côte d'Azur;06;1;25;152;Valbonne;13257;532;13789
93;Provence-Alpes-Côte d'Azur;06;2;24;153;Valdeblore;835;281;1116
93;Provence-Alpes-Côte d'Azur;06;1;11;154;Valderoure;459;8;467
93;Provence-Alpes-Côte d'Azur;06;1;01;155;Vallauris;27072;177;27249
93;Provence-Alpes-Côte d'Azur;06;2;24;156;Venanson;160;1;161
93;Provence-Alpes-Côte d'Azur;06;1;26;157;Vence;18670;296;18966
93;Provence-Alpes-Côte d'Azur;06;2;26;158;Villars-sur-Var;769;3;772
93;Provence-Alpes-Côte d'Azur;06;2;04;159;Villefranche-sur-Mer;5064;35;5099
93;Provence-Alpes-Côte d'Azur;06;2;26;160;Villeneuve-d'Entraunes;86;2;88
93;Provence-Alpes-Côte d'Azur;06;1;27;161;Villeneuve-Loubet;15780;223;16003
84;Auvergne-Rhône-Alpes;07;3;06;001;Accons;379;12;391
84;Auvergne-Rhône-Alpes;07;1;04;002;Ailhon;547;18;565
84;Auvergne-Rhône-Alpes;07;1;03;003;Aizac;169;1;170
84;Auvergne-Rhône-Alpes;07;2;10;004;Ajoux;79;1;80
84;Auvergne-Rhône-Alpes;07;2;12;005;Alba-la-Romaine;1452;36;1488
84;Auvergne-Rhône-Alpes;07;3;06;006;Albon-d'Ardèche;159;6;165
84;Auvergne-Rhône-Alpes;07;3;08;007;Alboussière;974;14;988
84;Auvergne-Rhône-Alpes;07;2;10;008;Alissas;1468;53;1521
84;Auvergne-Rhône-Alpes;07;3;11;009;Andance;1202;23;1225
84;Auvergne-Rhône-Alpes;07;3;98;010;Annonay;16288;624;16912
84;Auvergne-Rhône-Alpes;07;3;06;012;Arcens;377;9;386
84;Auvergne-Rhône-Alpes;07;3;08;013;Ardoix;1257;22;1279
84;Auvergne-Rhône-Alpes;07;3;08;014;Arlebosc;326;7;333
84;Auvergne-Rhône-Alpes;07;3;11;015;Arras-sur-Rhône;527;23;550
84;Auvergne-Rhône-Alpes;07;1;16;017;Les Assions;752;16;768
84;Auvergne-Rhône-Alpes;07;1;13;018;Astet;43;0;43
84;Auvergne-Rhône-Alpes;07;1;99;019;Aubenas;12253;773;13026
84;Auvergne-Rhône-Alpes;07;2;12;020;Aubignas;464;11;475
84;Auvergne-Rhône-Alpes;07;2;09;022;Baix;1207;25;1232
84;Auvergne-Rhône-Alpes;07;1;15;023;Balazuc;377;7;384
84;Auvergne-Rhône-Alpes;07;1;16;024;Banne;663;22;685
84;Auvergne-Rhône-Alpes;07;1;13;025;Barnas;208;2;210
84;Auvergne-Rhône-Alpes;07;1;13;026;Le Béage;255;8;263
84;Auvergne-Rhône-Alpes;07;2;17;027;Beauchastel;1833;30;1863
84;Auvergne-Rhône-Alpes;07;1;16;028;Beaulieu;507;10;517
84;Auvergne-Rhône-Alpes;07;1;16;029;Beaumont;247;3;250
84;Auvergne-Rhône-Alpes;07;2;06;030;Beauvène;209;5;214
84;Auvergne-Rhône-Alpes;07;3;06;165;Belsentes;551;22;573
84;Auvergne-Rhône-Alpes;07;1;16;031;Berrias-et-Casteljau;758;18;776
84;Auvergne-Rhône-Alpes;07;1;12;032;Berzème;169;1;170
84;Auvergne-Rhône-Alpes;07;1;15;033;Bessas;215;4;219
84;Auvergne-Rhône-Alpes;07;2;05;034;Bidon;246;3;249
84;Auvergne-Rhône-Alpes;07;3;17;035;Boffres;620;19;639
84;Auvergne-Rhône-Alpes;07;3;11;036;Bogy;437;11;448
84;Auvergne-Rhône-Alpes;07;1;06;037;Borée;144;3;147
84;Auvergne-Rhône-Alpes;07;1;13;038;Borne;49;0;49
84;Auvergne-Rhône-Alpes;07;3;14;040;Boucieu-le-Roi;264;5;269
84;Auvergne-Rhône-Alpes;07;3;01;041;Boulieu-lès-Annonay;2345;65;2410
84;Auvergne-Rhône-Alpes;07;2;05;042;Bourg-Saint-Andéol;7167;165;7332
84;Auvergne-Rhône-Alpes;07;3;08;039;Bozas;249;7;256
84;Auvergne-Rhône-Alpes;07;3;11;044;Brossainc;269;9;278
84;Auvergne-Rhône-Alpes;07;1;13;045;Burzet;480;6;486
84;Auvergne-Rhône-Alpes;07;1;13;047;Cellier-du-Luc;81;0;81
84;Auvergne-Rhône-Alpes;07;2;06;048;Chalencon;323;7;330
84;Auvergne-Rhône-Alpes;07;3;06;049;Le Chambon;50;3;53
84;Auvergne-Rhône-Alpes;07;1;16;050;Chambonas;915;15;930
84;Auvergne-Rhône-Alpes;07;3;11;051;Champagne;583;20;603
84;Auvergne-Rhône-Alpes;07;3;08;052;Champis;621;10;631
84;Auvergne-Rhône-Alpes;07;1;16;053;Chandolas;510;3;513
84;Auvergne-Rhône-Alpes;07;3;06;054;Chanéac;255;9;264
84;Auvergne-Rhône-Alpes;07;3;17;055;Charmes-sur-Rhône;2954;73;3027
84;Auvergne-Rhône-Alpes;07;3;11;056;Charnas;922;18;940
84;Auvergne-Rhône-Alpes;07;1;15;058;Chassiers;1033;34;1067
84;Auvergne-Rhône-Alpes;07;3;07;059;Châteaubourg;242;7;249
84;Auvergne-Rhône-Alpes;07;2;17;060;Châteauneuf-de-Vernoux;253;5;258
84;Auvergne-Rhône-Alpes;07;1;15;061;Chauzon;401;12;413
84;Auvergne-Rhône-Alpes;07;1;15;062;Chazeaux;143;3;146
84;Auvergne-Rhône-Alpes;07;3;14;063;Cheminas;399;9;408
84;Auvergne-Rhône-Alpes;07;3;06;064;Le Cheylard;2914;157;3071
84;Auvergne-Rhône-Alpes;07;1;13;065;Chirols;234;3;237
84;Auvergne-Rhône-Alpes;07;2;10;066;Chomérac;3020;173;3193
84;Auvergne-Rhône-Alpes;07;3;11;067;Colombier-le-Cardinal;305;4;309
84;Auvergne-Rhône-Alpes;07;3;14;068;Colombier-le-Jeune;574;6;580
84;Auvergne-Rhône-Alpes;07;3;08;069;Colombier-le-Vieux;658;22;680
84;Auvergne-Rhône-Alpes;07;3;07;070;Cornas;2274;48;2322
84;Auvergne-Rhône-Alpes;07;1;13;071;Coucouron;789;13;802
84;Auvergne-Rhône-Alpes;07;2;10;072;Coux;1652;42;1694
84;Auvergne-Rhône-Alpes;07;3;08;073;Le Crestet;519;11;530
84;Auvergne-Rhône-Alpes;07;2;10;074;Creysseilles;148;4;152
84;Auvergne-Rhône-Alpes;07;1;13;075;Cros-de-Géorand;154;4;158
84;Auvergne-Rhône-Alpes;07;2;09;076;Cruas;3014;65;3079
84;Auvergne-Rhône-Alpes;07;1;12;077;Darbres;250;2;252
84;Auvergne-Rhône-Alpes;07;3;01;078;Davézieux;3123;86;3209
84;Auvergne-Rhône-Alpes;07;3;08;079;Désaignes;1137;21;1158
84;Auvergne-Rhône-Alpes;07;3;06;080;Devesset;294;7;301
84;Auvergne-Rhône-Alpes;07;1;16;081;Dompnac;59;1;60
84;Auvergne-Rhône-Alpes;07;3;06;082;Dornas;206;12;218
84;Auvergne-Rhône-Alpes;07;2;06;083;Dunière-sur-Eyrieux;433;10;443
84;Auvergne-Rhône-Alpes;07;3;11;084;Eclassan;1030;37;1067
84;Auvergne-Rhône-Alpes;07;3;08;085;Empurany;610;14;624
84;Auvergne-Rhône-Alpes;07;3;14;086;Étables;911;19;930
84;Auvergne-Rhône-Alpes;07;1;13;087;Fabras;421;8;429
84;Auvergne-Rhône-Alpes;07;1;16;088;Faugères;98;2;100
84;Auvergne-Rhône-Alpes;07;3;11;089;Félines;1673;47;1720
84;Auvergne-Rhône-Alpes;07;2;10;090;Flaviac;1229;17;1246
84;Auvergne-Rhône-Alpes;07;1;04;091;Fons;330;12;342
84;Auvergne-Rhône-Alpes;07;2;10;092;Freyssenet;47;1;48
84;Auvergne-Rhône-Alpes;07;1;03;093;Genestelle;275;8;283
84;Auvergne-Rhône-Alpes;07;2;17;094;Gilhac-et-Bruzac;175;3;178
84;Auvergne-Rhône-Alpes;07;3;08;095;Gilhoc-sur-Ormèze;457;3;460
84;Auvergne-Rhône-Alpes;07;2;06;096;Gluiras;368;3;371
84;Auvergne-Rhône-Alpes;07;3;14;097;Glun;694;18;712
84;Auvergne-Rhône-Alpes;07;2;10;098;Gourdon;84;4;88
84;Auvergne-Rhône-Alpes;07;2;05;099;Gras;637;18;655
84;Auvergne-Rhône-Alpes;07;1;16;100;Gravières;486;18;504
84;Auvergne-Rhône-Alpes;07;1;15;101;Grospierres;899;20;919
84;Auvergne-Rhône-Alpes;07;3;07;102;Guilherand-Granges;10760;222;10982
84;Auvergne-Rhône-Alpes;07;3;06;104;Issamoulenc;90;2;92
84;Auvergne-Rhône-Alpes;07;1;13;105;Issanlas;101;3;104
84;Auvergne-Rhône-Alpes;07;1;13;106;Issarlès;138;1;139
84;Auvergne-Rhône-Alpes;07;1;13;107;Jaujac;1253;23;1276
84;Auvergne-Rhône-Alpes;07;3;06;108;Jaunac;124;8;132
84;Auvergne-Rhône-Alpes;07;1;15;109;Joannas;299;6;305
84;Auvergne-Rhône-Alpes;07;1;16;110;Joyeuse;1737;28;1765
84;Auvergne-Rhône-Alpes;07;1;03;111;Juvinas;172;5;177
84;Auvergne-Rhône-Alpes;07;1;15;113;Labastide-de-Virac;304;7;311
84;Auvergne-Rhône-Alpes;07;1;03;112;Labastide-sur-Bésorgues;250;7;257
84;Auvergne-Rhône-Alpes;07;3;08;114;Labatie-d'Andaure;203;2;205
84;Auvergne-Rhône-Alpes;07;1;15;115;Labeaume;674;11;685
84;Auvergne-Rhône-Alpes;07;1;03;116;Labégude;1375;22;1397
84;Auvergne-Rhône-Alpes;07;1;16;117;Lablachère;2174;35;2209
84;Auvergne-Rhône-Alpes;07;1;16;118;Laboule;141;6;147
84;Auvergne-Rhône-Alpes;07;1;13;119;Le Lac-d'Issarlès;270;5;275
84;Auvergne-Rhône-Alpes;07;1;03;120;Lachamp-Raphaël;62;0;62
84;Auvergne-Rhône-Alpes;07;1;13;121;Lachapelle-Graillouse;196;0;196
84;Auvergne-Rhône-Alpes;07;1;04;122;Lachapelle-sous-Aubenas;1632;45;1677
84;Auvergne-Rhône-Alpes;07;3;06;123;Lachapelle-sous-Chanéac;169;3;172
84;Auvergne-Rhône-Alpes;07;3;08;124;Lafarre;38;1;39
84;Auvergne-Rhône-Alpes;07;1;15;126;Lagorce;1161;24;1185
84;Auvergne-Rhône-Alpes;07;1;13;127;Lalevade-d'Ardèche;1112;13;1125
84;Auvergne-Rhône-Alpes;07;3;08;128;Lalouvesc;382;5;387
84;Auvergne-Rhône-Alpes;07;3;08;129;Lamastre;2338;49;2387
84;Auvergne-Rhône-Alpes;07;1;13;130;Lanarce;202;5;207
84;Auvergne-Rhône-Alpes;07;1;04;131;Lanas;452;43;495
84;Auvergne-Rhône-Alpes;07;1;15;132;Largentière;1598;50;1648
84;Auvergne-Rhône-Alpes;07;2;05;133;Larnas;241;3;244
84;Auvergne-Rhône-Alpes;07;1;15;134;Laurac-en-Vivarais;1007;27;1034
84;Auvergne-Rhône-Alpes;07;1;13;136;Laveyrune;105;1;106
84;Auvergne-Rhône-Alpes;07;1;13;137;Lavillatte;45;0;45
84;Auvergne-Rhône-Alpes;07;1;12;138;Lavilledieu;2180;46;2226
84;Auvergne-Rhône-Alpes;07;1;03;139;Laviolle;107;0;107
84;Auvergne-Rhône-Alpes;07;3;14;140;Lemps;782;23;805
84;Auvergne-Rhône-Alpes;07;1;04;141;Lentillères;230;7;237
84;Auvergne-Rhône-Alpes;07;1;13;142;Lespéron;321;8;329
84;Auvergne-Rhône-Alpes;07;3;11;143;Limony;768;18;786
84;Auvergne-Rhône-Alpes;07;1;16;144;Loubaresse;43;2;45
84;Auvergne-Rhône-Alpes;07;1;12;145;Lussas;1163;21;1184
84;Auvergne-Rhône-Alpes;07;2;10;146;Lyas;604;16;620
84;Auvergne-Rhône-Alpes;07;1;16;147;Malarce-sur-la-Thines;243;5;248
84;Auvergne-Rhône-Alpes;07;1;16;148;Malbosc;145;8;153
84;Auvergne-Rhône-Alpes;07;2;06;149;Marcols-les-Eaux;287;5;292
84;Auvergne-Rhône-Alpes;07;3;06;150;Mariac;564;21;585
84;Auvergne-Rhône-Alpes;07;3;06;151;Mars;261;11;272
84;Auvergne-Rhône-Alpes;07;3;14;152;Mauves;1180;26;1206
84;Auvergne-Rhône-Alpes;07;1;13;153;Mayres;263;7;270
84;Auvergne-Rhône-Alpes;07;1;13;154;Mazan-l'Abbaye;122;1;123
84;Auvergne-Rhône-Alpes;07;1;04;155;Mercuer;1203;46;1249
84;Auvergne-Rhône-Alpes;07;1;13;156;Meyras;922;29;951
84;Auvergne-Rhône-Alpes;07;2;09;157;Meysse;1335;13;1348
84;Auvergne-Rhône-Alpes;07;1;03;158;Mézilhac;97;0;97
84;Auvergne-Rhône-Alpes;07;1;12;159;Mirabel;685;10;695
84;Auvergne-Rhône-Alpes;07;3;02;160;Monestier;62;1;63
84;Auvergne-Rhône-Alpes;07;1;13;161;Montpezat-sous-Bauzon;739;24;763
84;Auvergne-Rhône-Alpes;07;1;15;162;Montréal;571;19;590
84;Auvergne-Rhône-Alpes;07;1;16;163;Montselgues;81;7;88
84;Auvergne-Rhône-Alpes;07;3;08;166;Nozières;255;2;257
84;Auvergne-Rhône-Alpes;07;2;06;167;Les Ollières-sur-Eyrieux;992;19;1011
84;Auvergne-Rhône-Alpes;07;1;15;168;Orgnac-l'Aven;588;16;604
84;Auvergne-Rhône-Alpes;07;3;11;169;Ozon;390;1;391
84;Auvergne-Rhône-Alpes;07;3;08;170;Pailharès;241;6;247
84;Auvergne-Rhône-Alpes;07;1;16;171;Payzac;536;8;544
84;Auvergne-Rhône-Alpes;07;3;11;172;Peaugres;2219;50;2269
84;Auvergne-Rhône-Alpes;07;1;13;173;Péreyres;49;0;49
84;Auvergne-Rhône-Alpes;07;3;11;174;Peyraud;487;6;493
84;Auvergne-Rhône-Alpes;07;1;13;175;Le Plagnal;80;1;81
84;Auvergne-Rhône-Alpes;07;1;16;176;Planzolles;144;2;146
84;Auvergne-Rhône-Alpes;07;3;14;177;Plats;851;19;870
84;Auvergne-Rhône-Alpes;07;1;13;178;Pont-de-Labeaume;571;12;583
84;Auvergne-Rhône-Alpes;07;2;10;179;Pourchères;132;2;134
84;Auvergne-Rhône-Alpes;07;2;09;181;Le Pouzin;2872;39;2911
84;Auvergne-Rhône-Alpes;07;1;13;182;Prades;1185;31;1216
84;Auvergne-Rhône-Alpes;07;1;15;183;Pradons;471;12;483
84;Auvergne-Rhône-Alpes;07;2;10;184;Pranles;507;13;520
84;Auvergne-Rhône-Alpes;07;3;08;185;Préaux;696;9;705
84;Auvergne-Rhône-Alpes;07;2;10;186;Privas;8363;306;8669
84;Auvergne-Rhône-Alpes;07;1;15;187;Prunet;135;4;139
84;Auvergne-Rhône-Alpes;07;3;08;188;Quintenas;1657;38;1695
84;Auvergne-Rhône-Alpes;07;1;16;189;Ribes;306;7;313
84;Auvergne-Rhône-Alpes;07;1;15;190;Rochecolombe;214;7;221
84;Auvergne-Rhône-Alpes;07;2;09;191;Rochemaure;2299;52;2351
84;Auvergne-Rhône-Alpes;07;3;06;192;Rochepaule;251;8;259
84;Auvergne-Rhône-Alpes;07;1;15;193;Rocher;274;4;278
84;Auvergne-Rhône-Alpes;07;2;10;194;Rochessauve;452;9;461
84;Auvergne-Rhône-Alpes;07;1;06;195;La Rochette;60;2;62
84;Auvergne-Rhône-Alpes;07;1;16;196;Rocles;253;4;257
84;Auvergne-Rhône-Alpes;07;3;02;197;Roiffieux;2762;84;2846
84;Auvergne-Rhône-Alpes;07;2;09;198;Rompon;1106;30;1136
84;Auvergne-Rhône-Alpes;07;1;16;199;Rosières;1219;25;1244
84;Auvergne-Rhône-Alpes;07;1;13;200;Le Roux;56;1;57
84;Auvergne-Rhône-Alpes;07;1;15;201;Ruoms;2268;29;2297
84;Auvergne-Rhône-Alpes;07;1;16;202;Sablières;167;4;171
84;Auvergne-Rhône-Alpes;07;1;13;203;Sagnes-et-Goudoulet;117;3;120
84;Auvergne-Rhône-Alpes;07;3;06;204;Saint-Agrève;2347;64;2411
84;Auvergne-Rhône-Alpes;07;1;15;207;Saint-Alban-Auriolles;1087;17;1104
84;Auvergne-Rhône-Alpes;07;3;08;205;Saint-Alban-d'Ay;1406;22;1428
84;Auvergne-Rhône-Alpes;07;1;13;206;Saint-Alban-en-Montagne;85;3;88
84;Auvergne-Rhône-Alpes;07;1;12;208;Saint-Andéol-de-Berg;124;3;127
84;Auvergne-Rhône-Alpes;07;3;06;209;Saint-Andéol-de-Fourchades;53;2;55
84;Auvergne-Rhône-Alpes;07;1;03;210;Saint-Andéol-de-Vals;525;11;536
84;Auvergne-Rhône-Alpes;07;1;16;211;Saint-André-de-Cruzières;463;14;477
84;Auvergne-Rhône-Alpes;07;3;06;212;Saint-André-en-Vivarais;211;3;214
84;Auvergne-Rhône-Alpes;07;1;16;213;Saint-André-Lachamp;151;1;152
84;Auvergne-Rhône-Alpes;07;2;17;214;Saint-Apollinaire-de-Rias;202;2;204
84;Auvergne-Rhône-Alpes;07;3;08;216;Saint-Barthélemy-Grozon;502;23;525
84;Auvergne-Rhône-Alpes;07;3;06;215;Saint-Barthélemy-le-Meil;197;6;203
84;Auvergne-Rhône-Alpes;07;3;14;217;Saint-Barthélemy-le-Plain;828;20;848
84;Auvergne-Rhône-Alpes;07;3;08;218;Saint-Basile;350;10;360
84;Auvergne-Rhône-Alpes;07;2;09;219;Saint-Bauzile;314;6;320
84;Auvergne-Rhône-Alpes;07;3;06;220;Saint-Christol;105;0;105
84;Auvergne-Rhône-Alpes;07;2;17;221;Saint-Cierge-la-Serre;249;9;258
84;Auvergne-Rhône-Alpes;07;3;06;222;Saint-Cierge-sous-le-Cheylard;206;5;211
84;Auvergne-Rhône-Alpes;07;1;13;223;Saint-Cirgues-de-Prades;139;2;141
84;Auvergne-Rhône-Alpes;07;1;13;224;Saint-Cirgues-en-Montagne;211;12;223
84;Auvergne-Rhône-Alpes;07;3;01;225;Saint-Clair;1141;43;1184
84;Auvergne-Rhône-Alpes;07;3;06;226;Saint-Clément;87;0;87
84;Auvergne-Rhône-Alpes;07;3;01;227;Saint-Cyr;1382;47;1429
84;Auvergne-Rhône-Alpes;07;3;11;228;Saint-Désirat;861;23;884
84;Auvergne-Rhône-Alpes;07;1;04;229;Saint-Didier-sous-Aubenas;943;25;968
84;Auvergne-Rhône-Alpes;07;1;04;230;Saint-Étienne-de-Boulogne;402;14;416
84;Auvergne-Rhône-Alpes;07;1;04;231;Saint-Étienne-de-Fontbellon;2740;80;2820
84;Auvergne-Rhône-Alpes;07;1;13;232;Saint-Étienne-de-Lugdarès;414;9;423
84;Auvergne-Rhône-Alpes;07;2;06;233;Saint-Étienne-de-Serre;215;4;219
84;Auvergne-Rhône-Alpes;07;3;11;234;Saint-Étienne-de-Valoux;293;3;296
84;Auvergne-Rhône-Alpes;07;3;08;236;Saint-Félicien;1169;20;1189
84;Auvergne-Rhône-Alpes;07;2;17;237;Saint-Fortunat-sur-Eyrieux;777;13;790
84;Auvergne-Rhône-Alpes;07;1;16;238;Saint-Genest-de-Beauzon;326;7;333
84;Auvergne-Rhône-Alpes;07;3;06;239;Saint-Genest-Lachamp;107;2;109
84;Auvergne-Rhône-Alpes;07;3;17;240;Saint-Georges-les-Bains;2367;44;2411
84;Auvergne-Rhône-Alpes;07;1;12;241;Saint-Germain;711;17;728
84;Auvergne-Rhône-Alpes;07;1;12;242;Saint-Gineis-en-Coiron;115;4;119
84;Auvergne-Rhône-Alpes;07;3;11;243;Saint-Jacques-d'Atticieux;300;5;305
84;Auvergne-Rhône-Alpes;07;2;17;244;Saint-Jean-Chambre;257;5;262
84;Auvergne-Rhône-Alpes;07;3;14;245;Saint-Jean-de-Muzols;2491;68;2559
84;Auvergne-Rhône-Alpes;07;1;12;247;Saint-Jean-le-Centenier;814;9;823
84;Auvergne-Rhône-Alpes;07;3;06;248;Saint-Jean-Roure;256;11;267
84;Auvergne-Rhône-Alpes;07;3;06;249;Saint-Jeure-d'Andaure;98;2;100
84;Auvergne-Rhône-Alpes;07;3;08;250;Saint-Jeure-d'Ay;478;10;488
84;Auvergne-Rhône-Alpes;07;1;03;251;Saint-Joseph-des-Bancs;173;3;176
84;Auvergne-Rhône-Alpes;07;3;06;103;Saint-Julien-d'Intres ;315;3;318
84;Auvergne-Rhône-Alpes;07;2;06;253;Saint-Julien-du-Gua;182;3;185
84;Auvergne-Rhône-Alpes;07;1;03;254;Saint-Julien-du-Serre;872;19;891
84;Auvergne-Rhône-Alpes;07;2;09;255;Saint-Julien-en-Saint-Alban;1487;38;1525
84;Auvergne-Rhône-Alpes;07;2;17;257;Saint-Julien-le-Roux;112;3;115
84;Auvergne-Rhône-Alpes;07;3;02;258;Saint-Julien-Vocance;225;2;227
84;Auvergne-Rhône-Alpes;07;2;05;259;Saint-Just-d'Ardèche;1683;37;1720
84;Auvergne-Rhône-Alpes;07;2;09;260;Saint-Lager-Bressac;935;16;951
84;Auvergne-Rhône-Alpes;07;2;17;261;Saint-Laurent-du-Pape;1577;34;1611
84;Auvergne-Rhône-Alpes;07;1;13;262;Saint-Laurent-les-Bains-Laval-d'Aurelle ;174;2;176
84;Auvergne-Rhône-Alpes;07;1;12;263;Saint-Laurent-sous-Coiron;106;3;109
84;Auvergne-Rhône-Alpes;07;2;05;264;Saint-Marcel-d'Ardèche;2381;68;2449
84;Auvergne-Rhône-Alpes;07;3;01;265;Saint-Marcel-lès-Annonay;1403;35;1438
84;Auvergne-Rhône-Alpes;07;1;06;267;Saint-Martial;259;4;263
84;Auvergne-Rhône-Alpes;07;2;05;268;Saint-Martin-d'Ardèche;964;12;976
84;Auvergne-Rhône-Alpes;07;3;06;269;Saint-Martin-de-Valamas;1102;38;1140
84;Auvergne-Rhône-Alpes;07;2;09;270;Saint-Martin-sur-Lavezon;429;12;441
84;Auvergne-Rhône-Alpes;07;1;15;272;Saint-Maurice-d'Ardèche;306;12;318
84;Auvergne-Rhône-Alpes;07;1;12;273;Saint-Maurice-d'Ibie;221;3;224
84;Auvergne-Rhône-Alpes;07;2;06;274;Saint-Maurice-en-Chalencon;215;5;220
84;Auvergne-Rhône-Alpes;07;1;16;275;Saint-Mélany;106;3;109
84;Auvergne-Rhône-Alpes;07;3;06;276;Saint-Michel-d'Aurance;270;20;290
84;Auvergne-Rhône-Alpes;07;1;04;277;Saint-Michel-de-Boulogne;152;5;157
84;Auvergne-Rhône-Alpes;07;2;06;278;Saint-Michel-de-Chabrillanoux;374;8;382
84;Auvergne-Rhône-Alpes;07;2;05;279;Saint-Montan;1885;43;1928
84;Auvergne-Rhône-Alpes;07;1;16;280;Saint-Paul-le-Jeune;956;21;977
84;Auvergne-Rhône-Alpes;07;3;07;281;Saint-Péray;7622;220;7842
84;Auvergne-Rhône-Alpes;07;1;13;282;Saint-Pierre-de-Colombier;421;24;445
84;Auvergne-Rhône-Alpes;07;2;09;283;Saint-Pierre-la-Roche;60;1;61
84;Auvergne-Rhône-Alpes;07;1;16;284;Saint-Pierre-Saint-Jean;157;4;161
84;Auvergne-Rhône-Alpes;07;3;08;285;Saint-Pierre-sur-Doux;109;1;110
84;Auvergne-Rhône-Alpes;07;3;06;286;Saint-Pierreville;536;2;538
84;Auvergne-Rhône-Alpes;07;1;12;287;Saint-Pons;292;15;307
84;Auvergne-Rhône-Alpes;07;2;10;288;Saint-Priest;1240;42;1282
84;Auvergne-Rhône-Alpes;07;1;04;289;Saint-Privat;1711;59;1770
84;Auvergne-Rhône-Alpes;07;3;08;290;Saint-Prix;273;7;280
84;Auvergne-Rhône-Alpes;07;1;15;291;Saint-Remèze;863;23;886
84;Auvergne-Rhône-Alpes;07;3;08;292;Saint-Romain-d'Ay;1231;36;1267
84;Auvergne-Rhône-Alpes;07;3;07;293;Saint-Romain-de-Lerps;891;18;909
84;Auvergne-Rhône-Alpes;07;1;16;294;Saint-Sauveur-de-Cruzières;531;15;546
84;Auvergne-Rhône-Alpes;07;2;06;295;Saint-Sauveur-de-Montagut;1108;23;1131
84;Auvergne-Rhône-Alpes;07;1;04;296;Saint-Sernin;1688;46;1734
84;Auvergne-Rhône-Alpes;07;3;08;297;Saint-Sylvestre;509;7;516
84;Auvergne-Rhône-Alpes;07;3;08;299;Saint-Symphorien-de-Mahun;120;4;124
84;Auvergne-Rhône-Alpes;07;2;09;298;Saint-Symphorien-sous-Chomérac;761;30;791
84;Auvergne-Rhône-Alpes;07;2;12;300;Saint-Thomé;459;16;475
84;Auvergne-Rhône-Alpes;07;3;08;301;Saint-Victor;952;15;967
84;Auvergne-Rhône-Alpes;07;2;09;302;Saint-Vincent-de-Barrès;836;22;858
84;Auvergne-Rhône-Alpes;07;2;06;303;Saint-Vincent-de-Durfort;240;4;244
84;Auvergne-Rhône-Alpes;07;1;13;235;Sainte-Eulalie;215;3;218
84;Auvergne-Rhône-Alpes;07;1;16;266;Sainte-Marguerite-Lafigère;110;2;112
84;Auvergne-Rhône-Alpes;07;1;15;304;Salavas;690;12;702
84;Auvergne-Rhône-Alpes;07;1;16;305;Les Salelles;365;8;373
84;Auvergne-Rhône-Alpes;07;1;15;306;Sampzon;230;7;237
84;Auvergne-Rhône-Alpes;07;1;15;307;Sanilhac;444;9;453
84;Auvergne-Rhône-Alpes;07;3;11;308;Sarras;2213;35;2248
84;Auvergne-Rhône-Alpes;07;3;08;309;Satillieu;1525;30;1555
84;Auvergne-Rhône-Alpes;07;3;01;310;Savas;899;24;923
84;Auvergne-Rhône-Alpes;07;1;12;311;Sceautres;145;7;152
84;Auvergne-Rhône-Alpes;07;3;14;312;Sécheras;544;17;561
84;Auvergne-Rhône-Alpes;07;3;11;313;Serrières;1141;17;1158
84;Auvergne-Rhône-Alpes;07;2;17;314;Silhac;375;12;387
84;Auvergne-Rhône-Alpes;07;1;13;315;La Souche;370;13;383
84;Auvergne-Rhône-Alpes;07;3;17;316;Soyons;2269;49;2318
84;Auvergne-Rhône-Alpes;07;3;02;317;Talencieux;1082;31;1113
84;Auvergne-Rhône-Alpes;07;1;15;318;Tauriers;196;5;201
84;Auvergne-Rhône-Alpes;07;2;12;319;Le Teil;8796;211;9007
84;Auvergne-Rhône-Alpes;07;3;02;321;Thorrenc;234;6;240
84;Auvergne-Rhône-Alpes;07;1;13;322;Thueyts;1209;25;1234
84;Auvergne-Rhône-Alpes;07;3;17;323;Toulaud;1706;53;1759
84;Auvergne-Rhône-Alpes;07;3;14;324;Tournon-sur-Rhône;10598;515;11113
84;Auvergne-Rhône-Alpes;07;1;03;325;Ucel;2035;71;2106
84;Auvergne-Rhône-Alpes;07;1;13;326;Usclades-et-Rieutord;115;0;115
84;Auvergne-Rhône-Alpes;07;1;15;327;Uzer;411;12;423
84;Auvergne-Rhône-Alpes;07;1;15;328;Vagnas;562;17;579
84;Auvergne-Rhône-Alpes;07;1;16;329;Valgorge;426;8;434
84;Auvergne-Rhône-Alpes;07;1;03;011;Vallées-d'Antraigues-Asperjoc;920;19;939
84;Auvergne-Rhône-Alpes;07;1;15;330;Vallon-Pont-d'Arc;2397;39;2436
84;Auvergne-Rhône-Alpes;07;1;03;331;Vals-les-Bains;3547;66;3613
84;Auvergne-Rhône-Alpes;07;2;12;332;Valvignères;447;13;460
84;Auvergne-Rhône-Alpes;07;3;02;333;Vanosc;934;13;947
84;Auvergne-Rhône-Alpes;07;1;16;334;Les Vans;2663;58;2721
84;Auvergne-Rhône-Alpes;07;3;08;335;Vaudevant;207;2;209
84;Auvergne-Rhône-Alpes;07;1;16;336;Vernon;229;7;236
84;Auvergne-Rhône-Alpes;07;3;02;337;Vernosc-lès-Annonay;2634;86;2720
84;Auvergne-Rhône-Alpes;07;2;17;338;Vernoux-en-Vivarais;1958;31;1989
84;Auvergne-Rhône-Alpes;07;1;04;339;Vesseaux;1962;60;2022
84;Auvergne-Rhône-Alpes;07;2;10;340;Veyras;1520;48;1568
84;Auvergne-Rhône-Alpes;07;1;12;341;Villeneuve-de-Berg;2973;124;3097
84;Auvergne-Rhône-Alpes;07;3;02;342;Villevocance;1177;28;1205
84;Auvergne-Rhône-Alpes;07;1;04;343;Vinezac;1394;40;1434
84;Auvergne-Rhône-Alpes;07;3;11;344;Vinzieux;453;3;456
84;Auvergne-Rhône-Alpes;07;3;14;345;Vion;945;19;964
84;Auvergne-Rhône-Alpes;07;2;05;346;Viviers;3710;67;3777
84;Auvergne-Rhône-Alpes;07;3;02;347;Vocance;615;2;617
84;Auvergne-Rhône-Alpes;07;1;15;348;Vogüé;1086;25;1111
84;Auvergne-Rhône-Alpes;07;2;17;349;La Voulte-sur-Rhône;4918;59;4977
44;Grand Est;08;2;11;001;Acy-Romance;456;3;459
44;Grand Est;08;1;18;003;Aiglemont;1629;34;1663
44;Grand Est;08;2;08;004;Aire;228;1;229
44;Grand Est;08;2;08;005;Alincourt;154;2;156
44;Grand Est;08;4;01;006;Alland'Huy-et-Sausseuil;244;4;248
44;Grand Est;08;2;11;008;Amagne;724;6;730
44;Grand Est;08;2;11;010;Ambly-Fleury;134;5;139
44;Grand Est;08;1;12;011;Anchamps;214;4;218
44;Grand Est;08;3;19;013;Angecourt;391;4;395
44;Grand Est;08;2;08;014;Annelles;139;6;145
44;Grand Est;08;1;17;015;Antheny;100;5;105
44;Grand Est;08;1;17;016;Aouste;205;2;207
44;Grand Est;08;4;01;017;Apremont;117;3;120
44;Grand Est;08;4;01;018;Ardeuil-et-Montfauxelles;71;2;73
44;Grand Est;08;2;11;021;Arnicourt;156;3;159
44;Grand Est;08;1;05;022;Arreux;322;12;334
44;Grand Est;08;3;19;023;Artaise-le-Vivier;66;1;67
44;Grand Est;08;2;08;024;Asfeld;1097;19;1116
44;Grand Est;08;4;01;025;Attigny;1127;28;1155
44;Grand Est;08;1;17;026;Aubigny-les-Pothées;312;8;320
44;Grand Est;08;2;17;027;Auboncourt-Vauzelles;99;3;102
44;Grand Est;08;1;09;028;Aubrives;946;19;965
44;Grand Est;08;3;03;029;Auflance;88;3;91
44;Grand Est;08;1;13;030;Auge;59;0;59
44;Grand Est;08;4;01;031;Aure;46;4;50
44;Grand Est;08;2;08;032;Aussonce;217;3;220
44;Grand Est;08;4;19;033;Authe;90;4;94
44;Grand Est;08;3;03;034;Autrecourt-et-Pourron;341;6;347
44;Grand Est;08;4;19;035;Autruche;64;2;66
44;Grand Est;08;4;01;036;Autry;116;8;124
44;Grand Est;08;1;13;037;Auvillers-les-Forges;878;10;888
44;Grand Est;08;2;08;038;Avançon;323;9;332
44;Grand Est;08;2;08;039;Avaux;466;13;479
44;Grand Est;08;1;10;040;Les Ayvelles;891;12;903
44;Grand Est;08;1;10;041;Baâlons;207;8;215
44;Grand Est;08;4;19;116;Bairon et ses environs;1025;17;1042
44;Grand Est;08;3;16;043;Balan;1623;30;1653
44;Grand Est;08;2;08;044;Balham;157;1;158
44;Grand Est;08;4;19;045;Ballay;278;12;290
44;Grand Est;08;2;08;046;Banogne-Recouvrance;159;3;162
44;Grand Est;08;4;19;049;Bar-lès-Buzancy;127;3;130
44;Grand Est;08;1;17;047;Barbaise;104;0;104
44;Grand Est;08;2;11;048;Barby;418;4;422
44;Grand Est;08;4;19;052;Bayonville;90;5;95
44;Grand Est;08;3;16;053;Bazeilles ;2411;218;2629
44;Grand Est;08;3;03;055;Beaumont-en-Argonne;429;8;437
44;Grand Est;08;4;01;056;Beffu-et-le-Morthomme;46;0;46
44;Grand Est;08;4;19;057;Belleville-et-Châtillon-sur-Bar;276;28;304
44;Grand Est;08;1;04;058;Belval;222;6;228
44;Grand Est;08;4;19;059;Belval-Bois-des-Dames;32;1;33
44;Grand Est;08;2;08;060;Bergnicourt;286;1;287
44;Grand Est;08;4;19;061;La Berlière;38;1;39
44;Grand Est;08;2;11;062;Bertoncourt;126;6;132
44;Grand Est;08;3;19;063;La Besace;139;1;140
44;Grand Est;08;2;11;064;Biermes;307;5;312
44;Grand Est;08;3;03;065;Bièvres;47;1;48
44;Grand Est;08;2;08;066;Bignicourt;68;1;69
44;Grand Est;08;3;03;067;Blagny;1155;18;1173
44;Grand Est;08;1;17;069;Blanchefosse-et-Bay;147;2;149
44;Grand Est;08;2;08;070;Blanzy-la-Salonnaise;356;6;362
44;Grand Est;08;1;13;071;Blombay;138;2;140
44;Grand Est;08;1;02;081;Bogny-sur-Meuse;5032;75;5107
44;Grand Est;08;1;17;073;Bossus-lès-Rumigny;100;2;102
44;Grand Est;08;4;01;074;Bouconville;55;3;58
44;Grand Est;08;4;19;075;Boult-aux-Bois;137;3;140
44;Grand Est;08;1;10;076;Boulzicourt;957;19;976
44;Grand Est;08;4;01;077;Bourcq;51;1;52
44;Grand Est;08;1;13;078;Bourg-Fidèle;854;15;869
44;Grand Est;08;1;10;080;Bouvellemont;125;0;125
44;Grand Est;08;4;01;082;Brécy-Brières;79;2;81
44;Grand Est;08;3;03;083;Brévilly;361;7;368
44;Grand Est;08;2;08;084;Brienne-sur-Aisne;259;2;261
44;Grand Est;08;4;19;085;Brieulles-sur-Bar;221;7;228
44;Grand Est;08;4;19;086;Briquenay;94;7;101
44;Grand Est;08;1;13;087;Brognon;148;2;150
44;Grand Est;08;3;19;088;Bulson;133;4;137
44;Grand Est;08;4;19;089;Buzancy;359;9;368
44;Grand Est;08;3;03;090;Carignan;2880;45;2925
44;Grand Est;08;4;01;092;Cauroy;190;8;198
44;Grand Est;08;1;17;094;Cernion;57;3;60
44;Grand Est;08;1;10;095;Chagny;183;6;189
44;Grand Est;08;1;10;096;Chalandry-Elaire;689;15;704
44;Grand Est;08;4;01;097;Challerange;447;7;454
44;Grand Est;08;1;10;099;Champigneul-sur-Vence;122;4;126
44;Grand Est;08;4;01;098;Champigneulle;57;2;59
44;Grand Est;08;1;17;100;Champlin;72;1;73
44;Grand Est;08;3;15;101;La Chapelle;173;5;178
44;Grand Est;08;2;17;102;Chappes;96;6;102
44;Grand Est;08;4;01;103;Charbogne;223;3;226
44;Grand Est;08;4;01;104;Chardeny;56;1;57
44;Grand Est;08;1;98;105;Charleville-Mézières;46391;1128;47519
44;Grand Est;08;1;09;106;Charnois;75;0;75
44;Grand Est;08;2;08;107;Château-Porcien;1338;18;1356
44;Grand Est;08;4;01;109;Chatel-Chéhéry;141;3;144
44;Grand Est;08;2;08;111;Le Châtelet-sur-Retourne;788;2;790
44;Grand Est;08;1;13;110;Le Châtelet-sur-Sormonne;162;1;163
44;Grand Est;08;2;17;113;Chaumont-Porcien;492;11;503
44;Grand Est;08;3;89;115;Chémery-Chéhéry;561;4;565
44;Grand Est;08;2;17;117;Chesnois-Auboncourt;164;0;164
44;Grand Est;08;3;14;119;Cheveuges;442;7;449
44;Grand Est;08;4;01;120;Chevières;45;2;47
44;Grand Est;08;1;13;121;Chilly;139;5;144
44;Grand Est;08;1;09;122;Chooz;745;15;760
44;Grand Est;08;4;01;123;Chuffilly-Roche;73;1;74
44;Grand Est;08;1;17;124;Clavy-Warby;347;9;356
44;Grand Est;08;1;04;125;Cliron;393;9;402
44;Grand Est;08;4;01;128;Condé-lès-Autry;66;2;68
44;Grand Est;08;2;08;126;Condé-lès-Herpy;218;4;222
44;Grand Est;08;4;01;130;Contreuve;82;3;85
44;Grand Est;08;4;01;131;Cornay;63;3;66
44;Grand Est;08;2;11;132;Corny-Machéroménil;191;2;193
44;Grand Est;08;2;11;133;Coucy;503;5;508
44;Grand Est;08;4;01;134;Coulommes-et-Marqueny;78;1;79
44;Grand Est;08;4;19;135;La Croix-aux-Bois;149;3;152
44;Grand Est;08;3;16;136;Daigny;348;8;356
44;Grand Est;08;1;05;137;Damouzy;451;12;463
44;Grand Est;08;3;03;138;Les Deux-Villes;253;3;256
44;Grand Est;08;1;02;139;Deville;1041;10;1051
44;Grand Est;08;1;10;140;Dom-le-Mesnil;1101;21;1122
44;Grand Est;08;1;17;141;Dommery;181;4;185
44;Grand Est;08;3;14;142;Donchery;2029;27;2056
44;Grand Est;08;2;17;143;Doumely-Bégny;73;0;73
44;Grand Est;08;2;11;144;Doux;101;1;102
44;Grand Est;08;3;03;145;Douzy ;2188;60;2248
44;Grand Est;08;2;17;146;Draize;99;2;101
44;Grand Est;08;4;01;147;Dricourt;84;9;93
44;Grand Est;08;2;08;148;L' Écaille;279;7;286
44;Grand Est;08;1;17;149;L' Échelle;139;5;144
44;Grand Est;08;2;08;150;Écly;173;5;178
44;Grand Est;08;4;01;151;Écordal;315;13;328
44;Grand Est;08;3;03;153;Escombres-et-le-Chesnois;349;5;354
44;Grand Est;08;1;17;154;Estrebay;77;3;80
44;Grand Est;08;1;13;155;Étalle;102;5;107
44;Grand Est;08;1;13;156;Éteignières;511;3;514
44;Grand Est;08;1;10;158;Étrépigny;296;8;304
44;Grand Est;08;3;03;159;Euilly-et-Lombut;112;4;116
44;Grand Est;08;1;10;160;Évigny;189;4;193
44;Grand Est;08;4;01;161;Exermont;40;1;41
44;Grand Est;08;1;04;162;Fagnon;350;6;356
44;Grand Est;08;2;17;163;Faissault;254;4;258
44;Grand Est;08;4;01;164;Falaise;333;9;342
44;Grand Est;08;2;17;165;Faux;57;1;58
44;Grand Est;08;1;12;166;Fépin;267;2;269
44;Grand Est;08;1;17;167;La Férée;79;2;81
44;Grand Est;08;3;03;168;La Ferté-sur-Chiers;173;4;177
44;Grand Est;08;1;17;169;Flaignes-Havys;113;8;121
44;Grand Est;08;3;15;170;Fleigneux;209;3;212
44;Grand Est;08;4;01;171;Fléville;96;4;100
44;Grand Est;08;1;13;172;Fligny;187;1;188
44;Grand Est;08;1;10;173;Flize ;1722;52;1774
44;Grand Est;08;3;15;174;Floing;2335;56;2391
44;Grand Est;08;1;09;175;Foisches;221;7;228
44;Grand Est;08;4;19;176;Fossé;53;1;54
44;Grand Est;08;2;17;178;Fraillicourt;187;5;192
44;Grand Est;08;3;16;179;Francheval;603;13;616
44;Grand Est;08;1;07;180;La Francheville;1678;41;1719
44;Grand Est;08;1;17;182;Le Fréty;56;0;56
44;Grand Est;08;1;09;183;Fromelennes;1041;24;1065
44;Grand Est;08;3;03;184;Fromy;82;2;84
44;Grand Est;08;1;12;185;Fumay;3379;51;3430
44;Grand Est;08;4;19;186;Germont;48;0;48
44;Grand Est;08;1;18;187;Gernelle;311;8;319
44;Grand Est;08;1;18;188;Gespunsart;1036;25;1061
44;Grand Est;08;1;17;189;Girondelle;159;2;161
44;Grand Est;08;1;09;190;Givet;6610;151;6761
44;Grand Est;08;3;15;191;Givonne;1047;25;1072
44;Grand Est;08;2;17;192;Givron;87;1;88
44;Grand Est;08;4;01;193;Givry;272;6;278
44;Grand Est;08;3;15;194;Glaire;865;13;878
44;Grand Est;08;2;08;195;Gomont;324;3;327
44;Grand Est;08;2;17;196;Grandchamp;101;0;101
44;Grand Est;08;4;19;019;Les Grandes-Armoises;61;0;61
44;Grand Est;08;4;01;197;Grandham;38;2;40
44;Grand Est;08;4;01;198;Grandpré;526;16;542
44;Grand Est;08;1;18;199;La Grandville;798;17;815
44;Grand Est;08;4;01;200;Grivy-Loisy;185;6;191
44;Grand Est;08;1;17;201;Gruyères;100;2;102
44;Grand Est;08;1;13;202;Gué-d'Hossus;522;10;532
44;Grand Est;08;1;10;203;Guignicourt-sur-Vence;291;6;297
44;Grand Est;08;4;01;204;Guincourt;86;1;87
44;Grand Est;08;2;17;205;Hagnicourt;76;0;76
44;Grand Est;08;1;13;206;Ham-les-Moines;372;5;377
44;Grand Est;08;1;09;207;Ham-sur-Meuse;235;4;239
44;Grand Est;08;1;17;208;Hannappes;137;1;138
44;Grand Est;08;1;10;209;Hannogne-Saint-Martin;474;5;479
44;Grand Est;08;2;08;210;Hannogne-Saint-Rémy;112;4;116
44;Grand Est;08;3;19;211;Haraucourt;724;4;728
44;Grand Est;08;1;13;212;Harcy;505;10;515
44;Grand Est;08;1;12;214;Hargnies;487;3;490
44;Grand Est;08;4;19;215;Harricourt;41;2;43
44;Grand Est;08;1;04;216;Haudrecy;306;13;319
44;Grand Est;08;1;02;217;Haulmé;90;0;90
44;Grand Est;08;1;02;218;Les Hautes-Rivières;1464;24;1488
44;Grand Est;08;2;08;219;Hauteville;112;1;113
44;Grand Est;08;4;01;220;Hauviné;331;8;339
44;Grand Est;08;1;12;222;Haybes;1866;48;1914
44;Grand Est;08;3;03;223;Herbeuval;121;2;123
44;Grand Est;08;2;08;225;Herpy-l'Arlésienne;202;6;208
44;Grand Est;08;1;09;226;Hierges;183;4;187
44;Grand Est;08;1;10;228;La Horgne;181;7;188
44;Grand Est;08;2;08;229;Houdilcourt;130;7;137
44;Grand Est;08;1;05;230;Houldizy;382;6;388
44;Grand Est;08;3;15;232;Illy;408;9;417
44;Grand Est;08;4;19;233;Imécourt;47;1;48
44;Grand Est;08;2;08;234;Inaumont;102;0;102
44;Grand Est;08;1;18;235;Issancourt-et-Rumel;379;12;391
44;Grand Est;08;1;17;236;Jandun;291;10;301
44;Grand Est;08;1;02;237;Joigny-sur-Meuse;666;21;687
44;Grand Est;08;4;01;238;Jonval;101;1;102
44;Grand Est;08;2;08;239;Juniville;1226;29;1255
44;Grand Est;08;2;17;240;Justine-Herbigny;173;4;177
44;Grand Est;08;1;02;242;Laifour;439;8;447
44;Grand Est;08;1;17;243;Lalobbe;167;4;171
44;Grand Est;08;4;01;244;Lametz;72;3;75
44;Grand Est;08;4;19;246;Landres-et-Saint-Georges;76;1;77
44;Grand Est;08;1;09;247;Landrichamps;131;2;133
44;Grand Est;08;4;01;245;Lançon;32;2;34
44;Grand Est;08;1;17;248;Launois-sur-Vence;692;9;701
44;Grand Est;08;1;13;249;Laval-Morency;243;10;253
44;Grand Est;08;4;01;250;Leffincourt;189;5;194
44;Grand Est;08;1;17;251;Lépron-les-Vallées;76;2;78
44;Grand Est;08;3;03;252;Létanne;124;2;126
44;Grand Est;08;1;17;254;Liart;605;10;615
44;Grand Est;08;3;03;255;Linay;237;3;240
44;Grand Est;08;4;01;256;Liry;87;1;88
44;Grand Est;08;1;17;257;Logny-Bogny;157;3;160
44;Grand Est;08;4;01;259;Longwé;72;2;74
44;Grand Est;08;1;13;260;Lonny;636;8;644
44;Grand Est;08;2;17;262;Lucquy;580;34;614
44;Grand Est;08;1;18;263;Lumes;1129;26;1155
44;Grand Est;08;4;01;264;Machault;512;11;523
44;Grand Est;08;3;19;268;Maisoncelle-et-Villers;68;4;72
44;Grand Est;08;3;03;269;Malandry;79;1;80
44;Grand Est;08;4;01;271;Manre;100;6;106
44;Grand Est;08;1;17;272;Maranwez;59;0;59
44;Grand Est;08;1;17;273;Marby;67;1;68
44;Grand Est;08;4;01;274;Marcq;101;1;102
44;Grand Est;08;3;03;275;Margny;202;4;206
44;Grand Est;08;3;03;276;Margut;756;14;770
44;Grand Est;08;1;17;277;Marlemont;135;4;139
44;Grand Est;08;4;01;278;Marquigny;83;0;83
44;Grand Est;08;4;01;279;Mars-sous-Bourcq;57;2;59
44;Grand Est;08;4;01;280;Marvaux-Vieux;74;2;76
44;Grand Est;08;3;03;281;Matton-et-Clémency;468;9;477
44;Grand Est;08;1;13;282;Maubert-Fontaine;1037;72;1109
44;Grand Est;08;1;10;283;Mazerny;126;1;127
44;Grand Est;08;1;02;284;Les Mazures;890;23;913
44;Grand Est;08;2;08;286;Ménil-Annelles;111;5;116
44;Grand Est;08;2;08;287;Ménil-Lépinois;135;2;137
44;Grand Est;08;2;17;288;Mesmont;92;1;93
44;Grand Est;08;3;03;289;Messincourt;610;8;618
44;Grand Est;08;3;03;291;Mogues;232;5;237
44;Grand Est;08;3;03;293;Moiry;145;5;150
44;Grand Est;08;3;16;294;La Moncelle;138;4;142
44;Grand Est;08;1;10;295;Mondigny;178;4;182
44;Grand Est;08;3;19;300;Le Mont-Dieu;16;0;16
44;Grand Est;08;2;11;306;Mont-Laurent;59;3;62
44;Grand Est;08;4;01;308;Mont-Saint-Martin;85;0;85
44;Grand Est;08;4;01;309;Mont-Saint-Remy;57;1;58
44;Grand Est;08;4;01;296;Montcheutin;117;7;124
44;Grand Est;08;1;02;297;Montcornet;298;8;306
44;Grand Est;08;1;06;298;Montcy-Notre-Dame;1580;45;1625
44;Grand Est;08;4;19;301;Montgon;67;4;71
44;Grand Est;08;1;02;302;Monthermé;2283;88;2371
44;Grand Est;08;4;01;303;Monthois;379;10;389
44;Grand Est;08;1;12;304;Montigny-sur-Meuse;81;2;83
44;Grand Est;08;1;10;305;Montigny-sur-Vence;248;5;253
44;Grand Est;08;2;17;307;Montmeillant;82;1;83
44;Grand Est;08;4;01;310;Mouron;69;5;74
44;Grand Est;08;3;03;311;Mouzon;2266;40;2306
44;Grand Est;08;1;13;312;Murtin-et-Bogny;185;7;192
44;Grand Est;08;2;11;313;Nanteuil-sur-Aisne;139;4;143
44;Grand Est;08;2;08;314;Neuflize;790;23;813
44;Grand Est;08;1;17;315;Neufmaison;72;2;74
44;Grand Est;08;1;18;316;Neufmanil;1013;15;1028
44;Grand Est;08;3;19;317;La Neuville-à-Maire;118;4;122
44;Grand Est;08;1;13;318;La Neuville-aux-Joûtes;358;8;366
44;Grand Est;08;4;01;321;Neuville-Day;163;4;167
44;Grand Est;08;2;08;320;La Neuville-en-Tourne-à-Fuy;566;17;583
44;Grand Est;08;1;13;322;Neuville-lès-This;375;14;389
44;Grand Est;08;2;17;323;La Neuville-lès-Wasigny;161;1;162
44;Grand Est;08;1;13;319;Neuville-lez-Beaulieu;334;8;342
44;Grand Est;08;2;17;324;Neuvizy;115;2;117
44;Grand Est;08;4;19;325;Noirval;27;1;28
44;Grand Est;08;4;19;326;Nouart;131;2;133
44;Grand Est;08;1;10;327;Nouvion-sur-Meuse;2246;37;2283
44;Grand Est;08;1;05;328;Nouzonville;5760;111;5871
44;Grand Est;08;2;17;329;Novion-Porcien;493;11;504
44;Grand Est;08;2;11;330;Novy-Chevrières;751;9;760
44;Grand Est;08;3;14;331;Noyers-Pont-Maugis;675;14;689
44;Grand Est;08;4;19;332;Oches;44;4;48
44;Grand Est;08;4;01;333;Olizy-Primat;236;9;245
44;Grand Est;08;1;10;334;Omicourt;40;2;42
44;Grand Est;08;1;10;335;Omont;82;1;83
44;Grand Est;08;3;03;336;Osnes;231;3;234
44;Grand Est;08;4;01;338;Pauvres;188;3;191
44;Grand Est;08;2;08;339;Perthes;308;4;312
44;Grand Est;08;4;19;020;Les Petites-Armoises;62;0;62
44;Grand Est;08;2;08;340;Poilcourt-Sydney;179;4;183
44;Grand Est;08;1;10;341;Poix-Terron;842;40;882
44;Grand Est;08;3;16;342;Pouru-aux-Bois;253;5;258
44;Grand Est;08;3;16;343;Pouru-Saint-Remy;1148;26;1174
44;Grand Est;08;1;17;344;Prez;133;2;135
44;Grand Est;08;1;04;346;Prix-lès-Mézières;1345;36;1381
44;Grand Est;08;3;03;347;Puilly-et-Charbeaux;225;5;230
44;Grand Est;08;2;17;348;Puiseux;113;3;116
44;Grand Est;08;3;03;349;Pure;587;6;593
44;Grand Est;08;4;19;350;Quatre-Champs;228;3;231
44;Grand Est;08;4;01;351;Quilly;83;0;83
44;Grand Est;08;1;17;352;Raillicourt;202;4;206
44;Grand Est;08;1;09;353;Rancennes;720;22;742
44;Grand Est;08;3;19;354;Raucourt-et-Flaba;826;13;839
44;Grand Est;08;1;13;355;Regniowez;388;7;395
44;Grand Est;08;2;17;356;Remaucourt;175;1;176
44;Grand Est;08;3;19;357;Remilly-Aillicourt;778;15;793
44;Grand Est;08;1;13;358;Remilly-les-Pothées;252;4;256
44;Grand Est;08;2;17;360;Renneville;198;5;203
44;Grand Est;08;1;02;361;Renwez;1668;58;1726
44;Grand Est;08;2;11;362;Rethel;7522;302;7824
44;Grand Est;08;1;12;363;Revin;6038;132;6170
44;Grand Est;08;4;01;364;Rilly-sur-Aisne;137;2;139
44;Grand Est;08;1;13;365;Rimogne;1368;21;1389
44;Grand Est;08;2;17;366;Rocquigny;690;11;701
44;Grand Est;08;1;13;367;Rocroi;2307;29;2336
44;Grand Est;08;2;08;368;Roizy;219;3;222
44;Grand Est;08;2;17;369;La Romagne;131;3;134
44;Grand Est;08;1;17;370;Rouvroy-sur-Audry;577;6;583
44;Grand Est;08;2;17;372;Rubigny;67;0;67
44;Grand Est;08;1;17;373;Rumigny;311;4;315
44;Grand Est;08;4;01;374;La Sabotterie;116;0;116
44;Grand Est;08;3;03;375;Sachy;180;6;186
44;Grand Est;08;3;03;376;Sailly;252;5;257
44;Grand Est;08;3;14;377;Saint-Aignan;152;2;154
44;Grand Est;08;4;01;378;Saint-Clément-à-Arnes;105;1;106
44;Grand Est;08;4;01;379;Saint-Étienne-à-Arnes;243;10;253
44;Grand Est;08;2;08;380;Saint-Fergeux;213;4;217
44;Grand Est;08;2;08;381;Saint-Germainmont;832;12;844
44;Grand Est;08;2;17;382;Saint-Jean-aux-Bois;102;3;105
44;Grand Est;08;4;01;383;Saint-Juvin;103;4;107
44;Grand Est;08;4;01;384;Saint-Lambert-et-Mont-de-Jeux;144;3;147
44;Grand Est;08;1;18;385;Saint-Laurent;1088;171;1259
44;Grand Est;08;2;08;386;Saint-Loup-en-Champagne;333;7;340
44;Grand Est;08;4;01;387;Saint-Loup-Terrier;180;6;186
44;Grand Est;08;1;10;388;Saint-Marceau;344;11;355
44;Grand Est;08;1;13;389;Saint-Marcel;344;7;351
44;Grand Est;08;3;15;391;Saint-Menges;960;16;976
44;Grand Est;08;4;01;392;Saint-Morel;204;12;216
44;Grand Est;08;4;01;393;Saint-Pierre-à-Arnes;67;1;68
44;Grand Est;08;1;10;395;Saint-Pierre-sur-Vence;129;4;133
44;Grand Est;08;4;19;394;Saint-Pierremont;72;3;75
44;Grand Est;08;2;08;396;Saint-Quentin-le-Petit;122;0;122
44;Grand Est;08;2;08;397;Saint-Remy-le-Petit;46;0;46
44;Grand Est;08;4;01;390;Sainte-Marie;80;4;84
44;Grand Est;08;4;01;398;Sainte-Vaubourg;88;2;90
44;Grand Est;08;1;10;400;Sapogne-et-Feuchères;517;10;527
44;Grand Est;08;3;03;399;Sapogne-sur-Marche;138;3;141
44;Grand Est;08;4;01;401;Saulces-Champenoises;237;3;240
44;Grand Est;08;2;17;402;Saulces-Monclin;815;9;824
44;Grand Est;08;2;11;403;Sault-lès-Rethel;1915;18;1933
44;Grand Est;08;2;08;404;Sault-Saint-Remy;215;3;218
44;Grand Est;08;4;19;405;Sauville;241;8;249
44;Grand Est;08;4;01;406;Savigny-sur-Aisne;374;12;386
44;Grand Est;08;4;01;407;Séchault;60;0;60
44;Grand Est;08;1;05;408;Sécheval;555;10;565
44;Grand Est;08;3;99;409;Sedan;16193;348;16541
44;Grand Est;08;4;01;410;Semide;184;15;199
44;Grand Est;08;4;01;411;Semuy;91;0;91
44;Grand Est;08;4;01;412;Senuc;164;4;168
44;Grand Est;08;2;08;413;Seraincourt;272;3;275
44;Grand Est;08;2;17;415;Sery;348;13;361
44;Grand Est;08;2;11;416;Seuil;168;6;174
44;Grand Est;08;1;13;417;Sévigny-la-Forêt;276;8;284
44;Grand Est;08;2;08;418;Sévigny-Waleppe;225;3;228
44;Grand Est;08;1;17;419;Signy-l'Abbaye;1357;28;1385
44;Grand Est;08;1;13;420;Signy-le-Petit;1218;22;1240
44;Grand Est;08;3;03;421;Signy-Montlibert;92;0;92
44;Grand Est;08;1;10;422;Singly;135;4;139
44;Grand Est;08;4;19;424;Sommauthe;119;2;121
44;Grand Est;08;4;01;425;Sommerance;40;1;41
44;Grand Est;08;2;08;426;Son;98;0;98
44;Grand Est;08;2;11;427;Sorbon;200;1;201
44;Grand Est;08;2;17;428;Sorcy-Bauthémont;148;2;150
44;Grand Est;08;1;13;429;Sormonne;540;14;554
44;Grand Est;08;3;19;430;Stonne;40;2;42
44;Grand Est;08;4;01;431;Sugny;100;6;106
44;Grand Est;08;1;13;432;Sury;109;4;113
44;Grand Est;08;4;01;433;Suzanne;63;2;65
44;Grand Est;08;4;19;434;Sy;51;2;53
44;Grand Est;08;2;08;435;Tagnon;884;13;897
44;Grand Est;08;1;13;436;Taillette;407;7;414
44;Grand Est;08;4;19;437;Tailly;174;6;180
44;Grand Est;08;2;08;438;Taizy;106;2;108
44;Grand Est;08;4;19;439;Tannay;153;10;163
44;Grand Est;08;1;13;440;Tarzy;142;2;144
44;Grand Est;08;3;03;444;Tétaigne;130;4;134
44;Grand Est;08;3;14;445;Thelonne;410;2;412
44;Grand Est;08;4;19;446;Thénorgues;81;0;81
44;Grand Est;08;1;02;448;Thilay;1053;12;1065
44;Grand Est;08;1;17;449;Thin-le-Moutier;631;15;646
44;Grand Est;08;1;13;450;This;226;9;235
44;Grand Est;08;2;08;451;Le Thour;390;8;398
44;Grand Est;08;2;11;452;Thugny-Trugny;272;0;272
44;Grand Est;08;4;19;453;Toges;103;3;106
44;Grand Est;08;1;10;454;Touligny;85;2;87
44;Grand Est;08;4;01;455;Tourcelles-Chaumont;92;1;93
44;Grand Est;08;1;02;456;Tournavaux;237;4;241
44;Grand Est;08;1;04;457;Tournes;1072;27;1099
44;Grand Est;08;4;01;458;Tourteron;182;4;186
44;Grand Est;08;3;03;459;Tremblois-lès-Carignan;159;3;162
44;Grand Est;08;1;13;460;Tremblois-lès-Rocroi;155;0;155
44;Grand Est;08;4;19;461;Vandy;206;1;207
44;Grand Est;08;4;01;462;Vaux-Champagne;129;4;133
44;Grand Est;08;4;19;463;Vaux-en-Dieulet;54;1;55
44;Grand Est;08;4;01;464;Vaux-lès-Mouron;80;3;83
44;Grand Est;08;3;03;466;Vaux-lès-Mouzon;72;2;74
44;Grand Est;08;2;17;465;Vaux-lès-Rubigny;45;3;48
44;Grand Est;08;2;17;467;Vaux-Montreuil;108;0;108
44;Grand Est;08;1;17;468;Vaux-Villaine;194;1;195
44;Grand Est;08;1;10;469;Vendresse;480;12;492
44;Grand Est;08;4;19;470;Verpel;67;1;68
44;Grand Est;08;4;19;471;Verrières;28;2;30
44;Grand Est;08;2;17;472;Viel-Saint-Remy;295;2;297
44;Grand Est;08;2;08;473;Vieux-lès-Asfeld;305;7;312
44;Grand Est;08;1;18;483;Ville-sur-Lumes;522;13;535
44;Grand Est;08;2;08;484;Ville-sur-Retourne;82;1;83
44;Grand Est;08;2;08;476;Villers-devant-le-Thour;418;7;425
44;Grand Est;08;3;03;477;Villers-devant-Mouzon;104;0;104
44;Grand Est;08;1;10;478;Villers-le-Tilleul;239;3;242
44;Grand Est;08;2;17;479;Villers-le-Tourneur;193;2;195
44;Grand Est;08;1;18;480;Villers-Semeuse;3572;71;3643
44;Grand Est;08;3;14;481;Villers-sur-Bar;251;5;256
44;Grand Est;08;1;10;482;Villers-sur-le-Mont;108;3;111
44;Grand Est;08;3;03;485;Villy;209;12;221
44;Grand Est;08;1;09;486;Vireux-Molhain;1473;32;1505
44;Grand Est;08;1;09;487;Vireux-Wallerand;1942;56;1998
44;Grand Est;08;1;18;488;Vivier-au-Court;2930;83;3013
44;Grand Est;08;4;01;489;Voncq;218;5;223
44;Grand Est;08;4;  ;490;Vouziers ;4339;150;4489
44;Grand Est;08;3;14;491;Vrigne aux Bois ;3598;78;3676
44;Grand Est;08;1;10;492;Vrigne-Meuse;310;8;318
44;Grand Est;08;3;14;494;Wadelincourt;465;5;470
44;Grand Est;08;2;17;496;Wagnon;130;1;131
44;Grand Est;08;1;04;497;Warcq;1273;26;1299
44;Grand Est;08;1;10;498;Warnécourt;379;16;395
44;Grand Est;08;2;17;499;Wasigny;328;3;331
44;Grand Est;08;2;17;500;Wignicourt;57;1;58
44;Grand Est;08;3;03;501;Williers;41;3;44
44;Grand Est;08;3;03;502;Yoncq;94;3;97
44;Grand Est;08;1;10;503;Yvernaumont;133;1;134
76;Occitanie;09;3;03;001;Aigues-Juntes;63;1;64
76;Occitanie;09;2;06;002;Aigues-Vives;655;21;676
76;Occitanie;09;2;09;003;L' Aiguillon;413;10;423
76;Occitanie;09;1;01;004;Albiès;122;7;129
76;Occitanie;09;3;03;005;Aleu;134;2;136
76;Occitanie;09;1;12;006;Alliat;53;0;53
76;Occitanie;09;3;03;007;Allières;72;0;72
76;Occitanie;09;3;03;008;Alos;120;2;122
76;Occitanie;09;3;03;009;Alzen;265;13;278
76;Occitanie;09;3;04;011;Antras;68;1;69
76;Occitanie;09;1;01;012;Appy;26;1;27
76;Occitanie;09;1;13;013;Arabaux;78;2;80
76;Occitanie;09;3;04;014;Argein;193;7;200
76;Occitanie;09;1;12;015;Arignac;700;8;708
76;Occitanie;09;1;12;016;Arnave;213;8;221
76;Occitanie;09;3;04;017;Arrien-en-Bethmale;111;2;113
76;Occitanie;09;3;04;018;Arrout;88;4;92
76;Occitanie;09;3;02;019;Artigat;563;10;573
76;Occitanie;09;1;01;020;Artigues;49;0;49
76;Occitanie;09;1;07;021;Artix;131;3;134
76;Occitanie;09;2;08;022;Arvigna;219;0;219
76;Occitanie;09;1;01;023;Ascou;120;1;121
76;Occitanie;09;1;01;024;Aston;214;5;219
76;Occitanie;09;3;04;025;Aucazein;57;3;60
76;Occitanie;09;3;04;026;Audressein;143;1;144
76;Occitanie;09;3;04;027;Augirein;78;2;80
76;Occitanie;09;1;01;296;Aulos-Sinsat ;159;2;161
76;Occitanie;09;3;03;029;Aulus-les-Bains;161;6;167
76;Occitanie;09;1;12;030;Auzat;481;10;491
76;Occitanie;09;1;01;032;Ax-les-Thermes;1277;66;1343
76;Occitanie;09;1;01;031;Axiat;41;1;42
76;Occitanie;09;3;11;033;Bagert;37;1;38
76;Occitanie;09;3;04;034;Balacet;30;2;32
76;Occitanie;09;3;04;035;Balaguères;196;2;198
76;Occitanie;09;3;11;037;Barjac;42;0;42
76;Occitanie;09;3;02;038;La Bastide-de-Besplas;382;7;389
76;Occitanie;09;2;06;039;La Bastide-de-Bousignac;339;13;352
76;Occitanie;09;2;10;040;La Bastide-de-Lordat;288;7;295
76;Occitanie;09;3;03;042;La Bastide-de-Sérou;967;14;981
76;Occitanie;09;3;11;041;La Bastide-du-Salat;193;7;200
76;Occitanie;09;2;06;043;La Bastide-sur-l'Hers;671;13;684
76;Occitanie;09;1;13;044;Baulou;171;3;174
76;Occitanie;09;1;12;045;Bédeilhac-et-Aynat;195;1;196
76;Occitanie;09;3;11;046;Bédeille;69;3;72
76;Occitanie;09;2;09;047;Bélesta;1075;19;1094
76;Occitanie;09;2;06;048;Belloc;77;1;78
76;Occitanie;09;1;13;049;Bénac;180;3;183
76;Occitanie;09;2;07;050;Benagues;523;7;530
76;Occitanie;09;2;09;051;Bénaix;149;4;153
76;Occitanie;09;2;06;052;Besset;163;8;171
76;Occitanie;09;1;01;053;Bestiac;20;3;23
76;Occitanie;09;3;11;054;Betchat;346;5;351
76;Occitanie;09;3;04;055;Bethmale;94;0;94
76;Occitanie;09;2;07;056;Bézac;376;10;386
76;Occitanie;09;3;03;057;Biert;319;5;324
76;Occitanie;09;1;12;058;Bompas;192;5;197
76;Occitanie;09;3;04;059;Bonac-Irazein;119;4;123
76;Occitanie;09;2;10;060;Bonnac;742;10;752
76;Occitanie;09;3;02;061;Les Bordes-sur-Arize;512;6;518
76;Occitanie;09;3;04;062;Bordes-Uchentein;186;4;190
76;Occitanie;09;1;13;063;Le Bosc;103;2;105
76;Occitanie;09;1;01;064;Bouan;39;0;39
76;Occitanie;09;3;03;065;Boussenac;214;1;215
76;Occitanie;09;1;13;066;Brassac;626;10;636
76;Occitanie;09;2;10;067;Brie;216;3;219
76;Occitanie;09;1;13;068;Burret;40;0;40
76;Occitanie;09;3;04;069;Buzan;28;0;28
76;Occitanie;09;1;01;070;Les Cabannes;335;8;343
76;Occitanie;09;3;03;071;Cadarcet;224;8;232
76;Occitanie;09;1;13;072;Calzan;33;0;33
76;Occitanie;09;3;02;073;Camarade;188;1;189
76;Occitanie;09;2;06;074;Camon;145;1;146
76;Occitanie;09;3;02;075;Campagne-sur-Arize;279;8;287
76;Occitanie;09;2;10;076;Canté;204;7;211
76;Occitanie;09;1;12;077;Capoulet-et-Junac;175;1;176
76;Occitanie;09;1;01;078;Carcanières;75;2;77
76;Occitanie;09;3;02;079;Carla-Bayle;788;14;802
76;Occitanie;09;2;09;080;Carla-de-Roquefort;171;2;173
76;Occitanie;09;2;08;081;Le Carlaret;274;11;285
76;Occitanie;09;3;03;082;Castelnau-Durban;452;8;460
76;Occitanie;09;3;02;083;Castéras;23;0;23
76;Occitanie;09;3;02;084;Castex;94;1;95
76;Occitanie;09;3;04;085;Castillon-en-Couserans;399;5;404
76;Occitanie;09;3;11;086;Caumont;328;5;333
76;Occitanie;09;1;01;087;Caussou;48;0;48
76;Occitanie;09;1;01;088;Caychax;15;0;15
76;Occitanie;09;2;06;089;Cazals-des-Baylès;56;2;58
76;Occitanie;09;1;13;090;Cazaux;38;6;44
76;Occitanie;09;3;11;091;Cazavet;213;3;216
76;Occitanie;09;1;12;092;Cazenave-Serres-et-Allens;56;3;59
76;Occitanie;09;1;12;093;Celles;154;0;154
76;Occitanie;09;3;11;094;Cérizols;139;9;148
76;Occitanie;09;3;04;095;Cescau;145;1;146
76;Occitanie;09;1;01;096;Château-Verdun;43;3;46
76;Occitanie;09;3;03;097;Clermont;112;0;112
76;Occitanie;09;3;11;098;Contrazy;67;2;69
76;Occitanie;09;1;05;099;Cos;393;19;412
76;Occitanie;09;3;03;100;Couflens;88;1;89
76;Occitanie;09;1;13;101;Coussa;275;3;278
76;Occitanie;09;2;06;102;Coutens;170;2;172
76;Occitanie;09;1;13;103;Crampagna;852;17;869
76;Occitanie;09;1;13;104;Dalou;774;19;793
76;Occitanie;09;3;02;105;Daumazan-sur-Arize;717;11;728
76;Occitanie;09;2;09;106;Dreuilhe;357;16;373
76;Occitanie;09;2;06;107;Dun;611;15;626
76;Occitanie;09;3;03;108;Durban-sur-Arize;182;4;186
76;Occitanie;09;3;02;109;Durfort;159;3;162
76;Occitanie;09;3;03;110;Encourtiech;89;4;93
76;Occitanie;09;3;04;111;Engomer;300;4;304
76;Occitanie;09;3;03;113;Ercé;550;3;553
76;Occitanie;09;3;03;114;Erp;125;2;127
76;Occitanie;09;2;06;115;Esclagne;139;2;141
76;Occitanie;09;2;07;116;Escosse;401;3;404
76;Occitanie;09;2;10;117;Esplas;102;6;108
76;Occitanie;09;3;03;118;Esplas-de-Sérou;186;4;190
76;Occitanie;09;3;04;119;Eycheil;550;6;556
76;Occitanie;09;3;11;120;Fabas;352;4;356
76;Occitanie;09;1;05;121;Ferrières-sur-Ariège;763;100;863
76;Occitanie;09;1;05;122;Foix;9452;323;9775
76;Occitanie;09;3;02;123;Fornex;113;1;114
76;Occitanie;09;3;02;124;Le Fossat;1043;14;1057
76;Occitanie;09;2;09;125;Fougax-et-Barrineuf;434;5;439
76;Occitanie;09;1;09;126;Freychenet;87;3;90
76;Occitanie;09;3;02;127;Gabre;123;4;127
76;Occitanie;09;3;11;128;Gajan;306;10;316
76;Occitanie;09;3;04;129;Galey;117;0;117
76;Occitanie;09;1;05;130;Ganac;731;9;740
76;Occitanie;09;1;01;131;Garanou;153;0;153
76;Occitanie;09;2;10;132;Gaudiès;246;3;249
76;Occitanie;09;1;12;133;Génat;21;1;22
76;Occitanie;09;1;12;134;Gestiès;31;1;32
76;Occitanie;09;1;12;136;Gourbit;74;3;77
76;Occitanie;09;1;13;137;Gudas;186;4;190
76;Occitanie;09;1;13;138;L' Herm;199;23;222
76;Occitanie;09;1;01;139;L' Hospitalet-près-l'Andorre;100;0;100
76;Occitanie;09;1;01;140;Ignaux;116;6;122
76;Occitanie;09;2;09;142;Ilhat;116;0;116
76;Occitanie;09;3;04;141;Illartein;73;0;73
76;Occitanie;09;1;12;143;Illier-et-Laramade;29;0;29
76;Occitanie;09;2;08;145;Les Issards;240;9;249
76;Occitanie;09;2;10;146;Justiniac;57;0;57
76;Occitanie;09;2;10;147;Labatut;178;1;179
76;Occitanie;09;3;11;148;Lacave;134;5;139
76;Occitanie;09;3;03;149;Lacourt;193;4;197
76;Occitanie;09;2;06;150;Lagarde;198;6;204
76;Occitanie;09;3;02;151;Lanoux;51;1;52
76;Occitanie;09;1;12;152;Lapège;26;1;27
76;Occitanie;09;2;06;153;Lapenne;123;4;127
76;Occitanie;09;3;03;154;Larbont;57;2;59
76;Occitanie;09;1;01;155;Larcat;46;0;46
76;Occitanie;09;1;01;156;Larnat;20;0;20
76;Occitanie;09;2;06;157;Laroque-d'Olmes;2412;53;2465
76;Occitanie;09;3;11;158;Lasserre;250;7;257
76;Occitanie;09;1;01;159;Lassur;92;0;92
76;Occitanie;09;2;09;160;Lavelanet;6099;166;6265
76;Occitanie;09;2;06;161;Léran;602;15;617
76;Occitanie;09;1;12;162;Lercoul;19;0;19
76;Occitanie;09;2;07;163;Lescousse;77;0;77
76;Occitanie;09;3;03;164;Lescure;492;22;514
76;Occitanie;09;2;09;165;Lesparrou;233;1;234
76;Occitanie;09;2;09;166;Leychert;99;6;105
76;Occitanie;09;3;02;167;Lézat-sur-Lèze;2336;40;2376
76;Occitanie;09;2;09;168;Lieurac;188;9;197
76;Occitanie;09;2;06;169;Limbrassac;130;3;133
76;Occitanie;09;2;10;170;Lissac;250;6;256
76;Occitanie;09;1;01;171;Lordat;69;0;69
76;Occitanie;09;3;11;289;Lorp-Sentaraille;1477;34;1511
76;Occitanie;09;3;02;172;Loubaut;27;0;27
76;Occitanie;09;1;13;173;Loubens;280;5;285
76;Occitanie;09;1;13;174;Loubières;344;12;356
76;Occitanie;09;2;08;175;Ludiès;92;4;96
76;Occitanie;09;1;01;176;Luzenac;530;10;540
76;Occitanie;09;2;07;177;Madière;226;6;232
76;Occitanie;09;2;06;178;Malegoude;46;4;50
76;Occitanie;09;1;13;179;Malléon;77;1;78
76;Occitanie;09;2;06;180;Manses;122;1;123
76;Occitanie;09;3;02;181;Le Mas-d'Azil;1151;10;1161
76;Occitanie;09;3;03;182;Massat;685;9;694
76;Occitanie;09;3;11;183;Mauvezin-de-Prat;102;4;106
76;Occitanie;09;3;11;184;Mauvezin-de-Sainte-Croix;40;1;41
76;Occitanie;09;2;10;185;Mazères;3875;83;3958
76;Occitanie;09;3;02;186;Méras;108;0;108
76;Occitanie;09;3;11;187;Mercenac;359;10;369
76;Occitanie;09;1;12;188;Mercus-Garrabet;1202;24;1226
76;Occitanie;09;1;01;189;Mérens-les-Vals;168;4;172
76;Occitanie;09;3;11;190;Mérigon;116;1;117
76;Occitanie;09;1;12;192;Miglos;115;3;118
76;Occitanie;09;1;01;193;Mijanès;60;0;60
76;Occitanie;09;2;06;194;Mirepoix;3130;132;3262
76;Occitanie;09;3;02;195;Monesple;29;0;29
76;Occitanie;09;3;03;196;Montagagne;81;1;82
76;Occitanie;09;1;01;197;Montaillou;17;0;17
76;Occitanie;09;3;11;198;Montardit;199;4;203
76;Occitanie;09;2;10;199;Montaut;706;18;724
76;Occitanie;09;2;06;200;Montbel;104;2;106
76;Occitanie;09;3;04;201;Montégut-en-Couserans;76;1;77
76;Occitanie;09;1;13;202;Montégut-Plantaurel;335;8;343
76;Occitanie;09;3;03;203;Montels;158;9;167
76;Occitanie;09;3;11;204;Montesquieu-Avantès;248;10;258
76;Occitanie;09;3;02;205;Montfa;81;2;83
76;Occitanie;09;2;09;206;Montferrier;515;12;527
76;Occitanie;09;1;05;207;Montgaillard;1474;31;1505
76;Occitanie;09;3;11;208;Montgauch;123;0;123
76;Occitanie;09;3;11;209;Montjoie-en-Couserans;1058;22;1080
76;Occitanie;09;1;12;210;Montoulieu;407;7;414
76;Occitanie;09;2;09;211;Montségur;118;2;120
76;Occitanie;09;3;03;212;Montseron;98;1;99
76;Occitanie;09;2;06;213;Moulin-Neuf;240;3;243
76;Occitanie;09;3;04;214;Moulis;759;12;771
76;Occitanie;09;2;09;215;Nalzen;129;4;133
76;Occitanie;09;3;03;216;Nescus;62;1;63
76;Occitanie;09;1;12;217;Niaux;156;2;158
76;Occitanie;09;1;01;218;Orgeix;88;1;89
76;Occitanie;09;3;04;219;Orgibet;191;4;195
76;Occitanie;09;1;01;220;Orlu;164;3;167
76;Occitanie;09;1;01;221;Ornolac-Ussat-les-Bains;239;3;242
76;Occitanie;09;1;12;222;Orus;26;0;26
76;Occitanie;09;3;03;223;Oust;550;7;557
76;Occitanie;09;3;02;224;Pailhès;472;8;480
76;Occitanie;09;2;99;225;Pamiers;15603;475;16078
76;Occitanie;09;1;01;226;Pech;37;0;37
76;Occitanie;09;2;09;227;Péreille;205;3;208
76;Occitanie;09;1;01;228;Perles-et-Castelet;223;5;228
76;Occitanie;09;2;06;229;Le Peyrat;469;8;477
76;Occitanie;09;1;01;230;Le Pla;58;0;58
76;Occitanie;09;3;03;231;Le Port;159;1;160
76;Occitanie;09;1;01;232;Prades;32;0;32
76;Occitanie;09;2;06;233;Pradettes;49;1;50
76;Occitanie;09;1;13;234;Pradières;117;3;120
76;Occitanie;09;3;11;235;Prat-Bonrepaux;891;16;907
76;Occitanie;09;1;12;236;Prayols;365;16;381
76;Occitanie;09;1;01;237;Le Puch;29;1;30
76;Occitanie;09;2;08;238;Les Pujols;816;16;832
76;Occitanie;09;1;01;239;Quérigut;133;1;134
76;Occitanie;09;1;12;240;Quié;300;3;303
76;Occitanie;09;1;12;241;Rabat-les-Trois-Seigneurs;361;5;366
76;Occitanie;09;2;09;242;Raissac;50;1;51
76;Occitanie;09;2;06;243;Régat;84;3;87
76;Occitanie;09;2;06;244;Rieucros;705;12;717
76;Occitanie;09;1;07;245;Rieux-de-Pelleport;1299;36;1335
76;Occitanie;09;3;03;246;Rimont;530;20;550
76;Occitanie;09;3;03;247;Rivèrenert;165;9;174
76;Occitanie;09;2;09;249;Roquefixade;148;4;152
76;Occitanie;09;2;09;250;Roquefort-les-Cascades;92;2;94
76;Occitanie;09;2;06;251;Roumengoux;160;8;168
76;Occitanie;09;1;01;252;Rouze;86;0;86
76;Occitanie;09;3;02;253;Sabarat;378;6;384
76;Occitanie;09;2;08;254;Saint-Amadou;242;6;248
76;Occitanie;09;2;07;255;Saint-Amans;44;0;44
76;Occitanie;09;1;07;256;Saint-Bauzeil;58;0;58
76;Occitanie;09;1;13;258;Saint-Félix-de-Rieutord;456;9;465
76;Occitanie;09;2;06;259;Saint-Félix-de-Tournegat;147;4;151
76;Occitanie;09;3;04;261;Saint-Girons;6408;401;6809
76;Occitanie;09;2;09;262;Saint-Jean-d'Aigues-Vives;385;6;391
76;Occitanie;09;1;13;264;Saint-Jean-de-Verges;1265;18;1283
76;Occitanie;09;3;04;263;Saint-Jean-du-Castillonnais;22;1;23
76;Occitanie;09;2;07;265;Saint-Jean-du-Falga;2863;62;2925
76;Occitanie;09;2;06;266;Saint-Julien-de-Gras-Capou;60;2;62
76;Occitanie;09;3;04;267;Saint-Lary;129;2;131
76;Occitanie;09;3;11;268;Saint-Lizier;1357;31;1388
76;Occitanie;09;2;07;270;Saint-Martin-d'Oydes;222;5;227
76;Occitanie;09;1;13;269;Saint-Martin-de-Caralp;364;11;375
76;Occitanie;09;2;07;271;Saint-Michel;77;2;79
76;Occitanie;09;1;12;272;Saint-Paul-de-Jarrat;1317;27;1344
76;Occitanie;09;1;05;273;Saint-Pierre-de-Rivière;666;23;689
76;Occitanie;09;2;06;274;Saint-Quentin-la-Tour;338;6;344
76;Occitanie;09;2;10;275;Saint-Quirc;376;8;384
76;Occitanie;09;2;07;276;Saint-Victor-Rouzaud;222;10;232
76;Occitanie;09;3;02;277;Saint-Ybars;688;11;699
76;Occitanie;09;3;11;257;Sainte-Croix-Volvestre;623;16;639
76;Occitanie;09;2;06;260;Sainte-Foi;27;0;27
76;Occitanie;09;3;02;342;Sainte-Suzanne;239;2;241
76;Occitanie;09;3;04;279;Salsein;45;2;47
76;Occitanie;09;1;12;280;Saurat;640;9;649
76;Occitanie;09;2;09;281;Sautel;115;2;117
76;Occitanie;09;2;10;282;Saverdun;4841;165;5006
76;Occitanie;09;1;01;283;Savignac-les-Ormeaux;380;14;394
76;Occitanie;09;1;13;284;Ségura;186;6;192
76;Occitanie;09;3;03;285;Seix;706;14;720
76;Occitanie;09;1;01;287;Senconac;13;0;13
76;Occitanie;09;3;04;290;Sentein;153;3;156
76;Occitanie;09;3;03;291;Sentenac-d'Oust;106;3;109
76;Occitanie;09;3;03;292;Sentenac-de-Sérou;54;0;54
76;Occitanie;09;1;13;293;Serres-sur-Arget;683;10;693
76;Occitanie;09;3;02;294;Sieuras;100;1;101
76;Occitanie;09;1;12;295;Siguer;96;0;96
76;Occitanie;09;3;04;297;Sor;28;0;28
76;Occitanie;09;1;01;298;Sorgeat;81;2;83
76;Occitanie;09;3;03;299;Soueix-Rogalle;422;7;429
76;Occitanie;09;1;09;300;Soula;176;7;183
76;Occitanie;09;3;03;301;Soulan;374;2;376
76;Occitanie;09;1;12;303;Surba;320;8;328
76;Occitanie;09;3;03;304;Suzan;15;1;16
76;Occitanie;09;2;06;305;Tabre;361;8;369
76;Occitanie;09;1;12;306;Tarascon-sur-Ariège;3028;32;3060
76;Occitanie;09;3;11;307;Taurignan-Castet;162;2;164
76;Occitanie;09;3;11;308;Taurignan-Vieux;207;8;215
76;Occitanie;09;2;06;309;Teilhet;153;2;155
76;Occitanie;09;3;02;310;Thouars-sur-Arize;49;2;51
76;Occitanie;09;1;01;311;Tignac;24;0;24
76;Occitanie;09;2;08;312;La Tour-du-Crieu;3193;69;3262
76;Occitanie;09;3;11;313;Tourtouse;150;7;157
76;Occitanie;09;2;06;314;Tourtrol;286;15;301
76;Occitanie;09;2;10;315;Trémoulet;129;0;129
76;Occitanie;09;2;06;316;Troye-d'Ariège;93;1;94
76;Occitanie;09;1;01;318;Unac;121;1;122
76;Occitanie;09;2;07;319;Unzent;117;4;121
76;Occitanie;09;1;01;320;Urs;31;1;32
76;Occitanie;09;1;01;321;Ussat;318;4;322
76;Occitanie;09;3;03;322;Ustou;286;10;296
76;Occitanie;09;1;12;334;Val-de-Sos ;594;63;657
76;Occitanie;09;2;06;323;Vals;95;1;96
76;Occitanie;09;1;13;324;Varilhes;3436;54;3490
76;Occitanie;09;1;01;325;Vaychis;26;0;26
76;Occitanie;09;1;01;326;Vèbre;125;1;126
76;Occitanie;09;1;13;327;Ventenac;236;2;238
76;Occitanie;09;1;01;328;Verdun;219;9;228
76;Occitanie;09;1;13;329;Vernajoul;664;21;685
76;Occitanie;09;1;01;330;Vernaux;28;0;28
76;Occitanie;09;2;10;331;Le Vernet;712;6;718
76;Occitanie;09;1;13;332;Verniolle;2274;67;2341
76;Occitanie;09;3;04;335;Villeneuve;38;0;38
76;Occitanie;09;2;09;336;Villeneuve-d'Olmes;972;19;991
76;Occitanie;09;3;02;338;Villeneuve-du-Latou;157;4;161
76;Occitanie;09;2;10;339;Villeneuve-du-Paréage;766;15;781
76;Occitanie;09;1;13;340;Vira;158;4;162
76;Occitanie;09;2;06;341;Viviès;135;0;135
44;Grand Est;10;1;03;002;Ailleville;244;5;249
44;Grand Est;10;3;01;003;Aix-Villemaur-Pâlis;3547;38;3585
44;Grand Est;10;3;02;004;Allibaudières;207;2;209
44;Grand Est;10;1;17;005;Amance;265;12;277
44;Grand Est;10;3;02;006;Arcis-sur-Aube;2839;84;2923
44;Grand Est;10;1;03;007;Arconville;105;2;107
44;Grand Est;10;1;17;008;Argançon;112;1;113
44;Grand Est;10;3;08;009;Arrelles;87;2;89
44;Grand Est;10;1;05;010;Arrembécourt;48;2;50
44;Grand Est;10;1;03;011;Arrentières;213;1;214
44;Grand Est;10;1;03;012;Arsonval;314;5;319
44;Grand Est;10;3;08;013;Assenay;148;2;150
44;Grand Est;10;3;05;014;Assencières;176;1;177
44;Grand Est;10;3;02;015;Aubeterre;370;6;376
44;Grand Est;10;1;05;017;Aulnay;129;3;132
44;Grand Est;10;3;01;018;Auxon;1012;10;1022
44;Grand Est;10;2;11;020;Avant-lès-Marcilly;506;10;516
44;Grand Est;10;3;02;021;Avant-lès-Ramerupt;158;4;162
44;Grand Est;10;3;08;022;Avirey-Lingey;201;12;213
44;Grand Est;10;2;11;023;Avon-la-Pèze;190;7;197
44;Grand Est;10;3;08;024;Avreuil;165;3;168
44;Grand Est;10;3;08;025;Bagneux-la-Fosse;170;4;174
44;Grand Est;10;1;05;026;Bailly-le-Franc;36;0;36
44;Grand Est;10;1;05;027;Balignicourt;60;5;65
44;Grand Est;10;3;08;028;Balnot-la-Grange;120;0;120
44;Grand Est;10;3;08;029;Balnot-sur-Laignes;155;2;157
44;Grand Est;10;1;03;033;Bar-sur-Aube;4844;183;5027
44;Grand Est;10;3;04;034;Bar-sur-Seine;2990;196;3186
44;Grand Est;10;3;11;030;Barberey-Saint-Sulpice;1491;31;1522
44;Grand Est;10;2;07;031;Barbuise;467;8;475
44;Grand Est;10;1;03;032;Baroville;305;9;314
44;Grand Est;10;1;03;035;Bayel;751;9;760
44;Grand Est;10;3;01;037;Bercenay-en-Othe;462;11;473
44;Grand Est;10;2;11;038;Bercenay-le-Hayer;194;2;196
44;Grand Est;10;1;03;039;Bergères;120;5;125
44;Grand Est;10;3;08;040;Bernon;164;8;172
44;Grand Est;10;3;04;041;Bertignolles;51;1;52
44;Grand Est;10;3;01;042;Bérulle;220;4;224
44;Grand Est;10;2;06;043;Bessy;134;3;137
44;Grand Est;10;1;05;044;Bétignicourt;33;0;33
44;Grand Est;10;1;17;045;Beurey;188;9;197
44;Grand Est;10;1;05;046;Blaincourt-sur-Aube;109;2;111
44;Grand Est;10;1;05;047;Blignicourt;40;1;41
44;Grand Est;10;1;03;048;Bligny;161;4;165
44;Grand Est;10;3;08;049;Les Bordes-Aumont;537;9;546
44;Grand Est;10;1;17;050;Bossancourt;202;3;205
44;Grand Est;10;3;08;051;Bouilly;1093;47;1140
44;Grand Est;10;2;06;052;Boulages;219;4;223
44;Grand Est;10;3;17;053;Bouranton;576;9;585
44;Grand Est;10;2;11;054;Bourdenay;115;1;116
44;Grand Est;10;3;04;055;Bourguignons;274;12;286
44;Grand Est;10;3;05;056;Bouy-Luxembourg;237;1;238
44;Grand Est;10;2;07;057;Bouy-sur-Orvin;55;1;56
44;Grand Est;10;3;08;058;Bragelogne-Beauvoir;242;9;251
44;Grand Est;10;1;05;059;Braux;112;5;117
44;Grand Est;10;3;17;060;Bréviandes;2838;55;2893
44;Grand Est;10;3;05;061;Brévonnes;677;12;689
44;Grand Est;10;3;04;062;Briel-sur-Barse;204;2;206
44;Grand Est;10;1;05;063;Brienne-la-Vieille;417;13;430
44;Grand Est;10;1;05;064;Brienne-le-Château;2784;26;2810
44;Grand Est;10;3;02;065;Brillecourt;86;1;87
44;Grand Est;10;3;01;066;Bucey-en-Othe;434;10;444
44;Grand Est;10;3;17;067;Buchères;1764;27;1791
44;Grand Est;10;3;04;068;Buxeuil;128;6;134
44;Grand Est;10;3;04;069;Buxières-sur-Arce;119;0;119
44;Grand Est;10;3;04;070;Celles-sur-Ource;497;19;516
44;Grand Est;10;3;04;071;Chacenay;50;2;52
44;Grand Est;10;1;03;072;La Chaise;35;0;35
44;Grand Est;10;1;05;073;Chalette-sur-Voire;129;2;131
44;Grand Est;10;3;01;074;Chamoy;509;8;517
44;Grand Est;10;1;17;078;Champ-sur-Barse;27;0;27
44;Grand Est;10;2;06;075;Champfleury;100;6;106
44;Grand Est;10;1;03;076;Champignol-lez-Mondeville;268;7;275
44;Grand Est;10;3;02;077;Champigny-sur-Aube;108;2;110
44;Grand Est;10;3;08;079;Channes;126;2;128
44;Grand Est;10;3;08;080;Chaource;1060;10;1070
44;Grand Est;10;3;14;081;La Chapelle-Saint-Luc;11913;93;12006
44;Grand Est;10;2;06;082;Chapelle-Vallon;244;4;248
44;Grand Est;10;3;04;083;Chappes;331;6;337
44;Grand Est;10;3;02;084;Charmont-sous-Barbuise;1007;27;1034
44;Grand Est;10;2;11;085;Charmoy;64;0;64
44;Grand Est;10;2;06;086;Charny-le-Bachot;261;8;269
44;Grand Est;10;3;08;087;Chaserey;53;1;54
44;Grand Est;10;2;06;089;Châtres;705;13;718
44;Grand Est;10;2;06;090;Chauchigny;237;2;239
44;Grand Est;10;3;02;091;Chaudrey;143;4;147
44;Grand Est;10;3;04;092;Chauffour-lès-Bailly;125;0;125
44;Grand Est;10;1;03;093;Chaumesnil;103;2;105
44;Grand Est;10;1;05;094;Chavanges;588;12;600
44;Grand Est;10;3;02;095;Le Chêne;290;5;295
44;Grand Est;10;3;01;096;Chennegy;435;8;443
44;Grand Est;10;3;04;097;Chervey;163;4;167
44;Grand Est;10;3;08;098;Chesley;323;9;332
44;Grand Est;10;3;01;099;Chessy-les-Prés;511;14;525
44;Grand Est;10;3;17;100;Clérey;1112;22;1134
44;Grand Est;10;3;02;101;Coclois;175;3;178
44;Grand Est;10;1;03;102;Colombé-la-Fosse;191;4;195
44;Grand Est;10;1;03;103;Colombé-le-Sec;151;1;152
44;Grand Est;10;3;08;104;Cormost;305;3;308
44;Grand Est;10;1;05;105;Courcelles-sur-Voire;25;1;26
44;Grand Est;10;2;07;106;Courceroy;131;5;136
44;Grand Est;10;3;01;107;Coursan-en-Othe;104;0;104
44;Grand Est;10;3;01;108;Courtaoult;82;0;82
44;Grand Est;10;3;04;109;Courtenot;231;8;239
44;Grand Est;10;3;17;110;Courteranges;561;11;572
44;Grand Est;10;3;04;111;Courteron;105;5;110
44;Grand Est;10;3;08;112;Coussegrey;184;2;186
44;Grand Est;10;1;03;113;Couvignon;201;6;207
44;Grand Est;10;2;09;114;Crancey;708;14;722
44;Grand Est;10;3;06;115;Creney-près-Troyes;1914;33;1947
44;Grand Est;10;3;08;116;Crésantignes;314;4;318
44;Grand Est;10;1;03;117;Crespy-le-Neuf;154;7;161
44;Grand Est;10;3;01;118;Les Croûtes;93;4;97
44;Grand Est;10;3;04;119;Cunfin;174;4;178
44;Grand Est;10;3;08;120;Cussangy;226;2;228
44;Grand Est;10;3;02;121;Dampierre;311;8;319
44;Grand Est;10;3;01;122;Davrey;227;4;231
44;Grand Est;10;1;05;123;Dienville;876;16;892
44;Grand Est;10;2;11;124;Dierrey-Saint-Julien;259;13;272
44;Grand Est;10;3;11;125;Dierrey-Saint-Pierre;303;5;308
44;Grand Est;10;1;17;126;Dolancourt;135;4;139
44;Grand Est;10;3;02;127;Dommartin-le-Coq;59;0;59
44;Grand Est;10;1;05;128;Donnement;75;1;76
44;Grand Est;10;3;05;129;Dosches;295;9;304
44;Grand Est;10;3;02;130;Dosnon;103;6;109
44;Grand Est;10;2;06;131;Droupt-Saint-Basle;357;4;361
44;Grand Est;10;2;06;132;Droupt-Sainte-Marie;235;5;240
44;Grand Est;10;3;01;133;Eaux-Puiseaux;255;11;266
44;Grand Est;10;2;11;134;Échemines;89;6;95
44;Grand Est;10;1;03;135;Éclance;101;3;104
44;Grand Est;10;3;04;136;Éguilly-sous-Bois;117;1;118
44;Grand Est;10;1;03;137;Engente;34;0;34
44;Grand Est;10;1;05;138;Épagne;140;2;142
44;Grand Est;10;1;03;139;Épothémont;173;4;177
44;Grand Est;10;3;01;140;Ervy-le-Châtel;1167;9;1176
44;Grand Est;10;3;04;141;Essoyes;715;12;727
44;Grand Est;10;3;01;142;Estissac;1840;19;1859
44;Grand Est;10;3;08;143;Étourvy;170;5;175
44;Grand Est;10;2;06;144;Étrelles-sur-Aube;155;3;158
44;Grand Est;10;2;11;145;Faux-Villecerf;216;7;223
44;Grand Est;10;2;11;146;Fay-lès-Marcilly;88;3;91
44;Grand Est;10;3;08;147;Fays-la-Chapelle;126;4;130
44;Grand Est;10;2;07;148;Ferreux-Quincey;405;10;415
44;Grand Est;10;3;02;149;Feuges;332;4;336
44;Grand Est;10;1;03;150;Fontaine;255;5;260
44;Grand Est;10;2;06;151;Fontaine-les-Grès;883;9;892
44;Grand Est;10;2;07;153;Fontaine-Mâcon;636;14;650
44;Grand Est;10;2;07;154;Fontenay-de-Bossery;71;1;72
44;Grand Est;10;3;04;155;Fontette;198;7;205
44;Grand Est;10;3;01;156;Fontvannes;711;8;719
44;Grand Est;10;2;11;157;La Fosse-Corduan;219;6;225
44;Grand Est;10;3;04;158;Fouchères;534;16;550
44;Grand Est;10;3;04;159;Fralignes;87;1;88
44;Grand Est;10;1;03;160;Fravaux;40;1;41
44;Grand Est;10;1;03;161;Fresnay;48;3;51
44;Grand Est;10;3;17;162;Fresnoy-le-Château;284;6;290
44;Grand Est;10;1;03;163;Fuligny;44;2;46
44;Grand Est;10;2;09;164;Gélannes;733;10;743
44;Grand Est;10;3;05;165;Géraudot;337;6;343
44;Grand Est;10;2;06;166;Les Grandes-Chapelles;396;6;402
44;Grand Est;10;3;02;167;Grandville;93;0;93
44;Grand Est;10;3;08;168;Les Granges;77;1;78
44;Grand Est;10;2;07;169;Gumery;222;8;230
44;Grand Est;10;3;04;170;Gyé-sur-Seine;493;9;502
44;Grand Est;10;1;05;171;Hampigny;234;9;243
44;Grand Est;10;3;02;172;Herbisse;160;1;161
44;Grand Est;10;3;02;174;Isle-Aubigny;174;3;177
44;Grand Est;10;3;17;173;Isle-Aumont;466;8;474
44;Grand Est;10;1;05;175;Jasseines;176;3;179
44;Grand Est;10;1;03;176;Jaucourt;165;7;172
44;Grand Est;10;3;08;177;Javernant;149;7;156
44;Grand Est;10;1;17;178;Jessains;269;6;275
44;Grand Est;10;3;08;179;Jeugny;481;10;491
44;Grand Est;10;1;05;180;Joncreuil;94;4;98
44;Grand Est;10;3;04;181;Jully-sur-Sarce;228;12;240
44;Grand Est;10;1;03;182;Juvancourt;118;1;119
44;Grand Est;10;1;05;183;Juvanzé;34;1;35
44;Grand Est;10;1;03;184;Juzanvigny;128;1;129
44;Grand Est;10;3;08;185;Lagesse;207;4;211
44;Grand Est;10;3;08;186;Laines-aux-Bois;524;16;540
44;Grand Est;10;3;04;187;Landreville;420;11;431
44;Grand Est;10;3;08;188;Lantages;219;7;226
44;Grand Est;10;1;05;189;Lassicourt;61;0;61
44;Grand Est;10;3;17;190;Laubressel;553;6;559
44;Grand Est;10;3;06;191;Lavau;930;10;940
44;Grand Est;10;1;05;192;Lentilles;125;1;126
44;Grand Est;10;1;05;193;Lesmont;306;7;313
44;Grand Est;10;1;03;194;Lévigny;96;2;98
44;Grand Est;10;3;02;195;Lhuître;297;4;301
44;Grand Est;10;3;08;196;Lignières;210;1;211
44;Grand Est;10;1;03;197;Lignol-le-Château;189;11;200
44;Grand Est;10;3;08;198;Lirey;103;3;106
44;Grand Est;10;3;04;199;Loches-sur-Ource;351;6;357
44;Grand Est;10;1;17;200;La Loge-aux-Chèvres;88;3;91
44;Grand Est;10;3;08;201;La Loge-Pomblin;68;0;68
44;Grand Est;10;3;08;202;Les Loges-Margueron;209;73;282
44;Grand Est;10;1;03;203;Longchamp-sur-Aujon;405;14;419
44;Grand Est;10;3;08;204;Longeville-sur-Mogne;152;3;155
44;Grand Est;10;1;17;205;Longpré-le-Sec;89;2;91
44;Grand Est;10;3;02;206;Longsols;125;1;126
44;Grand Est;10;2;06;207;Longueville-sur-Aube;125;1;126
44;Grand Est;10;2;07;208;La Louptière-Thénard;289;12;301
44;Grand Est;10;3;17;209;Lusigny-sur-Barse;2190;54;2244
44;Grand Est;10;3;02;210;Luyères;454;13;467
44;Grand Est;10;3;11;211;Macey;965;15;980
44;Grand Est;10;3;08;212;Machy;114;4;118
44;Grand Est;10;3;04;213;Magnant;161;3;164
44;Grand Est;10;1;05;214;Magnicourt;84;1;85
44;Grand Est;10;1;17;215;Magny-Fouchard;264;4;268
44;Grand Est;10;3;02;216;Mailly-le-Camp;1829;25;1854
44;Grand Est;10;1;17;217;Maison-des-Champs;32;0;32
44;Grand Est;10;3;08;218;Maisons-lès-Chaource;160;1;161
44;Grand Est;10;1;03;219;Maisons-lès-Soulaines;66;3;69
44;Grand Est;10;2;09;220;Maizières-la-Grande-Paroisse;1492;43;1535
44;Grand Est;10;1;05;221;Maizières-lès-Brienne;163;0;163
44;Grand Est;10;3;01;222;Maraye-en-Othe;442;7;449
44;Grand Est;10;2;11;223;Marcilly-le-Hayer;729;9;738
44;Grand Est;10;2;11;224;Marigny-le-Châtel;1766;33;1799
44;Grand Est;10;2;07;225;Marnay-sur-Seine;235;7;242
44;Grand Est;10;3;04;226;Marolles-lès-Bailly;109;2;111
44;Grand Est;10;3;01;227;Marolles-sous-Lignières;331;5;336
44;Grand Est;10;1;05;228;Mathaux;199;2;201
44;Grand Est;10;3;08;229;Maupas;105;2;107
44;Grand Est;10;3;06;230;Mergey;684;10;694
44;Grand Est;10;2;07;231;Le Mériot;620;10;630
44;Grand Est;10;3;04;232;Merrey-sur-Arce;324;5;329
44;Grand Est;10;2;06;233;Méry-sur-Seine;1522;49;1571
44;Grand Est;10;2;06;234;Mesgrigny;283;1;284
44;Grand Est;10;3;02;235;Mesnil-la-Comtesse;45;0;45
44;Grand Est;10;3;02;236;Mesnil-Lettre;57;1;58
44;Grand Est;10;2;11;237;Mesnil-Saint-Loup;595;29;624
44;Grand Est;10;3;17;238;Mesnil-Saint-Père;477;10;487
44;Grand Est;10;3;05;239;Mesnil-Sellières;586;23;609
44;Grand Est;10;3;01;240;Messon;466;11;477
44;Grand Est;10;3;08;241;Metz-Robert;64;0;64
44;Grand Est;10;1;03;242;Meurville;167;3;170
44;Grand Est;10;1;05;243;Molins-sur-Aube;106;5;111
44;Grand Est;10;3;17;245;Montaulin;806;28;834
44;Grand Est;10;3;08;246;Montceaux-lès-Vaudes;262;16;278
44;Grand Est;10;3;01;247;Montfey;129;4;133
44;Grand Est;10;3;11;248;Montgueux;393;11;404
44;Grand Est;10;1;03;250;Montier-en-l'Isle;229;6;235
44;Grand Est;10;3;17;249;Montiéramey;402;7;409
44;Grand Est;10;3;01;251;Montigny-les-Monts;251;9;260
44;Grand Est;10;1;17;252;Montmartin-le-Haut;56;2;58
44;Grand Est;10;1;05;253;Montmorency-Beaufort;139;1;140
44;Grand Est;10;2;07;254;Montpothier;327;9;336
44;Grand Est;10;3;17;255;Montreuil-sur-Barse;294;5;299
44;Grand Est;10;3;02;256;Montsuzain;409;4;413
44;Grand Est;10;3;02;257;Morembert;30;0;30
44;Grand Est;10;1;03;258;Morvilliers;292;7;299
44;Grand Est;10;2;07;259;La Motte-Tilly;368;3;371
44;Grand Est;10;3;17;260;Moussey;641;16;657
44;Grand Est;10;3;04;261;Mussy-sur-Seine;1019;15;1034
44;Grand Est;10;3;04;262;Neuville-sur-Seine;434;8;442
44;Grand Est;10;3;01;263;Neuville-sur-Vanne;431;5;436
44;Grand Est;10;3;04;264;Noé-les-Mallets;118;2;120
44;Grand Est;10;3;13;265;Les Noës-près-Troyes;3281;35;3316
44;Grand Est;10;3;01;266;Nogent-en-Othe;47;3;50
44;Grand Est;10;3;02;267;Nogent-sur-Aube;319;4;323
44;Grand Est;10;2;07;268;Nogent-sur-Seine;5987;118;6105
44;Grand Est;10;3;02;269;Nozay;149;4;153
44;Grand Est;10;3;05;270;Onjon;254;6;260
44;Grand Est;10;2;11;271;Origny-le-Sec;599;11;610
44;Grand Est;10;3;02;272;Ormes;180;3;183
44;Grand Est;10;3;02;273;Ortillon;24;0;24
44;Grand Est;10;2;11;274;Orvilliers-Saint-Julien;307;4;311
44;Grand Est;10;2;11;275;Ossey-les-Trois-Maisons;595;7;602
44;Grand Est;10;3;01;276;Paisy-Cosdon;336;6;342
44;Grand Est;10;3;08;278;Pargues;138;4;142
44;Grand Est;10;1;05;279;Pars-lès-Chavanges;60;1;61
44;Grand Est;10;2;09;280;Pars-lès-Romilly;814;9;823
44;Grand Est;10;3;11;281;Le Pavillon-Sainte-Julie;293;8;301
44;Grand Est;10;3;11;282;Payns;1369;19;1388
44;Grand Est;10;1;05;283;Pel-et-Der;132;2;134
44;Grand Est;10;2;07;284;Périgny-la-Rose;144;3;147
44;Grand Est;10;1;05;285;Perthes-lès-Brienne;77;0;77
44;Grand Est;10;1;03;286;Petit-Mesnil;210;7;217
44;Grand Est;10;3;05;287;Piney;1478;16;1494
44;Grand Est;10;3;04;288;Plaines-Saint-Lange;262;4;266
44;Grand Est;10;2;06;289;Plancy-l'Abbaye;968;17;985
44;Grand Est;10;3;01;290;Planty;239;3;242
44;Grand Est;10;2;07;291;Plessis-Barbuise;194;7;201
44;Grand Est;10;3;02;293;Poivres;159;2;161
44;Grand Est;10;3;04;294;Poligny;64;2;66
44;Grand Est;10;3;04;295;Polisot;326;6;332
44;Grand Est;10;3;04;296;Polisy;191;9;200
44;Grand Est;10;3;15;297;Pont-Sainte-Marie;5161;92;5253
44;Grand Est;10;2;07;298;Pont-sur-Seine;1161;20;1181
44;Grand Est;10;3;02;299;Pouan-les-Vallées;528;17;545
44;Grand Est;10;3;02;300;Pougy;291;2;293
44;Grand Est;10;2;11;301;Pouy-sur-Vannes;165;4;169
44;Grand Est;10;3;08;302;Praslin;88;2;90
44;Grand Est;10;1;05;303;Précy-Notre-Dame;82;2;84
44;Grand Est;10;1;05;304;Précy-Saint-Martin;186;2;188
44;Grand Est;10;2;06;305;Prémierfait;87;3;90
44;Grand Est;10;1;03;306;Proverville;240;6;246
44;Grand Est;10;3;01;307;Prugny;371;10;381
44;Grand Est;10;2;11;308;Prunay-Belleville;214;8;222
44;Grand Est;10;3;08;309;Prusy;95;2;97
44;Grand Est;10;1;17;310;Puits-et-Nuisement;215;5;220
44;Grand Est;10;3;01;312;Racines;167;5;172
44;Grand Est;10;1;05;313;Radonvilliers;373;2;375
44;Grand Est;10;3;02;314;Ramerupt;409;4;413
44;Grand Est;10;1;05;315;Rances;45;2;47
44;Grand Est;10;2;06;316;Rhèges;225;4;229
44;Grand Est;10;3;08;317;Les Riceys;1228;23;1251
44;Grand Est;10;2;11;318;Rigny-la-Nonneuse;166;2;168
44;Grand Est;10;3;01;319;Rigny-le-Ferron;339;7;346
44;Grand Est;10;2;06;320;Rilly-Sainte-Syre;235;5;240
44;Grand Est;10;3;10;321;La Rivière-de-Corps;3457;108;3565
44;Grand Est;10;2;09;323;Romilly-sur-Seine;14328;315;14643
44;Grand Est;10;3;08;324;Roncenay;159;2;161
44;Grand Est;10;3;10;325;Rosières-près-Troyes;4414;346;4760
44;Grand Est;10;1;05;326;Rosnay-l'Hôpital;176;9;185
44;Grand Est;10;1;03;327;La Rothière;111;1;112
44;Grand Est;10;3;05;328;Rouilly-Sacey;385;4;389
44;Grand Est;10;3;17;329;Rouilly-Saint-Loup;513;45;558
44;Grand Est;10;1;03;330;Rouvres-les-Vignes;108;1;109
44;Grand Est;10;3;04;331;Rumilly-lès-Vaudes;550;10;560
44;Grand Est;10;3;17;332;Ruvigny;496;11;507
44;Grand Est;10;3;10;333;Saint-André-les-Vergers;12581;187;12768
44;Grand Est;10;2;07;334;Saint-Aubin;588;8;596
44;Grand Est;10;3;01;335;Saint-Benoist-sur-Vanne;239;6;245
44;Grand Est;10;3;06;336;Saint-Benoît-sur-Seine;394;5;399
44;Grand Est;10;1;05;337;Saint-Christophe-Dodinicourt;34;1;35
44;Grand Est;10;3;02;338;Saint-Étienne-sous-Barbuise;173;3;176
44;Grand Est;10;2;11;339;Saint-Flavy;286;6;292
44;Grand Est;10;3;10;340;Saint-Germain;2289;49;2338
44;Grand Est;10;2;09;341;Saint-Hilaire-sous-Romilly;357;9;366
44;Grand Est;10;3;08;342;Saint-Jean-de-Bonneval;397;8;405
44;Grand Est;10;3;15;343;Saint-Julien-les-Villas;6801;145;6946
44;Grand Est;10;3;17;344;Saint-Léger-près-Troyes;891;15;906
44;Grand Est;10;1;05;345;Saint-Léger-sous-Brienne;384;11;395
44;Grand Est;10;1;05;346;Saint-Léger-sous-Margerie;56;1;57
44;Grand Est;10;2;11;347;Saint-Loup-de-Buffigny;210;6;216
44;Grand Est;10;2;11;348;Saint-Lupien;233;4;237
44;Grand Est;10;3;11;349;Saint-Lyé;2900;62;2962
44;Grand Est;10;3;01;350;Saint-Mards-en-Othe;639;11;650
44;Grand Est;10;2;11;351;Saint-Martin-de-Bossenay;368;5;373
44;Grand Est;10;2;06;353;Saint-Mesmin;865;10;875
44;Grand Est;10;3;02;354;Saint-Nabord-sur-Aube;138;4;142
44;Grand Est;10;2;07;355;Saint-Nicolas-la-Chapelle;68;0;68
44;Grand Est;10;2;06;356;Saint-Oulph;293;8;301
44;Grand Est;10;3;15;357;Saint-Parres-aux-Tertres;3136;48;3184
44;Grand Est;10;3;04;358;Saint-Parres-lès-Vaudes;1023;17;1040
44;Grand Est;10;3;01;359;Saint-Phal;521;11;532
44;Grand Est;10;3;08;360;Saint-Pouange;935;229;1164
44;Grand Est;10;3;02;361;Saint-Remy-sous-Barbuise;236;4;240
44;Grand Est;10;3;17;363;Saint-Thibault;552;3;555
44;Grand Est;10;3;04;364;Saint-Usage;74;2;76
44;Grand Est;10;3;06;352;Sainte-Maure;1679;294;1973
44;Grand Est;10;3;13;362;Sainte-Savine;10409;409;10818
44;Grand Est;10;2;06;365;Salon;122;0;122
44;Grand Est;10;1;03;366;Saulcy;66;2;68
44;Grand Est;10;2;07;367;La Saulsotte;696;9;705
44;Grand Est;10;2;06;368;Savières;1004;11;1015
44;Grand Est;10;3;02;369;Semoine;195;6;201
44;Grand Est;10;2;07;370;Soligny-les-Étangs;242;6;248
44;Grand Est;10;3;08;371;Sommeval;311;5;316
44;Grand Est;10;1;03;372;Soulaines-Dhuys;417;6;423
44;Grand Est;10;3;08;373;Souligny;387;20;407
44;Grand Est;10;1;03;374;Spoy;169;1;170
44;Grand Est;10;3;17;375;Thennelières;334;10;344
44;Grand Est;10;3;04;376;Thieffrain;154;3;157
44;Grand Est;10;1;03;377;Thil;113;9;122
44;Grand Est;10;1;03;378;Thors;70;3;73
44;Grand Est;10;3;02;379;Torcy-le-Grand;453;9;462
44;Grand Est;10;3;02;380;Torcy-le-Petit;81;5;86
44;Grand Est;10;3;10;381;Torvilliers;976;17;993
44;Grand Est;10;2;07;382;Traînel;1050;13;1063
44;Grand Est;10;2;11;383;Trancault;185;3;188
44;Grand Est;10;1;17;384;Trannes;230;8;238
44;Grand Est;10;3;02;386;Trouans;227;7;234
44;Grand Est;10;3;99;387;Troyes;61996;1128;63124
44;Grand Est;10;3;08;388;Turgy;45;1;46
44;Grand Est;10;1;05;389;Unienville;120;4;124
44;Grand Est;10;1;03;390;Urville;124;2;126
44;Grand Est;10;3;06;391;Vailly;291;1;292
44;Grand Est;10;3;05;019;Val-d'Auzon;380;5;385
44;Grand Est;10;2;06;392;Vallant-Saint-Georges;392;9;401
44;Grand Est;10;1;05;393;Vallentigny;179;3;182
44;Grand Est;10;3;08;394;Vallières;157;1;158
44;Grand Est;10;3;08;395;Vanlay;298;4;302
44;Grand Est;10;3;01;396;Vauchassis;501;5;506
44;Grand Est;10;1;17;397;Vauchonvilliers;163;2;165
44;Grand Est;10;3;02;398;Vaucogne;74;4;78
44;Grand Est;10;3;04;399;Vaudes;713;8;721
44;Grand Est;10;3;02;400;Vaupoisson;119;5;124
44;Grand Est;10;1;17;401;Vendeuvre-sur-Barse;2315;39;2354
44;Grand Est;10;3;08;402;La Vendue-Mignot;248;5;253
44;Grand Est;10;1;03;403;Vernonvilliers;56;1;57
44;Grand Est;10;3;04;404;Verpillières-sur-Ource;109;2;111
44;Grand Est;10;3;02;405;Verricourt;55;0;55
44;Grand Est;10;3;17;406;Verrières;1860;37;1897
44;Grand Est;10;2;06;408;Viâpres-le-Petit;130;5;135
44;Grand Est;10;3;06;409;Villacerf;598;4;602
44;Grand Est;10;2;11;410;Villadin;110;4;114
44;Grand Est;10;1;03;411;La Ville-aux-Bois;27;0;27
44;Grand Est;10;1;03;426;Ville-sous-la-Ferté;1013;13;1026
44;Grand Est;10;3;04;427;Ville-sur-Arce;208;7;215
44;Grand Est;10;1;03;428;Ville-sur-Terre;102;5;107
44;Grand Est;10;3;06;412;Villechétif;934;20;954
44;Grand Est;10;3;11;414;Villeloup;122;5;127
44;Grand Est;10;3;08;416;Villemereuil;246;9;255
44;Grand Est;10;3;01;417;Villemoiron-en-Othe;201;6;207
44;Grand Est;10;3;04;418;Villemorien;204;9;213
44;Grand Est;10;3;04;419;Villemoyenne;767;13;780
44;Grand Est;10;2;07;420;Villenauxe-la-Grande;2727;30;2757
44;Grand Est;10;2;07;421;La Villeneuve-au-Châtelot;147;4;151
44;Grand Est;10;3;01;422;Villeneuve-au-Chemin;185;2;187
44;Grand Est;10;1;17;423;La Villeneuve-au-Chêne;421;15;436
44;Grand Est;10;1;05;424;Villeret;63;2;65
44;Grand Est;10;3;08;425;Villery;273;3;276
44;Grand Est;10;3;02;429;Villette-sur-Aube;259;3;262
44;Grand Est;10;3;02;430;Villiers-Herbisse;86;2;88
44;Grand Est;10;3;08;431;Villiers-le-Bois;98;1;99
44;Grand Est;10;3;08;432;Villiers-sous-Praslin;70;1;71
44;Grand Est;10;3;04;433;Villy-en-Trodes;248;8;256
44;Grand Est;10;3;08;434;Villy-le-Bois;55;1;56
44;Grand Est;10;3;08;435;Villy-le-Maréchal;187;4;191
44;Grand Est;10;3;02;436;Vinets;171;7;178
44;Grand Est;10;3;04;437;Virey-sous-Bar;613;10;623
44;Grand Est;10;3;04;438;Vitry-le-Croisé;227;5;232
44;Grand Est;10;3;04;439;Viviers-sur-Artaut;126;3;129
44;Grand Est;10;1;03;440;Voigny;152;6;158
44;Grand Est;10;3;01;441;Vosnon;232;2;234
44;Grand Est;10;3;02;442;Voué;688;9;697
44;Grand Est;10;3;08;443;Vougrey;47;1;48
44;Grand Est;10;3;01;444;Vulaines;226;3;229
44;Grand Est;10;1;05;445;Yèvres-le-Petit;55;9;64
76;Occitanie;11;1;15;001;Aigues-Vives;575;12;587
76;Occitanie;11;1;05;002;Airoux;165;2;167
76;Occitanie;11;2;09;003;Ajac;191;3;194
76;Occitanie;11;2;01;004;Alaigne;329;5;334
76;Occitanie;11;1;04;005;Alairac;1320;33;1353
76;Occitanie;11;3;07;006;Albas;78;2;80
76;Occitanie;11;3;07;007;Albières;119;4;123
76;Occitanie;11;2;09;008;Alet-les-Bains;390;3;393
76;Occitanie;11;1;10;009;Alzonne;1529;21;1550
76;Occitanie;11;2;14;010;Antugnac;263;7;270
76;Occitanie;11;1;19;011;Aragon;446;13;459
76;Occitanie;11;3;16;012;Argeliers;2165;32;2197
76;Occitanie;11;3;08;013;Argens-Minervois;348;6;354
76;Occitanie;11;3;06;014;Armissan;1516;30;1546
76;Occitanie;11;2;14;015;Arques;261;3;264
76;Occitanie;11;1;18;016;Arquettes-en-Val;80;3;83
76;Occitanie;11;2;14;017;Artigues;74;1;75
76;Occitanie;11;1;10;018;Arzens;1229;33;1262
76;Occitanie;11;2;14;019;Aunat;65;0;65
76;Occitanie;11;3;07;020;Auriac;40;0;40
76;Occitanie;11;2;14;021;Axat;541;11;552
76;Occitanie;11;1;15;022;Azille;1129;23;1152
76;Occitanie;11;1;18;023;Badens;773;14;787
76;Occitanie;11;3;12;024;Bages;771;15;786
76;Occitanie;11;1;15;025;Bagnoles;307;3;310
76;Occitanie;11;1;01;026;Baraigne;176;3;179
76;Occitanie;11;1;18;027;Barbaira;763;20;783
76;Occitanie;11;2;14;028;Belcaire;388;7;395
76;Occitanie;11;2;09;029;Belcastel-et-Buc;59;3;62
76;Occitanie;11;1;01;030;Belflou;119;6;125
76;Occitanie;11;2;14;031;Belfort-sur-Rebenty;24;2;26
76;Occitanie;11;2;01;032;Bellegarde-du-Razès;242;2;244
76;Occitanie;11;1;01;033;Belpech;1295;27;1322
76;Occitanie;11;2;01;034;Belvèze-du-Razès;862;7;869
76;Occitanie;11;2;14;035;Belvianes-et-Cavirac;248;6;254
76;Occitanie;11;2;14;036;Belvis;163;2;165
76;Occitanie;11;1;18;037;Berriac;993;10;1003
76;Occitanie;11;2;14;038;Bessède-de-Sault;46;0;46
76;Occitanie;11;2;09;039;La Bezole;47;1;48
76;Occitanie;11;3;11;040;Bizanet;1731;28;1759
76;Occitanie;11;3;16;041;Bize-Minervois;1205;15;1220
76;Occitanie;11;1;18;042;Blomac;226;6;232
76;Occitanie;11;1;18;043;Bouilhonnac;222;6;228
76;Occitanie;11;3;07;044;Bouisse;105;0;105
76;Occitanie;11;2;09;045;Bouriège;134;1;135
76;Occitanie;11;2;09;046;Bourigeole;53;0;53
76;Occitanie;11;2;14;047;Le Bousquet;45;1;46
76;Occitanie;11;3;07;048;Boutenac;724;16;740
76;Occitanie;11;1;01;049;Bram;3204;81;3285
76;Occitanie;11;1;01;051;Brézilhac;177;4;181
76;Occitanie;11;1;10;052;Brousses-et-Villaret;344;5;349
76;Occitanie;11;2;01;053;Brugairolles;279;5;284
76;Occitanie;11;1;10;054;Les Brunels;272;11;283
76;Occitanie;11;2;14;055;Bugarach;234;4;238
76;Occitanie;11;1;15;056;Cabrespine;173;4;177
76;Occitanie;11;1;01;057;Cahuzac;30;0;30
76;Occitanie;11;2;01;058;Cailhau;261;8;269
76;Occitanie;11;2;01;059;Cailhavel;135;1;136
76;Occitanie;11;2;14;060;Cailla;48;1;49
76;Occitanie;11;2;01;061;Cambieure;303;4;307
76;Occitanie;11;2;14;062;Campagna-de-Sault;19;0;19
76;Occitanie;11;2;14;063;Campagne-sur-Aude;592;5;597
76;Occitanie;11;3;07;064;Camplong-d'Aude;369;4;373
76;Occitanie;11;2;14;065;Camps-sur-l'Agly;54;1;55
76;Occitanie;11;2;14;066;Camurac;100;0;100
76;Occitanie;11;3;16;067;Canet;1812;18;1830
76;Occitanie;11;1;18;068;Capendu;1473;41;1514
76;Occitanie;11;1;98;069;Carcassonne;46513;1282;47795
76;Occitanie;11;1;10;070;Carlipa;339;5;344
76;Occitanie;11;3;07;071;Cascastel-des-Corbières;222;7;229
76;Occitanie;11;1;01;072;La Cassaigne;168;8;176
76;Occitanie;11;2;14;073;Cassaignes;60;0;60
76;Occitanie;11;1;05;074;Les Cassés;298;2;300
76;Occitanie;11;1;15;075;Castans;133;2;135
76;Occitanie;11;3;08;077;Castelnau-d'Aude;497;9;506
76;Occitanie;11;1;05;076;Castelnaudary;11951;516;12467
76;Occitanie;11;2;09;078;Castelreng;208;7;215
76;Occitanie;11;1;19;079;Caudebronde;197;3;200
76;Occitanie;11;1;15;081;Caunes-Minervois;1641;30;1671
76;Occitanie;11;2;09;082;Caunette-sur-Lauquet;6;0;6
76;Occitanie;11;1;18;083;Caunettes-en-Val;48;0;48
76;Occitanie;11;1;10;084;Caux-et-Sauzens;999;23;1022
76;Occitanie;11;1;03;085;Cavanac;939;39;978
76;Occitanie;11;3;17;086;Caves;886;13;899
76;Occitanie;11;1;01;087;Cazalrenoux;91;1;92
76;Occitanie;11;1;03;088;Cazilhac;1650;50;1700
76;Occitanie;11;1;10;089;Cenne-Monestiés;406;7;413
76;Occitanie;11;2;09;090;Cépie;631;17;648
76;Occitanie;11;2;14;091;Chalabre;1121;12;1133
76;Occitanie;11;1;15;092;Citou;88;1;89
76;Occitanie;11;2;14;093;Le Clat;30;2;32
76;Occitanie;11;2;09;094;Clermont-sur-Lauquet;26;0;26
76;Occitanie;11;1;18;095;Comigne;307;8;315
76;Occitanie;11;2;14;096;Comus;40;2;42
76;Occitanie;11;3;08;098;Conilhac-Corbières;910;19;929
76;Occitanie;11;1;19;099;Conques-sur-Orbiel;2545;55;2600
76;Occitanie;11;2;14;100;Corbières;27;1;28
76;Occitanie;11;2;14;101;Coudons;52;1;53
76;Occitanie;11;1;03;102;Couffoulens;605;8;613
76;Occitanie;11;2;14;103;Couiza;1115;21;1136
76;Occitanie;11;2;14;104;Counozouls;49;0;49
76;Occitanie;11;2;09;105;Cournanel;722;10;732
76;Occitanie;11;3;06;106;Coursan;5864;96;5960
76;Occitanie;11;2;14;107;Courtauly;76;1;77
76;Occitanie;11;2;01;108;La Courtète;46;1;47
76;Occitanie;11;2;14;109;Coustaussa;53;1;54
76;Occitanie;11;3;07;110;Coustouge;119;0;119
76;Occitanie;11;3;08;111;Cruscades;944;9;953
76;Occitanie;11;2;14;112;Cubières-sur-Cinoble;90;1;91
76;Occitanie;11;3;07;113;Cucugnan;119;5;124
76;Occitanie;11;1;01;114;Cumiès;37;0;37
76;Occitanie;11;1;10;115;Cuxac-Cabardès;906;24;930
76;Occitanie;11;3;06;116;Cuxac-d'Aude;4026;71;4097
76;Occitanie;11;3;07;117;Davejean;118;2;120
76;Occitanie;11;3;07;118;Dernacueillette;43;1;44
76;Occitanie;11;2;09;119;La Digne-d'Amont;291;7;298
76;Occitanie;11;2;09;120;La Digne-d'Aval;533;13;546
76;Occitanie;11;2;01;121;Donazac;110;1;111
76;Occitanie;11;1;18;122;Douzens;741;12;753
76;Occitanie;11;3;07;123;Duilhac-sous-Peyrepertuse;145;3;148
76;Occitanie;11;3;07;124;Durban-Corbières;651;11;662
76;Occitanie;11;3;07;125;Embres-et-Castelmaure;151;0;151
76;Occitanie;11;3;08;126;Escales;473;4;477
76;Occitanie;11;2;14;127;Escouloubre;72;3;75
76;Occitanie;11;2;01;128;Escueillens-et-Saint-Just-de-Bélengard;150;2;152
76;Occitanie;11;2;14;129;Espéraza;1800;33;1833
76;Occitanie;11;2;14;130;Espezel;217;5;222
76;Occitanie;11;3;07;132;Fabrezan;1273;16;1289
76;Occitanie;11;1;18;133;Fajac-en-Val;39;0;39
76;Occitanie;11;1;01;134;Fajac-la-Relenque;50;4;54
76;Occitanie;11;2;14;135;La Fajolle;12;1;13
76;Occitanie;11;1;01;136;Fanjeaux;835;88;923
76;Occitanie;11;3;07;137;Félines-Termenès;122;4;126
76;Occitanie;11;1;05;138;Fendeille;531;16;547
76;Occitanie;11;1;01;139;Fenouillet-du-Razès;81;0;81
76;Occitanie;11;3;07;140;Ferrals-les-Corbières;1213;20;1233
76;Occitanie;11;1;01;141;Ferran;115;1;116
76;Occitanie;11;2;09;142;Festes-et-Saint-André;202;5;207
76;Occitanie;11;3;17;143;Feuilla;106;0;106
76;Occitanie;11;3;17;144;Fitou;1060;12;1072
76;Occitanie;11;3;06;145;Fleury;3801;63;3864
76;Occitanie;11;1;18;146;Floure;407;8;415
76;Occitanie;11;2;14;147;Fontanès-de-Sault;5;0;5
76;Occitanie;11;3;07;148;Fontcouverte;550;10;560
76;Occitanie;11;1;01;149;Fonters-du-Razès;79;1;80
76;Occitanie;11;1;10;150;Fontiers-Cabardès;452;50;502
76;Occitanie;11;1;18;151;Fontiès-d'Aude;498;11;509
76;Occitanie;11;3;07;152;Fontjoncouse;130;4;134
76;Occitanie;11;1;01;153;La Force;232;6;238
76;Occitanie;11;1;19;154;Fournes-Cabardès;50;0;50
76;Occitanie;11;2;14;155;Fourtou;76;1;77
76;Occitanie;11;1;10;156;Fraisse-Cabardès;104;2;106
76;Occitanie;11;3;07;157;Fraissé-des-Corbières;213;5;218
76;Occitanie;11;2;09;158;Gaja-et-Villedieu;289;11;300
76;Occitanie;11;1;01;159;Gaja-la-Selve;140;2;142
76;Occitanie;11;2;14;160;Galinagues;37;0;37
76;Occitanie;11;2;09;161;Gardie;124;3;127
76;Occitanie;11;1;01;162;Generville;59;1;60
76;Occitanie;11;2;14;163;Gincla;47;0;47
76;Occitanie;11;3;16;164;Ginestas;1473;20;1493
76;Occitanie;11;2;14;165;Ginoles;303;9;312
76;Occitanie;11;1;01;166;Gourvieille;78;0;78
76;Occitanie;11;2;01;167;Gramazie;123;2;125
76;Occitanie;11;2;14;168;Granès;96;0;96
76;Occitanie;11;2;09;169;Greffeil;82;5;87
76;Occitanie;11;3;12;170;Gruissan;5044;79;5123
76;Occitanie;11;3;08;172;Homps;596;11;607
76;Occitanie;11;1;01;173;Hounoux;133;3;136
76;Occitanie;11;1;19;174;Les Ilhes;54;0;54
76;Occitanie;11;1;05;175;Issel;482;9;491
76;Occitanie;11;3;07;176;Jonquières;59;2;61
76;Occitanie;11;2;14;177;Joucou;34;0;34
76;Occitanie;11;1;05;178;Labastide-d'Anjou;1307;15;1322
76;Occitanie;11;1;18;179;Labastide-en-Val;91;2;93
76;Occitanie;11;1;19;180;Labastide-Esparbairenque;67;0;67
76;Occitanie;11;1;10;181;Labécède-Lauragais;404;9;413
76;Occitanie;11;1;10;182;Lacombe;175;3;178
76;Occitanie;11;2;09;183;Ladern-sur-Lauquet;268;9;277
76;Occitanie;11;1;01;184;Lafage;90;3;93
76;Occitanie;11;3;07;185;Lagrasse;544;9;553
76;Occitanie;11;3;07;186;Lairière;53;2;55
76;Occitanie;11;3;07;187;Lanet;53;1;54
76;Occitanie;11;1;10;189;Laprade;104;1;105
76;Occitanie;11;3;07;191;Laroque-de-Fa;151;7;158
76;Occitanie;11;1;05;192;Lasbordes;787;30;817
76;Occitanie;11;1;01;193;Lasserre-de-Prouille;271;3;274
76;Occitanie;11;1;19;194;Lastours;157;3;160
76;Occitanie;11;1;01;195;Laurabuc;415;9;424
76;Occitanie;11;1;01;196;Laurac;177;8;185
76;Occitanie;11;2;01;197;Lauraguel;608;16;624
76;Occitanie;11;1;15;198;Laure-Minervois;1035;15;1050
76;Occitanie;11;1;04;199;Lavalette;1495;26;1521
76;Occitanie;11;1;15;200;Lespinassière;133;7;140
76;Occitanie;11;1;03;201;Leuc;857;15;872
76;Occitanie;11;3;17;202;Leucate;4520;57;4577
76;Occitanie;11;3;08;203;Lézignan-Corbières;11248;201;11449
76;Occitanie;11;2;01;204;Lignairolles;46;0;46
76;Occitanie;11;1;15;205;Limousis;131;2;133
76;Occitanie;11;2;09;206;Limoux;10112;513;10625
76;Occitanie;11;2;09;207;Loupia;240;5;245
76;Occitanie;11;1;01;208;La Louvière-Lauragais;78;3;81
76;Occitanie;11;2;14;209;Luc-sur-Aude;246;7;253
76;Occitanie;11;3;07;210;Luc-sur-Orbieu;1138;10;1148
76;Occitanie;11;2;09;211;Magrie;531;5;536
76;Occitanie;11;3;16;212;Mailhac;570;12;582
76;Occitanie;11;3;07;213;Maisons;48;0;48
76;Occitanie;11;2;09;214;Malras;407;12;419
76;Occitanie;11;1;19;215;Malves-en-Minervois;860;25;885
76;Occitanie;11;2;01;216;Malviès;370;12;382
76;Occitanie;11;3;16;217;Marcorignan;1316;27;1343
76;Occitanie;11;1;01;218;Marquein;84;0;84
76;Occitanie;11;2;14;219;Marsa;18;0;18
76;Occitanie;11;1;18;220;Marseillette;708;13;721
76;Occitanie;11;1;19;221;Les Martys;299;5;304
76;Occitanie;11;1;19;222;Mas-Cabardès;182;5;187
76;Occitanie;11;1;03;223;Mas-des-Cours;25;1;26
76;Occitanie;11;1;05;225;Mas-Saintes-Puelles;924;22;946
76;Occitanie;11;3;07;224;Massac;28;1;29
76;Occitanie;11;1;01;226;Mayreville;78;1;79
76;Occitanie;11;1;18;227;Mayronnes;36;1;37
76;Occitanie;11;2;01;228;Mazerolles-du-Razès;152;4;156
76;Occitanie;11;2;14;229;Mazuby;25;1;26
76;Occitanie;11;2;14;230;Mérial;32;0;32
76;Occitanie;11;1;01;231;Mézerville;96;3;99
76;Occitanie;11;1;19;232;Miraval-Cabardès;46;0;46
76;Occitanie;11;3;16;233;Mirepeisset;763;13;776
76;Occitanie;11;1;01;234;Mireval-Lauragais;180;5;185
76;Occitanie;11;2;14;235;Missègre;62;2;64
76;Occitanie;11;1;01;236;Molandier;240;2;242
76;Occitanie;11;1;01;238;Molleville;135;6;141
76;Occitanie;11;1;01;239;Montauriol;84;2;86
76;Occitanie;11;2;14;240;Montazels;557;9;566
76;Occitanie;11;3;08;241;Montbrun-des-Corbières;319;1;320
76;Occitanie;11;1;04;242;Montclar;173;0;173
76;Occitanie;11;1;05;243;Montferrand;583;10;593
76;Occitanie;11;2;14;244;Montfort-sur-Boulzane;89;3;92
76;Occitanie;11;3;07;245;Montgaillard;39;0;39
76;Occitanie;11;2;01;246;Montgradail;47;0;47
76;Occitanie;11;2;01;247;Monthaut;38;0;38
76;Occitanie;11;1;18;248;Montirat;72;1;73
76;Occitanie;11;2;14;249;Montjardin;84;1;85
76;Occitanie;11;3;07;250;Montjoi;36;1;37
76;Occitanie;11;1;05;252;Montmaur;306;9;315
76;Occitanie;11;1;10;253;Montolieu;837;14;851
76;Occitanie;11;1;10;254;Montréal;1894;174;2068
76;Occitanie;11;3;11;255;Montredon-des-Corbières;1475;15;1490
76;Occitanie;11;3;07;256;Montséret;608;12;620
76;Occitanie;11;1;18;257;Monze;229;3;232
76;Occitanie;11;3;16;258;Moussan;1998;47;2045
76;Occitanie;11;1;10;259;Moussoulens;1011;30;1041
76;Occitanie;11;3;07;260;Mouthoumet;106;3;109
76;Occitanie;11;3;18;261;Moux;701;8;709
76;Occitanie;11;3;99;262;Narbonne;55375;1175;56550
76;Occitanie;11;2;14;263;Nébias;253;5;258
76;Occitanie;11;3;11;264;Névian;1299;32;1331
76;Occitanie;11;2;14;265;Niort-de-Sault;35;1;36
76;Occitanie;11;3;08;267;Ornaisons;1154;26;1180
76;Occitanie;11;1;01;268;Orsans;106;0;106
76;Occitanie;11;3;16;269;Ouveillan;2549;50;2599
76;Occitanie;11;3;07;270;Padern;136;1;137
76;Occitanie;11;3;07;271;Palairac;31;0;31
76;Occitanie;11;1;03;272;Palaja;2359;99;2458
76;Occitanie;11;3;17;188;La Palme;1674;30;1704
76;Occitanie;11;3;16;273;Paraza;647;11;658
76;Occitanie;11;2;09;274;Pauligne;364;14;378
76;Occitanie;11;1;01;275;Payra-sur-l'Hers;204;3;207
76;Occitanie;11;3;07;276;Paziols;528;18;546
76;Occitanie;11;1;01;278;Pech-Luna;75;1;76
76;Occitanie;11;1;01;277;Pécharic-et-le-Py;27;2;29
76;Occitanie;11;1;19;279;Pennautier;2589;58;2647
76;Occitanie;11;1;15;280;Pépieux;1078;30;1108
76;Occitanie;11;1;01;281;Pexiora;1230;19;1249
76;Occitanie;11;2;14;282;Peyrefitte-du-Razès;50;2;52
76;Occitanie;11;1;01;283;Peyrefitte-sur-l'Hers;76;5;81
76;Occitanie;11;1;05;284;Peyrens;486;17;503
76;Occitanie;11;3;17;285;Peyriac-de-Mer;1123;23;1146
76;Occitanie;11;1;15;286;Peyriac-Minervois;1155;20;1175
76;Occitanie;11;2;14;287;Peyrolles;86;2;88
76;Occitanie;11;1;10;288;Pezens;1562;155;1717
76;Occitanie;11;2;09;289;Pieusse;973;17;990
76;Occitanie;11;1;01;290;Plaigne;115;1;116
76;Occitanie;11;1;01;291;Plavilla;110;4;114
76;Occitanie;11;1;05;292;La Pomarède;153;1;154
76;Occitanie;11;2;09;293;Pomas;889;24;913
76;Occitanie;11;2;01;294;Pomy;58;1;59
76;Occitanie;11;3;17;266;Port-la-Nouvelle;5686;67;5753
76;Occitanie;11;3;17;295;Portel-des-Corbières;1374;19;1393
76;Occitanie;11;3;16;296;Pouzols-Minervois;560;9;569
76;Occitanie;11;1;19;297;Pradelles-Cabardès;143;1;144
76;Occitanie;11;1;04;299;Preixan;622;14;636
76;Occitanie;11;1;05;300;Puginier;151;0;151
76;Occitanie;11;1;15;301;Puichéric;1190;17;1207
76;Occitanie;11;2;14;302;Puilaurens;268;9;277
76;Occitanie;11;2;14;303;Puivert;445;15;460
76;Occitanie;11;2;14;304;Quillan ;3238;108;3346
76;Occitanie;11;3;07;305;Quintillan;51;0;51
76;Occitanie;11;2;14;306;Quirbajou;54;2;56
76;Occitanie;11;3;16;307;Raissac-d'Aude;261;5;266
76;Occitanie;11;1;10;308;Raissac-sur-Lampy;454;9;463
76;Occitanie;11;1;15;190;La Redorte;1194;20;1214
76;Occitanie;11;2;14;309;Rennes-le-Château;91;4;95
76;Occitanie;11;2;14;310;Rennes-les-Bains;204;1;205
76;Occitanie;11;3;07;311;Ribaute;273;4;277
76;Occitanie;11;1;01;312;Ribouisse;109;5;114
76;Occitanie;11;1;05;313;Ricaud;301;7;308
76;Occitanie;11;1;18;314;Rieux-en-Val;87;7;94
76;Occitanie;11;1;15;315;Rieux-Minervois;1967;26;1993
76;Occitanie;11;2;14;316;Rivel;204;3;207
76;Occitanie;11;2;14;317;Rodome;118;1;119
76;Occitanie;11;3;18;318;Roquecourbe-Minervois;138;6;144
76;Occitanie;11;1;19;319;Roquefère;80;1;81
76;Occitanie;11;2;14;320;Roquefeuil;292;4;296
76;Occitanie;11;2;14;321;Roquefort-de-Sault;84;0;84
76;Occitanie;11;3;17;322;Roquefort-des-Corbières;1007;18;1025
76;Occitanie;11;2;14;323;Roquetaillade-et-Conilhac ;277;2;279
76;Occitanie;11;3;16;324;Roubia;506;13;519
76;Occitanie;11;1;04;325;Rouffiac-d'Aude;436;10;446
76;Occitanie;11;3;07;326;Rouffiac-des-Corbières;83;1;84
76;Occitanie;11;1;04;327;Roullens;470;13;483
76;Occitanie;11;2;01;328;Routier;245;3;248
76;Occitanie;11;1;15;330;Rustiques;506;12;518
76;Occitanie;11;1;01;331;Saint-Amans;62;3;65
76;Occitanie;11;3;07;332;Saint-André-de-Roquelongue;1380;16;1396
76;Occitanie;11;2;14;333;Saint-Benoît;106;3;109
76;Occitanie;11;3;18;337;Saint-Couat-d'Aude;396;4;400
76;Occitanie;11;2;09;338;Saint-Couat-du-Razès;44;1;45
76;Occitanie;11;1;10;339;Saint-Denis;509;12;521
76;Occitanie;11;2;14;341;Saint-Ferriol;113;2;115
76;Occitanie;11;1;15;342;Saint-Frichoux;249;4;253
76;Occitanie;11;1;01;343;Saint-Gaudéric;118;2;120
76;Occitanie;11;2;09;344;Saint-Hilaire;774;16;790
76;Occitanie;11;3;07;345;Saint-Jean-de-Barrou;258;0;258
76;Occitanie;11;2;14;346;Saint-Jean-de-Paracol;125;3;128
76;Occitanie;11;2;14;347;Saint-Julia-de-Bec;104;2;106
76;Occitanie;11;1;01;348;Saint-Julien-de-Briola;88;1;89
76;Occitanie;11;2;14;350;Saint-Just-et-le-Bézu;48;3;51
76;Occitanie;11;3;07;351;Saint-Laurent-de-la-Cabrerisse;729;26;755
76;Occitanie;11;2;14;352;Saint-Louis-et-Parahou;52;2;54
76;Occitanie;11;3;16;353;Saint-Marcel-sur-Aude;2012;46;2058
76;Occitanie;11;2;09;355;Saint-Martin-de-Villereglan;355;8;363
76;Occitanie;11;3;07;354;Saint-Martin-des-Puits;27;0;27
76;Occitanie;11;1;05;356;Saint-Martin-Lalande;1125;20;1145
76;Occitanie;11;1;10;357;Saint-Martin-le-Vieil;221;7;228
76;Occitanie;11;2;14;358;Saint-Martin-Lys;25;2;27
76;Occitanie;11;1;01;359;Saint-Michel-de-Lanès;470;6;476
76;Occitanie;11;3;16;360;Saint-Nazaire-d'Aude;2062;35;2097
76;Occitanie;11;1;05;361;Saint-Papoul;879;20;899
76;Occitanie;11;1;05;362;Saint-Paulet;200;4;204
76;Occitanie;11;3;07;363;Saint-Pierre-des-Champs;181;5;186
76;Occitanie;11;2;09;364;Saint-Polycarpe;144;2;146
76;Occitanie;11;1;01;365;Saint-Sernin;39;2;41
76;Occitanie;11;1;01;334;Sainte-Camelle;118;2;120
76;Occitanie;11;2;14;335;Sainte-Colombe-sur-Guette;46;0;46
76;Occitanie;11;2;14;336;Sainte-Colombe-sur-l'Hers;432;7;439
76;Occitanie;11;1;10;340;Sainte-Eulalie;515;9;524
76;Occitanie;11;3;16;366;Sainte-Valière;550;10;560
76;Occitanie;11;1;10;367;Saissac;925;23;948
76;Occitanie;11;1;15;368;Sallèles-Cabardès;120;3;123
76;Occitanie;11;3;16;369;Sallèles-d'Aude;2973;42;3015
76;Occitanie;11;3;06;370;Salles-d'Aude;3254;76;3330
76;Occitanie;11;1;01;371;Salles-sur-l'Hers;707;13;720
76;Occitanie;11;1;19;372;Salsigne;384;5;389
76;Occitanie;11;2;14;373;Salvezines;74;1;75
76;Occitanie;11;3;07;374;Salza;16;0;16
76;Occitanie;11;2;01;375;Seignalens;31;1;32
76;Occitanie;11;2;14;376;La Serpent;93;4;97
76;Occitanie;11;2;14;377;Serres;71;0;71
76;Occitanie;11;1;18;378;Serviès-en-Val;205;6;211
76;Occitanie;11;3;17;379;Sigean;5531;96;5627
76;Occitanie;11;2;14;380;Sonnac-sur-l'Hers;133;3;136
76;Occitanie;11;2;14;381;Sougraigne;116;6;122
76;Occitanie;11;1;05;382;Souilhanels;364;58;422
76;Occitanie;11;1;05;383;Souilhe;321;10;331
76;Occitanie;11;3;07;384;Soulatgé;127;0;127
76;Occitanie;11;1;05;385;Soupex;241;7;248
76;Occitanie;11;3;07;386;Talairan;484;7;491
76;Occitanie;11;1;18;387;Taurize;112;1;113
76;Occitanie;11;3;07;388;Termes;43;0;43
76;Occitanie;11;2;14;389;Terroles;16;0;16
76;Occitanie;11;3;07;390;Thézan-des-Corbières;552;10;562
76;Occitanie;11;1;19;391;La Tourette-Cabardès;24;2;26
76;Occitanie;11;3;07;392;Tournissan;273;4;277
76;Occitanie;11;3;08;393;Tourouzelle;478;7;485
76;Occitanie;11;2;09;394;Tourreilles;129;0;129
76;Occitanie;11;1;15;395;Trassanel;32;0;32
76;Occitanie;11;1;15;396;Trausse;595;3;598
76;Occitanie;11;1;18;397;Trèbes;5566;129;5695
76;Occitanie;11;3;17;398;Treilles;247;5;252
76;Occitanie;11;1;05;399;Tréville;106;5;111
76;Occitanie;11;2;14;400;Tréziers;101;1;102
76;Occitanie;11;3;07;401;Tuchan;797;11;808
76;Occitanie;11;1;18;251;Val-de-Dagne ;739;10;749
76;Occitanie;11;2;14;080;Val de Lambronne;174;2;176
76;Occitanie;11;2;14;131;Val-du-Faby;564;13;577
76;Occitanie;11;2;14;402;Valmigère;20;0;20
76;Occitanie;11;1;19;404;Ventenac-Cabardès;958;33;991
76;Occitanie;11;3;16;405;Ventenac-en-Minervois;564;10;574
76;Occitanie;11;2;09;406;Véraza;33;2;35
76;Occitanie;11;1;10;407;Verdun-en-Lauragais;277;6;283
76;Occitanie;11;1;03;408;Verzeille;502;8;510
76;Occitanie;11;3;07;409;Vignevieille;106;1;107
76;Occitanie;11;1;19;410;Villalier;986;17;1003
76;Occitanie;11;1;19;411;Villanière;137;1;138
76;Occitanie;11;1;18;414;Villar-en-Val;25;1;26
76;Occitanie;11;2;09;415;Villar-Saint-Anselme;124;0;124
76;Occitanie;11;2;09;412;Villardebelle;54;0;54
76;Occitanie;11;1;19;413;Villardonnel;499;11;510
76;Occitanie;11;1;15;416;Villarzel-Cabardès;240;5;245
76;Occitanie;11;2;01;417;Villarzel-du-Razès;98;0;98
76;Occitanie;11;1;01;418;Villasavary;1210;39;1249
76;Occitanie;11;1;01;419;Villautou;63;0;63
76;Occitanie;11;2;09;420;Villebazy;131;3;134
76;Occitanie;11;3;11;421;Villedaigne;512;8;520
76;Occitanie;11;1;18;422;Villedubert;347;15;362
76;Occitanie;11;1;03;423;Villefloure;161;4;165
76;Occitanie;11;2;14;424;Villefort;87;1;88
76;Occitanie;11;1;19;425;Villegailhenc;1709;54;1763
76;Occitanie;11;1;15;426;Villegly;1157;23;1180
76;Occitanie;11;2;09;427;Villelongue-d'Aude;304;8;312
76;Occitanie;11;1;10;428;Villemagne;257;7;264
76;Occitanie;11;1;19;429;Villemoustaussou;4449;79;4528
76;Occitanie;11;1;05;430;Villeneuve-la-Comptal;1332;41;1373
76;Occitanie;11;3;07;431;Villeneuve-les-Corbières;245;7;252
76;Occitanie;11;1;10;432;Villeneuve-lès-Montréal;314;10;324
76;Occitanie;11;1;15;433;Villeneuve-Minervois;997;17;1014
76;Occitanie;11;1;01;434;Villepinte;1289;25;1314
76;Occitanie;11;3;07;435;Villerouge-Termenès;152;6;158
76;Occitanie;11;3;07;436;Villesèque-des-Corbières;371;2;373
76;Occitanie;11;1;10;437;Villesèquelande;901;17;918
76;Occitanie;11;1;01;438;Villesiscle;388;6;394
76;Occitanie;11;1;10;439;Villespy;387;8;395
76;Occitanie;11;1;18;440;Villetritouls;36;3;39
76;Occitanie;11;3;06;441;Vinassan;2653;53;2706
76;Occitanie;12;1;03;001;Agen-d'Aveyron;1069;32;1101
76;Occitanie;12;1;12;002;Aguessac;868;29;897
76;Occitanie;12;3;08;003;Les Albres;345;7;352
76;Occitanie;12;3;07;004;Almont-les-Junies;454;20;474
76;Occitanie;12;1;15;006;Alrance;354;11;365
76;Occitanie;12;3;23;007;Ambeyrac;175;8;183
76;Occitanie;12;3;06;008;Anglars-Saint-Félix;853;19;872
76;Occitanie;12;2;01;223;Argences en Aubrac;1623;38;1661
76;Occitanie;12;1;04;009;Arnac-sur-Dourdou;35;1;36
76;Occitanie;12;1;15;010;Arques;144;2;146
76;Occitanie;12;1;13;011;Arvieu;782;28;810
76;Occitanie;12;3;08;012;Asprières;739;9;748
76;Occitanie;12;3;06;013;Aubin;3757;113;3870
76;Occitanie;12;1;13;015;Auriac-Lagast;229;3;232
76;Occitanie;12;3;06;016;Auzits;835;26;861
76;Occitanie;12;1;15;017;Ayssènes;217;5;222
76;Occitanie;12;3;08;018;Balaguier-d'Olt;172;7;179
76;Occitanie;12;1;04;019;Balaguier-sur-Rance;91;4;95
76;Occitanie;12;3;05;056;Baraqueville;3144;84;3228
76;Occitanie;12;3;02;021;Bas Ségala ;1571;55;1626
76;Occitanie;12;1;19;022;La Bastide-Pradines;105;0;105
76;Occitanie;12;1;04;023;La Bastide-Solages;108;1;109
76;Occitanie;12;3;06;024;Belcastel;193;3;196
76;Occitanie;12;1;04;025;Belmont-sur-Rance;976;12;988
76;Occitanie;12;2;09;026;Bertholène;1050;20;1070
76;Occitanie;12;2;10;027;Bessuéjouls;209;10;219
76;Occitanie;12;3;07;028;Boisse-Penchot;517;9;526
76;Occitanie;12;3;02;029;Bor-et-Bar;198;4;202
76;Occitanie;12;3;08;030;Bouillac;397;15;412
76;Occitanie;12;3;06;031;Bournazel;351;5;356
76;Occitanie;12;3;05;032;Boussac;591;13;604
76;Occitanie;12;2;03;033;Bozouls;2886;65;2951
76;Occitanie;12;3;23;034;Brandonnet;311;7;318
76;Occitanie;12;1;04;035;Brasc;170;8;178
76;Occitanie;12;2;01;036;Brommat;638;8;646
76;Occitanie;12;1;15;037;Broquiès;610;16;626
76;Occitanie;12;1;15;038;Brousse-le-Château;161;4;165
76;Occitanie;12;1;04;039;Brusque;268;5;273
76;Occitanie;12;3;05;041;Cabanès;258;6;264
76;Occitanie;12;1;19;042;Calmels-et-le-Viala;208;11;219
76;Occitanie;12;3;13;043;Calmont;2109;75;2184
76;Occitanie;12;1;04;044;Camarès;1034;32;1066
76;Occitanie;12;3;05;045;Camboulazet;390;12;402
76;Occitanie;12;3;05;046;Camjac;573;16;589
76;Occitanie;12;2;20;047;Campagnac;448;6;454
76;Occitanie;12;2;01;048;Campouriez;346;9;355
76;Occitanie;12;2;10;049;Campuac;448;10;458
76;Occitanie;12;1;15;050;Canet-de-Salars;436;12;448
76;Occitanie;12;2;01;051;Cantoin;307;2;309
76;Occitanie;12;3;08;052;Capdenac-Gare;4462;119;4581
76;Occitanie;12;3;23;053;La Capelle-Balaguier;317;6;323
76;Occitanie;12;3;02;054;La Capelle-Bleys;352;8;360
76;Occitanie;12;2;20;055;La Capelle-Bonance;83;0;83
76;Occitanie;12;3;13;057;Cassagnes-Bégonhès;915;33;948
76;Occitanie;12;2;01;058;Cassuéjouls;108;5;113
76;Occitanie;12;3;05;059;Castanet;516;24;540
76;Occitanie;12;3;02;060;Castelmary;114;4;118
76;Occitanie;12;2;09;061;Castelnau-de-Mandailles;581;11;592
76;Occitanie;12;1;20;062;Castelnau-Pégayrols;337;3;340
76;Occitanie;12;3;08;257;Causse-et-Diège;778;18;796
76;Occitanie;12;1;04;063;La Cavalerie;1690;28;1718
76;Occitanie;12;2;10;064;Le Cayrol;262;5;267
76;Occitanie;12;3;05;065;Centrès;459;14;473
76;Occitanie;12;2;21;066;Clairvaux-d'Aveyron;1147;28;1175
76;Occitanie;12;1;04;067;Le Clapier;77;0;77
76;Occitanie;12;3;05;068;Colombiès;891;27;918
76;Occitanie;12;1;04;069;Combret;268;7;275
76;Occitanie;12;1;12;070;Compeyre;526;26;552
76;Occitanie;12;3;23;071;Compolibat;340;7;347
76;Occitanie;12;1;11;072;Comprégnac;241;7;248
76;Occitanie;12;1;13;073;Comps-la-Grand-Ville;625;19;644
76;Occitanie;12;2;01;074;Condom-d'Aubrac;298;14;312
76;Occitanie;12;1;13;075;Connac;107;2;109
76;Occitanie;12;2;07;076;Conques-en-Rouergue;1643;57;1700
76;Occitanie;12;1;04;077;Cornus;519;12;531
76;Occitanie;12;1;15;078;Les Costes-Gozon;185;2;187
76;Occitanie;12;2;10;079;Coubisou;493;18;511
76;Occitanie;12;1;04;080;Coupiac;382;9;391
76;Occitanie;12;1;04;082;La Couvertoirade;189;2;191
76;Occitanie;12;3;06;083;Cransac;1490;53;1543
76;Occitanie;12;1;11;084;Creissels;1580;58;1638
76;Occitanie;12;3;02;085;Crespin;315;0;315
76;Occitanie;12;1;20;086;La Cresse;320;16;336
76;Occitanie;12;1;15;307;Curan;297;15;312
76;Occitanie;12;2;01;088;Curières;227;4;231
76;Occitanie;12;3;07;089;Decazeville;5353;206;5559
76;Occitanie;12;2;21;090;Druelle Balsac ;3180;93;3273
76;Occitanie;12;3;23;091;Drulhe;446;11;457
76;Occitanie;12;1;13;092;Durenque;524;10;534
76;Occitanie;12;2;10;094;Entraygues-sur-Truyère;992;17;1009
76;Occitanie;12;3;06;095;Escandolières;238;6;244
76;Occitanie;12;2;10;096;Espalion;4559;143;4702
76;Occitanie;12;2;10;097;Espeyrac;249;3;252
76;Occitanie;12;2;10;098;Estaing;467;21;488
76;Occitanie;12;1;04;099;Fayet;249;4;253
76;Occitanie;12;2;10;093;Le Fel;175;1;176
76;Occitanie;12;3;06;100;Firmi;2374;67;2441
76;Occitanie;12;3;07;101;Flagnac;1061;35;1096
76;Occitanie;12;1;14;102;Flavin;2331;50;2381
76;Occitanie;12;2;01;103;Florentin-la-Capelle;280;8;288
76;Occitanie;12;3;08;104;Foissac;487;10;497
76;Occitanie;12;1;04;155;Fondamente;331;9;340
76;Occitanie;12;3;02;105;La Fouillade;1094;25;1119
76;Occitanie;12;2;03;106;Gabriac;519;10;529
76;Occitanie;12;2;09;107;Gaillac-d'Aveyron;313;5;318
76;Occitanie;12;3;08;108;Galgan;373;5;378
76;Occitanie;12;1;04;109;Gissac;101;2;103
76;Occitanie;12;2;10;110;Golinhac;329;16;345
76;Occitanie;12;3;06;111;Goutrens;502;18;520
76;Occitanie;12;3;05;113;Gramond;504;7;511
76;Occitanie;12;1;04;115;L' Hospitalet-du-Larzac;281;3;284
76;Occitanie;12;2;01;116;Huparlac;265;8;273
76;Occitanie;12;2;01;118;Lacroix-Barrez;519;13;532
76;Occitanie;12;2;01;119;Laguiole;1238;28;1266
76;Occitanie;12;2;09;120;Laissac-Sévérac l'Église;2126;103;2229
76;Occitanie;12;3;23;121;Lanuéjouls;723;16;739
76;Occitanie;12;1;04;122;Lapanouse-de-Cernon;124;8;132
76;Occitanie;12;2;09;124;Lassouts;298;9;307
76;Occitanie;12;1;04;125;Laval-Roquecezière;280;4;284
76;Occitanie;12;1;13;127;Lédergues;640;20;660
76;Occitanie;12;3;02;128;Lescure-Jaoul;224;6;230
76;Occitanie;12;1;15;129;Lestrade-et-Thouels;478;15;493
76;Occitanie;12;3;07;130;Livinhac-le-Haut;1122;32;1154
76;Occitanie;12;2;03;131;La Loubière;1495;46;1541
76;Occitanie;12;2;14;133;Luc-la-Primaube;5987;166;6153
76;Occitanie;12;3;08;134;Lugan;344;10;354
76;Occitanie;12;3;02;135;Lunac;440;14;454
76;Occitanie;12;3;23;136;Maleville;940;17;957
76;Occitanie;12;3;05;137;Manhac;828;11;839
76;Occitanie;12;2;21;138;Marcillac-Vallon;1721;50;1771
76;Occitanie;12;1;04;139;Marnhagues-et-Latour;139;1;140
76;Occitanie;12;3;23;140;Martiel;994;24;1018
76;Occitanie;12;1;04;141;Martrin;224;7;231
76;Occitanie;12;3;06;142;Mayran;636;15;651
76;Occitanie;12;1;04;143;Mélagues;60;0;60
76;Occitanie;12;3;05;144;Meljac;127;2;129
76;Occitanie;12;1;98;145;Millau;22002;668;22670
76;Occitanie;12;2;17;146;Le Monastère;2276;76;2352
76;Occitanie;12;1;04;147;Montagnol;137;1;138
76;Occitanie;12;3;08;148;Montbazens;1398;39;1437
76;Occitanie;12;1;04;149;Montclar;157;5;162
76;Occitanie;12;3;02;150;Monteils;523;90;613
76;Occitanie;12;2;01;151;Montézic;219;8;227
76;Occitanie;12;1;04;152;Montfranc;126;2;128
76;Occitanie;12;1;20;153;Montjaux;419;7;426
76;Occitanie;12;1;04;154;Montlaur;620;25;645
76;Occitanie;12;2;01;156;Montpeyroux;534;13;547
76;Occitanie;12;2;03;157;Montrozier;1662;48;1710
76;Occitanie;12;3;23;158;Montsalès;328;8;336
76;Occitanie;12;3;02;159;Morlhon-le-Haut;559;24;583
76;Occitanie;12;1;20;160;Mostuéjouls;316;5;321
76;Occitanie;12;1;04;192;Mounes-Prohencoux;183;4;187
76;Occitanie;12;2;21;161;Mouret;542;15;557
76;Occitanie;12;3;05;162;Moyrazès;1084;28;1112
76;Occitanie;12;2;01;164;Mur-de-Barrez;730;17;747
76;Occitanie;12;1;04;163;Murasson;202;4;206
76;Occitanie;12;2;21;165;Muret-le-Château;357;16;373
76;Occitanie;12;2;01;166;Murols;114;1;115
76;Occitanie;12;3;02;167;Najac;697;22;719
76;Occitanie;12;1;12;168;Nant;999;18;1017
76;Occitanie;12;3;05;169;Naucelle;2008;146;2154
76;Occitanie;12;3;08;170;Naussac;372;8;380
76;Occitanie;12;2;21;171;Nauviale;574;19;593
76;Occitanie;12;2;10;172;Le Nayrac;535;12;547
76;Occitanie;12;2;14;174;Olemps;3425;98;3523
76;Occitanie;12;3;23;175;Ols-et-Rinhodes;174;2;176
76;Occitanie;12;2;18;176;Onet-le-Château;11659;588;12247
76;Occitanie;12;2;09;177;Palmas d'Aveyron;1020;15;1035
76;Occitanie;12;1;12;178;Paulhe;381;9;390
76;Occitanie;12;1;04;179;Peux-et-Couffouleux;86;1;87
76;Occitanie;12;1;20;180;Peyreleau;73;2;75
76;Occitanie;12;3;08;181;Peyrusse-le-Roc;221;5;226
76;Occitanie;12;2;09;182;Pierrefiche;277;5;282
76;Occitanie;12;1;04;183;Plaisance;219;6;225
76;Occitanie;12;2;09;184;Pomayrols;119;6;125
76;Occitanie;12;1;15;185;Pont-de-Salars;1645;65;1710
76;Occitanie;12;1;04;186;Pousthomy;209;2;211
76;Occitanie;12;2;09;187;Prades-d'Aubrac;359;4;363
76;Occitanie;12;1;15;188;Prades-Salars;312;10;322
76;Occitanie;12;3;05;189;Pradinas;358;6;364
76;Occitanie;12;3;02;190;Prévinquières;301;9;310
76;Occitanie;12;3;23;191;Privezac;324;9;333
76;Occitanie;12;2;21;193;Pruines;291;13;304
76;Occitanie;12;3;05;194;Quins;849;21;870
76;Occitanie;12;1;04;195;Rebourguil;277;3;280
76;Occitanie;12;1;13;197;Réquista;1994;86;2080
76;Occitanie;12;3;02;198;Rieupeyroux;1961;71;2032
76;Occitanie;12;3;06;199;Rignac;1969;141;2110
76;Occitanie;12;1;20;200;Rivière-sur-Tarn;1036;27;1063
76;Occitanie;12;2;03;201;Rodelle;1056;44;1100
76;Occitanie;12;2;99;202;Rodez;24319;1893;26212
76;Occitanie;12;1;20;204;La Roque-Sainte-Marguerite;180;4;184
76;Occitanie;12;1;19;203;Roquefort-sur-Soulzon;552;15;567
76;Occitanie;12;3;22;205;La Rouquette;779;16;795
76;Occitanie;12;3;08;206;Roussennac;632;15;647
76;Occitanie;12;1;13;207;Rullac-Saint-Cirq;345;14;359
76;Occitanie;12;1;19;208;Saint-Affrique;8034;635;8669
76;Occitanie;12;2;01;209;Saint-Amans-des-Cots;749;13;762
76;Occitanie;12;3;02;210;Saint-André-de-Najac;457;5;462
76;Occitanie;12;1;20;211;Saint-André-de-Vézines;134;1;135
76;Occitanie;12;1;04;212;Saint-Beaulize;88;7;95
76;Occitanie;12;1;20;213;Saint-Beauzély;605;15;620
76;Occitanie;12;2;01;214;Saint-Chély-d'Aubrac;519;13;532
76;Occitanie;12;2;21;215;Saint-Christophe-Vallon;1149;47;1196
76;Occitanie;12;2;09;216;Saint-Côme-d'Olt;1375;37;1412
76;Occitanie;12;2;07;221;Saint-Félix-de-Lunel;346;10;356
76;Occitanie;12;1;19;222;Saint-Félix-de-Sorgues;201;4;205
76;Occitanie;12;2;09;224;Saint Geniez d'Olt et d'Aubrac;2206;40;2246
76;Occitanie;12;1;11;225;Saint-Georges-de-Luzençon;1607;43;1650
76;Occitanie;12;2;10;226;Saint-Hippolyte;427;13;440
76;Occitanie;12;3;23;227;Saint-Igest;185;5;190
76;Occitanie;12;1;19;228;Saint-Izaire;304;8;312
76;Occitanie;12;1;19;229;Saint-Jean-d'Alcapiès;258;7;265
76;Occitanie;12;1;13;230;Saint-Jean-Delnous;411;16;427
76;Occitanie;12;1;12;231;Saint-Jean-du-Bruel;708;8;716
76;Occitanie;12;1;04;232;Saint-Jean-et-Saint-Paul;278;8;286
76;Occitanie;12;1;04;233;Saint-Juéry;289;3;292
76;Occitanie;12;3;05;235;Saint-Just-sur-Viaur;207;7;214
76;Occitanie;12;2;20;237;Saint-Laurent-d'Olt;645;81;726
76;Occitanie;12;1;15;236;Saint-Laurent-de-Lévézou;152;5;157
76;Occitanie;12;1;15;238;Saint-Léons;407;13;420
76;Occitanie;12;2;20;239;Saint-Martin-de-Lenne;308;13;321
76;Occitanie;12;3;07;240;Saint-Parthem;405;10;415
76;Occitanie;12;3;23;242;Saint-Rémy;309;15;324
76;Occitanie;12;1;19;243;Saint-Rome-de-Cernon;935;13;948
76;Occitanie;12;1;15;244;Saint-Rome-de-Tarn;877;10;887
76;Occitanie;12;3;07;246;Saint-Santin;547;15;562
76;Occitanie;12;2;20;247;Saint-Saturnin-de-Lenne;287;7;294
76;Occitanie;12;1;04;248;Saint-Sernin-sur-Rance;616;104;720
76;Occitanie;12;1;04;249;Saint-Sever-du-Moustier;196;8;204
76;Occitanie;12;2;01;250;Saint-Symphorien-de-Thénières;209;2;211
76;Occitanie;12;1;15;251;Saint-Victor-et-Melvieu;351;8;359
76;Occitanie;12;3;23;217;Sainte-Croix;743;18;761
76;Occitanie;12;2;09;219;Sainte-Eulalie-d'Olt;375;9;384
76;Occitanie;12;1;04;220;Sainte-Eulalie-de-Cernon;284;2;286
76;Occitanie;12;3;13;234;Sainte-Juliette-sur-Viaur;606;8;614
76;Occitanie;12;2;14;241;Sainte-Radegonde;1745;64;1809
76;Occitanie;12;3;08;252;Salles-Courbatiès;418;9;427
76;Occitanie;12;1;15;253;Salles-Curan;1023;31;1054
76;Occitanie;12;2;21;254;Salles-la-Source;2243;74;2317
76;Occitanie;12;1;13;255;Salmiech;769;28;797
76;Occitanie;12;3;23;256;Salvagnac-Cajarc;374;10;384
76;Occitanie;12;3;02;258;La Salvetat-Peyralès;980;15;995
76;Occitanie;12;3;02;259;Sanvensa;655;17;672
76;Occitanie;12;1;04;260;Sauclières;169;2;171
76;Occitanie;12;3;23;261;Saujac;122;4;126
76;Occitanie;12;3;05;262;Sauveterre-de-Rouergue;744;15;759
76;Occitanie;12;3;23;263;Savignac;726;23;749
76;Occitanie;12;2;03;264;Sébazac-Concourès;3260;92;3352
76;Occitanie;12;2;10;265;Sébrazac;512;13;525
76;Occitanie;12;1;15;266;Ségur;548;5;553
76;Occitanie;12;1;13;267;La Selve;628;12;640
76;Occitanie;12;2;07;268;Sénergues;421;17;438
76;Occitanie;12;1;04;269;La Serre;123;3;126
76;Occitanie;12;2;20;270;Sévérac d'Aveyron;4081;122;4203
76;Occitanie;12;3;08;272;Sonnac;518;13;531
76;Occitanie;12;2;01;273;Soulages-Bonneval;292;8;300
76;Occitanie;12;1;04;274;Sylvanès;111;2;113
76;Occitanie;12;1;04;275;Tauriac-de-Camarès;37;1;38
76;Occitanie;12;3;05;276;Tauriac-de-Naucelle;366;13;379
76;Occitanie;12;2;01;277;Taussac;525;4;529
76;Occitanie;12;3;02;278;Tayrac;182;2;184
76;Occitanie;12;2;01;280;Thérondels;407;6;413
76;Occitanie;12;3;23;281;Toulonjac;745;22;767
76;Occitanie;12;1;19;282;Tournemire;426;8;434
76;Occitanie;12;1;15;283;Trémouilles;495;16;511
76;Occitanie;12;1;15;284;Le Truel;347;1;348
76;Occitanie;12;1;19;286;Vabres-l'Abbaye;1204;31;1235
76;Occitanie;12;3;22;287;Vailhourles;633;22;655
76;Occitanie;12;2;21;288;Valady;1564;38;1602
76;Occitanie;12;3;08;289;Valzergues;210;8;218
76;Occitanie;12;3;23;290;Vaureilles;489;10;499
76;Occitanie;12;1;20;291;Verrières;429;10;439
76;Occitanie;12;1;19;292;Versols-et-Lapeyre;417;14;431
76;Occitanie;12;1;20;293;Veyreau;136;1;137
76;Occitanie;12;1;15;294;Vézins-de-Lévézou;657;18;675
76;Occitanie;12;1;04;295;Viala-du-Pas-de-Jaux;98;2;100
76;Occitanie;12;1;20;296;Viala-du-Tarn;531;13;544
76;Occitanie;12;1;15;297;Le Vibal;509;19;528
76;Occitanie;12;2;10;298;Villecomtal;407;8;415
76;Occitanie;12;1;15;299;Villefranche-de-Panat;690;26;716
76;Occitanie;12;3;22;300;Villefranche-de-Rouergue;11781;576;12357
76;Occitanie;12;3;23;301;Villeneuve;1988;46;2034
76;Occitanie;12;2;09;303;Vimenet;246;5;251
76;Occitanie;12;3;07;305;Viviez;1258;22;1280
93;Provence-Alpes-Côte d'Azur;13;1;97;001;Aix-en-Provence;143097;3185;146282
93;Provence-Alpes-Côte d'Azur;13;3;03;002;Allauch;20860;221;21081
93;Provence-Alpes-Côte d'Azur;13;1;25;003;Alleins;2516;52;2568
93;Provence-Alpes-Côte d'Azur;13;2;04;004;Arles;51031;800;51831
93;Provence-Alpes-Côte d'Azur;13;3;05;005;Aubagne;47208;451;47659
93;Provence-Alpes-Côte d'Azur;13;2;26;006;Aureille;1522;26;1548
93;Provence-Alpes-Côte d'Azur;13;3;03;007;Auriol;12771;158;12929
93;Provence-Alpes-Côte d'Azur;13;1;25;008;Aurons;560;16;576
93;Provence-Alpes-Côte d'Azur;13;1;25;009;La Barben;836;33;869
93;Provence-Alpes-Côte d'Azur;13;2;07;010;Barbentane;4156;185;4341
93;Provence-Alpes-Côte d'Azur;13;2;26;011;Les Baux-de-Provence;349;8;357
93;Provence-Alpes-Côte d'Azur;13;1;28;012;Beaurecueil;586;55;641
93;Provence-Alpes-Côte d'Azur;13;3;03;013;Belcodène;1919;35;1954
93;Provence-Alpes-Côte d'Azur;13;4;06;014;Berre-l'Étang;13520;77;13597
93;Provence-Alpes-Côte d'Azur;13;1;29;015;Bouc-Bel-Air;14784;301;15085
93;Provence-Alpes-Côte d'Azur;13;3;03;016;La Bouilladisse;6254;83;6337
93;Provence-Alpes-Côte d'Azur;13;2;07;017;Boulbon;1518;18;1536
93;Provence-Alpes-Côte d'Azur;13;2;07;018;Cabannes;4443;59;4502
93;Provence-Alpes-Côte d'Azur;13;1;29;019;Cabriès;9834;325;10159
93;Provence-Alpes-Côte d'Azur;13;3;03;020;Cadolive;2162;44;2206
93;Provence-Alpes-Côte d'Azur;13;3;08;119;Carnoux-en-Provence;6564;84;6648
93;Provence-Alpes-Côte d'Azur;13;4;11;021;Carry-le-Rouet;5756;128;5884
93;Provence-Alpes-Côte d'Azur;13;3;08;022;Cassis;7027;109;7136
93;Provence-Alpes-Côte d'Azur;13;3;08;023;Ceyreste;4656;108;4764
93;Provence-Alpes-Côte d'Azur;13;1;25;024;Charleval;2684;36;2720
93;Provence-Alpes-Côte d'Azur;13;1;28;025;Châteauneuf-le-Rouge;2307;74;2381
93;Provence-Alpes-Côte d'Azur;13;4;11;026;Châteauneuf-les-Martigues;17425;59;17484
93;Provence-Alpes-Côte d'Azur;13;2;07;027;Châteaurenard;16012;247;16259
93;Provence-Alpes-Côte d'Azur;13;3;08;028;La Ciotat;35281;379;35660
93;Provence-Alpes-Côte d'Azur;13;4;06;029;Cornillon-Confoux;1370;22;1392
93;Provence-Alpes-Côte d'Azur;13;1;06;118;Coudoux;3710;52;3762
93;Provence-Alpes-Côte d'Azur;13;3;08;030;Cuges-les-Pins;5147;54;5201
93;Provence-Alpes-Côte d'Azur;13;3;03;031;La Destrousse;3757;44;3801
93;Provence-Alpes-Côte d'Azur;13;1;25;032;Éguilles;7957;142;8099
93;Provence-Alpes-Côte d'Azur;13;4;11;033;Ensuès-la-Redonne;5527;94;5621
93;Provence-Alpes-Côte d'Azur;13;2;26;034;Eygalières;1790;29;1819
93;Provence-Alpes-Côte d'Azur;13;1;26;035;Eyguières;6926;163;7089
93;Provence-Alpes-Côte d'Azur;13;2;07;036;Eyragues;4468;128;4596
93;Provence-Alpes-Côte d'Azur;13;1;06;037;La Fare-les-Oliviers;8666;103;8769
93;Provence-Alpes-Côte d'Azur;13;2;26;038;Fontvieille;3568;80;3648
93;Provence-Alpes-Côte d'Azur;13;4;10;039;Fos-sur-Mer;15602;181;15783
93;Provence-Alpes-Côte d'Azur;13;1;28;040;Fuveau;10157;185;10342
93;Provence-Alpes-Côte d'Azur;13;1;09;041;Gardanne;21376;338;21714
93;Provence-Alpes-Côte d'Azur;13;3;08;042;Gémenos;6551;126;6677
93;Provence-Alpes-Côte d'Azur;13;4;11;043;Gignac-la-Nerthe;9606;87;9693
93;Provence-Alpes-Côte d'Azur;13;4;27;044;Grans;5120;82;5202
93;Provence-Alpes-Côte d'Azur;13;2;07;045;Graveson;4857;73;4930
93;Provence-Alpes-Côte d'Azur;13;1;03;046;Gréasque;4253;78;4331
93;Provence-Alpes-Côte d'Azur;13;4;10;047;Istres;43411;648;44059
93;Provence-Alpes-Côte d'Azur;13;1;28;048;Jouques;4423;98;4521
93;Provence-Alpes-Côte d'Azur;13;1;26;049;Lamanon;1989;40;2029
93;Provence-Alpes-Côte d'Azur;13;1;25;050;Lambesc;9799;273;10072
93;Provence-Alpes-Côte d'Azur;13;1;06;051;Lançon-Provence;8947;119;9066
93;Provence-Alpes-Côte d'Azur;13;2;07;052;Maillane;2625;32;2657
93;Provence-Alpes-Côte d'Azur;13;1;25;053;Mallemort;6084;147;6231
93;Provence-Alpes-Côte d'Azur;13;4;11;054;Marignane;32793;231;33024
93;Provence-Alpes-Côte d'Azur;13;3;12;201;Marseille 1er Arrondissement;40283;198;40481
93;Provence-Alpes-Côte d'Azur;13;3;13;202;Marseille 2e Arrondissement;24874;58;24932
93;Provence-Alpes-Côte d'Azur;13;3;98;203;Marseille 3e Arrondissement;50982;190;51172
93;Provence-Alpes-Côte d'Azur;13;3;98;204;Marseille 4e Arrondissement;49281;306;49587
93;Provence-Alpes-Côte d'Azur;13;3;98;205;Marseille 5e Arrondissement;45979;280;46259
93;Provence-Alpes-Côte d'Azur;13;3;98;206;Marseille 6e Arrondissement;42241;402;42643
93;Provence-Alpes-Côte d'Azur;13;3;23;207;Marseille 7e Arrondissement;34875;316;35191
93;Provence-Alpes-Côte d'Azur;13;3;98;208;Marseille 8e Arrondissement;81276;1262;82538
93;Provence-Alpes-Côte d'Azur;13;3;98;209;Marseille 9e Arrondissement;76342;639;76981
93;Provence-Alpes-Côte d'Azur;13;3;98;210;Marseille 10e Arrondissement;57093;336;57429
93;Provence-Alpes-Côte d'Azur;13;3;98;211;Marseille 11e Arrondissement;57372;444;57816
93;Provence-Alpes-Côte d'Azur;13;3;98;212;Marseille 12e Arrondissement;61325;557;61882
93;Provence-Alpes-Côte d'Azur;13;3;98;213;Marseille 13e Arrondissement;91674;718;92392
93;Provence-Alpes-Côte d'Azur;13;3;98;214;Marseille 14e Arrondissement;61965;242;62207
93;Provence-Alpes-Côte d'Azur;13;3;98;215;Marseille 15e Arrondissement;76610;293;76903
93;Provence-Alpes-Côte d'Azur;13;3;14;216;Marseille 16e Arrondissement;16105;101;16206
93;Provence-Alpes-Côte d'Azur;13;4;24;056;Martigues;48420;515;48935
93;Provence-Alpes-Côte d'Azur;13;2;26;057;Mas-Blanc-des-Alpilles;507;11;518
93;Provence-Alpes-Côte d'Azur;13;2;26;058;Maussane-les-Alpilles;2326;49;2375
93;Provence-Alpes-Côte d'Azur;13;1;28;059;Meyrargues;3840;52;3892
93;Provence-Alpes-Côte d'Azur;13;1;28;060;Meyreuil;5796;90;5886
93;Provence-Alpes-Côte d'Azur;13;1;09;062;Mimet;4348;76;4424
93;Provence-Alpes-Côte d'Azur;13;4;27;063;Miramas;26668;394;27062
93;Provence-Alpes-Côte d'Azur;13;2;07;064;Mollégès;2608;28;2636
93;Provence-Alpes-Côte d'Azur;13;2;26;065;Mouriès;3400;49;3449
93;Provence-Alpes-Côte d'Azur;13;2;07;066;Noves;5866;69;5935
93;Provence-Alpes-Côte d'Azur;13;2;26;067;Orgon;2892;35;2927
93;Provence-Alpes-Côte d'Azur;13;2;26;068;Paradou;2066;35;2101
93;Provence-Alpes-Côte d'Azur;13;1;25;069;Pélissanne;10404;265;10669
93;Provence-Alpes-Côte d'Azur;13;3;05;070;La Penne-sur-Huveaune;6446;60;6506
93;Provence-Alpes-Côte d'Azur;13;1;09;071;Les Pennes-Mirabeau;21411;291;21702
93;Provence-Alpes-Côte d'Azur;13;1;28;072;Peynier;3513;113;3626
93;Provence-Alpes-Côte d'Azur;13;3;03;073;Peypin;5547;77;5624
93;Provence-Alpes-Côte d'Azur;13;1;28;074;Peyrolles-en-Provence;5125;89;5214
93;Provence-Alpes-Côte d'Azur;13;2;07;076;Plan-d'Orgon;3465;48;3513
93;Provence-Alpes-Côte d'Azur;13;3;03;075;Plan-de-Cuques;11481;100;11581
93;Provence-Alpes-Côte d'Azur;13;4;24;077;Port-de-Bouc;16569;124;16693
93;Provence-Alpes-Côte d'Azur;13;4;04;078;Port-Saint-Louis-du-Rhône;8423;80;8503
93;Provence-Alpes-Côte d'Azur;13;1;28;080;Le Puy-Sainte-Réparade;5744;88;5832
93;Provence-Alpes-Côte d'Azur;13;1;28;079;Puyloubier;1779;103;1882
93;Provence-Alpes-Côte d'Azur;13;4;06;081;Rognac;12080;122;12202
93;Provence-Alpes-Côte d'Azur;13;1;25;082;Rognes;4706;127;4833
93;Provence-Alpes-Côte d'Azur;13;2;07;083;Rognonas;4062;58;4120
93;Provence-Alpes-Côte d'Azur;13;1;25;084;La Roque-d'Anthéron;5441;113;5554
93;Provence-Alpes-Côte d'Azur;13;3;08;085;Roquefort-la-Bédoule;5896;72;5968
93;Provence-Alpes-Côte d'Azur;13;3;05;086;Roquevaire;8858;126;8984
93;Provence-Alpes-Côte d'Azur;13;1;28;087;Rousset;4881;132;5013
93;Provence-Alpes-Côte d'Azur;13;4;11;088;Le Rove;5137;47;5184
93;Provence-Alpes-Côte d'Azur;13;2;07;089;Saint-Andiol;3297;51;3348
93;Provence-Alpes-Côte d'Azur;13;1;28;090;Saint-Antonin-sur-Bayon;123;4;127
93;Provence-Alpes-Côte d'Azur;13;1;25;091;Saint-Cannat;5678;114;5792
93;Provence-Alpes-Côte d'Azur;13;4;06;092;Saint-Chamas;8593;128;8721
93;Provence-Alpes-Côte d'Azur;13;1;25;093;Saint-Estève-Janson;380;8;388
93;Provence-Alpes-Côte d'Azur;13;2;26;094;Saint-Étienne-du-Grès;2483;44;2527
93;Provence-Alpes-Côte d'Azur;13;1;28;095;Saint-Marc-Jaumegarde;1243;68;1311
93;Provence-Alpes-Côte d'Azur;13;2;27;097;Saint-Martin-de-Crau;13558;303;13861
93;Provence-Alpes-Côte d'Azur;13;4;10;098;Saint-Mitre-les-Remparts;5800;109;5909
93;Provence-Alpes-Côte d'Azur;13;1;28;099;Saint-Paul-lès-Durance;880;13;893
93;Provence-Alpes-Côte d'Azur;13;2;07;061;Saint-Pierre-de-Mézoargues;210;5;215
93;Provence-Alpes-Côte d'Azur;13;2;26;100;Saint-Rémy-de-Provence;9829;213;10042
93;Provence-Alpes-Côte d'Azur;13;3;03;101;Saint-Savournin;3384;58;3442
93;Provence-Alpes-Côte d'Azur;13;4;29;102;Saint-Victoret;6633;52;6685
93;Provence-Alpes-Côte d'Azur;13;2;04;096;Saintes-Maries-de-la-Mer;2157;21;2178
93;Provence-Alpes-Côte d'Azur;13;1;99;103;Salon-de-Provence;45400;586;45986
93;Provence-Alpes-Côte d'Azur;13;4;11;104;Sausset-les-Pins;7640;144;7784
93;Provence-Alpes-Côte d'Azur;13;1;26;105;Sénas;6930;86;7016
93;Provence-Alpes-Côte d'Azur;13;3;09;106;Septèmes-les-Vallons;11058;95;11153
93;Provence-Alpes-Côte d'Azur;13;1;09;107;Simiane-Collongue;5699;119;5818
93;Provence-Alpes-Côte d'Azur;13;2;07;108;Tarascon;15195;138;15333
93;Provence-Alpes-Côte d'Azur;13;1;28;109;Le Tholonet;2267;56;2323
93;Provence-Alpes-Côte d'Azur;13;1;28;110;Trets;10500;153;10653
93;Provence-Alpes-Côte d'Azur;13;1;28;111;Vauvenargues;1007;20;1027
93;Provence-Alpes-Côte d'Azur;13;1;06;112;Velaux;8616;150;8766
93;Provence-Alpes-Côte d'Azur;13;1;28;113;Venelles;8406;184;8590
93;Provence-Alpes-Côte d'Azur;13;1;06;114;Ventabren;5433;138;5571
93;Provence-Alpes-Côte d'Azur;13;1;25;115;Vernègues;1937;38;1975
93;Provence-Alpes-Côte d'Azur;13;2;07;116;Verquières;821;17;838
93;Provence-Alpes-Côte d'Azur;13;4;29;117;Vitrolles;33101;361;33462
28;Normandie;14;3;15;001;Ablon;1198;44;1242
28;Normandie;14;1;02;003;Agy;298;7;305
28;Normandie;14;2;12;006;Amayé-sur-Orne;1009;20;1029
28;Normandie;14;4;01;007;Amayé-sur-Seulles;233;4;237
28;Normandie;14;3;04;009;Amfreville;1377;19;1396
28;Normandie;14;3;04;012;Angerville;188;1;189
28;Normandie;14;2;11;015;Anisy;734;22;756
28;Normandie;14;3;04;016;Annebault;466;14;480
28;Normandie;14;1;02;019;Arganchy;223;3;226
28;Normandie;14;2;24;020;Argences;3756;30;3786
28;Normandie;14;1;11;021;Arromanches-les-Bains;481;11;492
28;Normandie;14;1;11;022;Asnelles;591;8;599
28;Normandie;14;1;23;023;Asnières-en-Bessin;66;1;67
28;Normandie;14;3;04;024;Auberville;584;12;596
28;Normandie;14;2;13;025;Aubigny;308;3;311
28;Normandie;14;1;03;026;Audrieu;1078;19;1097
28;Normandie;14;1;23;591;Aure sur Mer ;737;10;747
28;Normandie;14;4;01;011;Aurseulles ;1907;38;1945
28;Normandie;14;2;06;030;Authie;1607;46;1653
28;Normandie;14;3;21;032;Les Authieux-sur-Calonne;281;11;292
28;Normandie;14;3;19;033;Auvillars;220;2;222
28;Normandie;14;2;12;034;Avenay;563;2;565
28;Normandie;14;1;23;035;Balleroy-sur-Drôme ;1414;57;1471
28;Normandie;14;2;24;036;Banneville-la-Campagne;172;1;173
28;Normandie;14;1;11;038;Banville;789;9;798
28;Normandie;14;2;22;039;Barbery;822;18;840
28;Normandie;14;1;02;040;Barbeville;184;3;187
28;Normandie;14;3;15;041;Barneville-la-Bertran;125;2;127
28;Normandie;14;2;12;042;Baron-sur-Odon;962;21;983
28;Normandie;14;2;13;043;Barou-en-Auge;74;0;74
28;Normandie;14;2;11;044;Basly;1081;18;1099
28;Normandie;14;3;04;045;Basseneville;254;2;256
28;Normandie;14;3;04;046;Bavent;1869;13;1882
28;Normandie;14;1;02;047;Bayeux;13017;333;13350
28;Normandie;14;1;11;049;Bazenville;136;2;138
28;Normandie;14;1;23;050;La Bazoque;182;2;184
28;Normandie;14;3;19;231;Beaufour-Druval;447;12;459
28;Normandie;14;2;13;053;Beaumais;176;3;179
28;Normandie;14;4;25;054;Beaumesnil;201;3;204
28;Normandie;14;3;21;055;Beaumont-en-Auge;401;9;410
28;Normandie;14;3;19;527;Belle Vie en Auge;535;8;543
28;Normandie;14;2;24;057;Bellengreville;1483;8;1491
28;Normandie;14;3;21;059;Benerville-sur-Mer;417;32;449
28;Normandie;14;2;20;060;Bénouville;2046;26;2072
28;Normandie;14;1;03;062;Bény-sur-Mer;445;7;452
28;Normandie;14;1;23;063;Bernesq;211;1;212
28;Normandie;14;2;13;064;Bernières-d'Ailly;233;7;240
28;Normandie;14;2;11;066;Bernières-sur-Mer;2286;35;2321
28;Normandie;14;3;17;069;Beuvillers;1337;27;1364
28;Normandie;14;3;19;070;Beuvron-en-Auge;191;2;193
28;Normandie;14;2;20;068;Biéville-Beuville;3476;83;3559
28;Normandie;14;2;20;076;Blainville-sur-Orne;5942;73;6015
28;Normandie;14;3;21;077;Blangy-le-Château;699;55;754
28;Normandie;14;1;23;078;Blay;377;4;381
28;Normandie;14;3;21;079;Blonville-sur-Mer;1560;35;1595
28;Normandie;14;2;22;080;Le Bô;120;5;125
28;Normandie;14;3;19;082;La Boissière;189;9;198
28;Normandie;14;3;19;083;Bonnebosq;667;15;682
28;Normandie;14;4;01;084;Bonnemaison;403;9;412
28;Normandie;14;3;21;085;Bonneville-la-Louvet;775;20;795
28;Normandie;14;3;21;086;Bonneville-sur-Touques;336;14;350
28;Normandie;14;2;13;087;Bonnœil;126;1;127
28;Normandie;14;2;13;088;Bons-Tassilly;402;7;409
28;Normandie;14;2;12;089;Bougy;398;9;407
28;Normandie;14;2;22;090;Boulon;708;6;714
28;Normandie;14;3;04;091;Bourgeauville;105;1;106
28;Normandie;14;2;12;092;Bourguébus;2081;23;2104
28;Normandie;14;3;04;093;Branville;199;5;204
28;Normandie;14;4;01;096;Brémoy;227;6;233
28;Normandie;14;2;22;097;Bretteville-le-Rabet;303;4;307
28;Normandie;14;2;22;100;Bretteville-sur-Laize;1915;24;1939
28;Normandie;14;2;05;101;Bretteville-sur-Odon;3919;75;3994
28;Normandie;14;3;21;102;Le Breuil-en-Auge;1020;23;1043
28;Normandie;14;1;23;103;Le Breuil-en-Bessin;402;7;409
28;Normandie;14;3;21;104;Le Brévedent;170;4;174
28;Normandie;14;3;04;106;Bréville-les-Monts;657;5;662
28;Normandie;14;1;23;107;Bricqueville;173;0;173
28;Normandie;14;3;04;110;Brucourt;124;2;126
28;Normandie;14;2;22;116;Le Bû-sur-Rouvres;104;5;109
28;Normandie;14;1;03;111;Bucéels;420;6;426
28;Normandie;14;3;04;117;Cabourg;3604;31;3635
28;Normandie;14;2;99;118;Caen;105512;2174;107686
28;Normandie;14;2;24;119;Cagny;1944;22;1966
28;Normandie;14;4;01;120;Cahagnes;1391;23;1414
28;Normandie;14;1;23;121;Cahagnolles;252;1;253
28;Normandie;14;2;12;122;La Caine;158;1;159
28;Normandie;14;2;03;123;Cairon;2007;47;2054
28;Normandie;14;1;23;124;La Cambe;554;9;563
28;Normandie;14;2;20;125;Cambes-en-Plaine;1738;49;1787
28;Normandie;14;3;19;126;Cambremer;1346;37;1383
28;Normandie;14;4;25;127;Campagnolles;542;4;546
28;Normandie;14;1;02;130;Campigny;185;1;186
28;Normandie;14;3;21;131;Canapville;230;4;234
28;Normandie;14;1;23;132;Canchy;206;0;206
28;Normandie;14;2;24;134;Canteloup;183;5;188
28;Normandie;14;1;03;135;Carcagny;281;2;283
28;Normandie;14;1;23;136;Cardonville;106;0;106
28;Normandie;14;2;06;137;Carpiquet;2747;24;2771
28;Normandie;14;1;23;138;Cartigny-l'Épinay;295;6;301
28;Normandie;14;2;12;554;Castelet ;1576;10;1586
28;Normandie;14;1;23;140;Castillon;347;6;353
28;Normandie;14;3;19;141;Castillon-en-Auge;165;2;167
28;Normandie;14;2;12;538;Castine-en-Plaine;1601;30;1631
28;Normandie;14;4;01;143;Caumont-sur-Aure ;2358;25;2383
28;Normandie;14;2;22;145;Cauvicourt;516;4;520
28;Normandie;14;2;22;146;Cauville;166;4;170
28;Normandie;14;3;18;147;Cernay;140;1;141
28;Normandie;14;2;24;149;Cesny-aux-Vignes;417;13;430
28;Normandie;14;2;22;150;Cesny-les-Sources ;1333;27;1360
28;Normandie;14;1;02;159;Chouain;222;13;235
28;Normandie;14;2;22;160;Cintheaux;189;6;195
28;Normandie;14;3;21;161;Clarbec;352;17;369
28;Normandie;14;2;22;162;Clécy;1292;15;1307
28;Normandie;14;2;24;163;Cléville;377;3;380
28;Normandie;14;2;20;166;Colleville-Montgomery;2496;43;2539
28;Normandie;14;1;23;165;Colleville-sur-Mer;174;4;178
28;Normandie;14;2;14;167;Colombelles;6941;52;6993
28;Normandie;14;1;23;168;Colombières;208;5;213
28;Normandie;14;1;03;169;Colombiers-sur-Seulles;162;0;162
28;Normandie;14;2;11;014;Colomby-Anguerny ;1105;31;1136
28;Normandie;14;2;22;171;Combray;146;1;147
28;Normandie;14;1;02;172;Commes;419;10;429
28;Normandie;14;4;10;174;Condé-en-Normandie ;6524;276;6800
28;Normandie;14;2;19;173;Condé-sur-Ifs;446;14;460
28;Normandie;14;1;02;175;Condé-sur-Seulles;289;5;294
28;Normandie;14;3;21;177;Coquainvilliers;852;17;869
28;Normandie;14;3;17;179;Cordebugle;164;5;169
28;Normandie;14;2;13;180;Cordey;155;3;158
28;Normandie;14;2;16;181;Cormelles-le-Royal;4959;45;5004
28;Normandie;14;1;23;182;Cormolain;412;6;418
28;Normandie;14;2;22;183;Cossesseville;99;1;100
28;Normandie;14;1;02;184;Cottun;227;0;227
28;Normandie;14;2;13;190;Courcy;129;5;134
28;Normandie;14;2;11;191;Courseulles-sur-Mer;4242;55;4297
28;Normandie;14;3;17;193;Courtonne-la-Meurdrac;658;20;678
28;Normandie;14;3;17;194;Courtonne-les-Deux-Églises;653;10;663
28;Normandie;14;4;01;195;Courvaudon;251;1;252
28;Normandie;14;1;11;196;Crépon;209;6;215
28;Normandie;14;2;11;197;Cresserons;1132;27;1159
28;Normandie;14;3;04;198;Cresseveuille;259;9;268
28;Normandie;14;1;03;200;Creully sur Seulles ;2269;79;2348
28;Normandie;14;3;15;202;Cricquebœuf;280;6;286
28;Normandie;14;3;04;203;Cricqueville-en-Auge;186;7;193
28;Normandie;14;1;23;204;Cricqueville-en-Bessin;187;2;189
28;Normandie;14;1;03;205;Cristot;217;6;223
28;Normandie;14;2;13;206;Crocy;304;0;304
28;Normandie;14;2;22;207;Croisilles;644;8;652
28;Normandie;14;1;23;209;Crouay;521;10;531
28;Normandie;14;2;22;211;Culey-le-Patry;363;4;367
28;Normandie;14;1;02;214;Cussy;189;2;191
28;Normandie;14;2;24;215;Cuverville;2227;33;2260
28;Normandie;14;2;13;216;Damblainville;240;3;243
28;Normandie;14;3;04;218;Danestal;393;6;399
28;Normandie;14;3;15;220;Deauville;3595;60;3655
28;Normandie;14;2;24;221;Démouville;3169;45;3214
28;Normandie;14;2;13;223;Le Détroit;87;2;89
28;Normandie;14;1;23;224;Deux-Jumeaux;51;2;53
28;Normandie;14;4;01;347;Dialan sur Chaîne;1054;12;1066
28;Normandie;14;3;04;225;Dives-sur-Mer;5411;178;5589
28;Normandie;14;2;22;226;Donnay;289;2;291
28;Normandie;14;3;04;227;Douville-en-Auge;211;6;217
28;Normandie;14;2;11;228;Douvres-la-Délivrande;4999;204;5203
28;Normandie;14;3;04;229;Dozulé;2284;22;2306
28;Normandie;14;3;19;230;Drubec;118;1;119
28;Normandie;14;1;03;232;Ducy-Sainte-Marguerite;164;3;167
28;Normandie;14;1;02;236;Ellon;544;7;551
28;Normandie;14;2;24;237;Émiéville;603;7;610
28;Normandie;14;3;21;238;Englesqueville-en-Auge;109;2;111
28;Normandie;14;1;23;239;Englesqueville-la-Percée;106;0;106
28;Normandie;14;2;13;240;Épaney;511;12;523
28;Normandie;14;4;01;241;Épinay-sur-Odon;617;15;632
28;Normandie;14;2;07;242;Épron;1633;24;1657
28;Normandie;14;3;15;243;Équemauville;1440;6;1446
28;Normandie;14;2;13;244;Eraines;331;11;342
28;Normandie;14;2;13;245;Ernes;316;11;327
28;Normandie;14;3;24;246;Escoville;805;6;811
28;Normandie;14;2;22;248;Espins;250;5;255
28;Normandie;14;2;12;249;Esquay-Notre-Dame;1436;10;1446
28;Normandie;14;1;02;250;Esquay-sur-Seulles;288;6;294
28;Normandie;14;2;22;251;Esson;527;6;533
28;Normandie;14;2;22;252;Estrées-la-Campagne;255;3;258
28;Normandie;14;2;09;254;Éterville;1615;26;1641
28;Normandie;14;1;23;256;Étréham;343;5;348
28;Normandie;14;2;12;257;Évrecy;2000;27;2027
28;Normandie;14;2;13;258;Falaise;8086;265;8351
28;Normandie;14;3;21;260;Fauguernon;248;7;255
28;Normandie;14;3;21;261;Le Faulq;340;7;347
28;Normandie;14;2;12;266;Feuguerolles-Bully;1429;23;1452
28;Normandie;14;3;21;269;Fierville-les-Parcs;219;4;223
28;Normandie;14;3;21;270;Firfol;405;16;421
28;Normandie;14;2;09;271;Fleury-sur-Orne;4954;69;5023
28;Normandie;14;1;23;272;La Folie;97;2;99
28;Normandie;14;3;18;273;La Folletière-Abenon;133;1;134
28;Normandie;14;2;12;274;Fontaine-Étoupefour;2516;62;2578
28;Normandie;14;1;03;275;Fontaine-Henry;462;6;468
28;Normandie;14;2;13;276;Fontaine-le-Pin;356;4;360
28;Normandie;14;2;12;277;Fontenay-le-Marmion;1935;13;1948
28;Normandie;14;1;03;278;Fontenay-le-Pesnel;1196;18;1214
28;Normandie;14;3;19;280;Formentin;253;9;262
28;Normandie;14;1;23;281;Formigny La Bataille ;734;14;748
28;Normandie;14;1;23;282;Foulognes;202;6;208
28;Normandie;14;2;13;283;Fourches;227;7;234
28;Normandie;14;2;13;284;Fourneaux-le-Val;157;4;161
28;Normandie;14;3;19;285;Le Fournet;66;2;68
28;Normandie;14;3;15;286;Fourneville;490;20;510
28;Normandie;14;2;24;287;Frénouville;1933;14;1947
28;Normandie;14;2;03;288;Le Fresne-Camilly;927;24;951
28;Normandie;14;2;13;289;Fresné-la-Mère;588;13;601
28;Normandie;14;2;22;290;Fresney-le-Puceux;819;8;827
28;Normandie;14;2;22;291;Fresney-le-Vieux;282;4;286
28;Normandie;14;3;21;293;Fumichon;279;6;285
28;Normandie;14;2;12;297;Gavrus;560;7;567
28;Normandie;14;1;23;298;Géfosse-Fontenay;138;3;141
28;Normandie;14;3;15;299;Genneville;832;18;850
28;Normandie;14;3;19;300;Gerrots;52;0;52
28;Normandie;14;2;16;301;Giberville;4951;47;4998
28;Normandie;14;3;21;302;Glanville;170;15;185
28;Normandie;14;3;17;303;Glos;921;20;941
28;Normandie;14;3;04;306;Gonneville-en-Auge;391;5;396
28;Normandie;14;3;15;304;Gonneville-sur-Honfleur;873;34;907
28;Normandie;14;3;04;305;Gonneville-sur-Mer;680;13;693
28;Normandie;14;3;04;308;Goustranville;234;0;234
28;Normandie;14;2;22;309;Gouvix;846;4;850
28;Normandie;14;2;22;310;Grainville-Langannerie;702;7;709
28;Normandie;14;2;12;311;Grainville-sur-Odon;1047;9;1056
28;Normandie;14;1;23;312;Grandcamp-Maisy;1554;24;1578
28;Normandie;14;3;04;316;Grangues;257;3;260
28;Normandie;14;1;11;318;Graye-sur-Mer;714;7;721
28;Normandie;14;2;12;319;Grentheville;955;7;962
28;Normandie;14;2;22;320;Grimbosq;284;7;291
28;Normandie;14;1;02;322;Guéron;244;5;249
28;Normandie;14;2;20;325;Hermanville-sur-Mer;3105;42;3147
28;Normandie;14;3;21;326;Hermival-les-Vaux;807;38;845
28;Normandie;14;2;14;327;Hérouville-Saint-Clair;22638;271;22909
28;Normandie;14;3;04;328;Hérouvillette;1323;9;1332
28;Normandie;14;3;04;329;Heuland;105;4;109
28;Normandie;14;2;13;332;La Hoguette;669;11;680
28;Normandie;14;2;22;689;Le Hom;3659;49;3708
28;Normandie;14;3;15;333;Honfleur;7138;214;7352
28;Normandie;14;3;17;334;L' Hôtellerie;315;6;321
28;Normandie;14;3;19;335;Hotot-en-Auge;297;3;300
28;Normandie;14;1;01;336;Hottot-les-Bagues;480;5;485
28;Normandie;14;3;19;337;La Houblonnière;331;10;341
28;Normandie;14;3;04;338;Houlgate;1792;38;1830
28;Normandie;14;2;16;341;Ifs;11567;194;11761
28;Normandie;14;1;23;342;Isigny-sur-Mer ;3619;43;3662
28;Normandie;14;2;13;343;Les Isles-Bardel;63;0;63
28;Normandie;14;2;24;344;Janville;372;9;381
28;Normandie;14;2;13;345;Jort;300;2;302
28;Normandie;14;1;02;346;Juaye-Mondaye;673;14;687
28;Normandie;14;1;03;348;Juvigny-sur-Seulles;82;1;83
28;Normandie;14;2;12;349;Laize-Clinchamps ;2082;21;2103
28;Normandie;14;4;25;352;Landelles-et-Coupigny;846;20;866
28;Normandie;14;4;01;353;Landes-sur-Ajon;438;5;443
28;Normandie;14;2;11;354;Langrune-sur-Mer;1879;47;1926
28;Normandie;14;3;19;358;Léaupartie;88;2;90
28;Normandie;14;2;13;360;Leffard;210;2;212
28;Normandie;14;3;19;362;Lessard-et-le-Chêne;159;0;159
28;Normandie;14;1;01;364;Lingèvres;465;13;478
28;Normandie;14;2;20;365;Lion-sur-Mer;2498;40;2538
28;Normandie;14;3;17;366;Lisieux;20171;652;20823
28;Normandie;14;1;23;367;Lison;439;5;444
28;Normandie;14;3;18;368;Lisores;261;11;272
28;Normandie;14;1;23;369;Litteau;291;3;294
28;Normandie;14;3;18;371;Livarot-Pays-d'Auge;6254;111;6365
28;Normandie;14;4;01;374;Les Loges;140;2;142
28;Normandie;14;2;13;375;Les Loges-Saulces;168;3;171
28;Normandie;14;1;02;377;Longues-sur-Mer;599;9;608
28;Normandie;14;1;23;378;Longueville;276;9;285
28;Normandie;14;4;01;379;Longvillers;361;5;366
28;Normandie;14;1;03;380;Loucelles;183;5;188
28;Normandie;14;2;13;381;Louvagny;61;2;63
28;Normandie;14;2;09;383;Louvigny;2712;39;2751
28;Normandie;14;2;11;384;Luc-sur-Mer;3228;52;3280
28;Normandie;14;1;02;385;Magny-en-Bessin;152;8;160
28;Normandie;14;4;01;389;Maisoncelles-Pelvey;264;9;273
28;Normandie;14;4;01;390;Maisoncelles-sur-Ajon;190;4;194
28;Normandie;14;1;23;391;Maisons;391;4;395
28;Normandie;14;2;12;393;Maizet;365;7;372
28;Normandie;14;2;13;394;Maizières;436;14;450
28;Normandie;14;4;01;037;Malherbe-sur-Ajon ;558;13;571
28;Normandie;14;2;12;396;Maltot;1015;15;1030
28;Normandie;14;1;23;397;Mandeville-en-Bessin;335;6;341
28;Normandie;14;3;19;398;Manerbe;552;16;568
28;Normandie;14;3;21;399;Manneville-la-Pipard;283;12;295
28;Normandie;14;1;02;400;Le Manoir;218;3;221
28;Normandie;14;1;02;401;Manvieux;131;6;137
28;Normandie;14;2;13;402;Le Marais-la-Chapelle;108;2;110
28;Normandie;14;3;17;403;Marolles;756;21;777
28;Normandie;14;2;22;404;Martainville;119;2;121
28;Normandie;14;2;13;405;Martigny-sur-l'Ante;323;7;330
28;Normandie;14;2;20;407;Mathieu;2255;56;2311
28;Normandie;14;2;12;408;May-sur-Orne;1967;14;1981
28;Normandie;14;3;04;409;Merville-Franceville-Plage;2177;35;2212
28;Normandie;14;3;19;410;Méry-Bissières-en-Auge ;1093;7;1100
28;Normandie;14;2;22;411;Meslay;301;6;307
28;Normandie;14;4;01;412;Le Mesnil-au-Grain;80;2;82
28;Normandie;14;3;19;419;Le Mesnil-Eudes;257;9;266
28;Normandie;14;3;17;421;Le Mesnil-Guillaume;605;6;611
28;Normandie;14;4;25;424;Le Mesnil-Robert;192;3;195
28;Normandie;14;3;19;425;Le Mesnil-Simon;172;6;178
28;Normandie;14;3;21;426;Le Mesnil-sur-Blangy;163;7;170
28;Normandie;14;2;13;427;Le Mesnil-Villement;296;3;299
28;Normandie;14;1;11;430;Meuvaines;140;3;143
28;Normandie;14;3;19;431;Mézidon Vallée d'Auge;9607;113;9720
28;Normandie;14;1;23;370;Le Molay-Littry;3003;39;3042
28;Normandie;14;3;19;435;Les Monceaux;190;3;193
28;Normandie;14;1;02;436;Monceaux-en-Bessin;561;5;566
28;Normandie;14;2;16;437;Mondeville;9893;258;10151
28;Normandie;14;2;12;438;Mondrainville;534;10;544
28;Normandie;14;1;23;439;Monfréville;90;2;92
28;Normandie;14;1;23;445;Montfiquet;100;2;102
28;Normandie;14;2;12;446;Montigny;97;2;99
28;Normandie;14;2;22;713;Montillières-sur-Orne ;587;11;598
28;Normandie;14;3;19;448;Montreuil-en-Auge;61;0;61
28;Normandie;14;4;89;027;Les Monts d'Aunay;4634;67;4701
28;Normandie;14;4;01;449;Monts-en-Bessin;409;5;414
28;Normandie;14;2;13;452;Morteaux-Coulibœuf;637;10;647
28;Normandie;14;1;23;453;Mosles;353;7;360
28;Normandie;14;2;05;454;Mouen;1613;22;1635
28;Normandie;14;2;22;455;Moulines;294;2;296
28;Normandie;14;1;03;406;Moulins en Bessin;1143;27;1170
28;Normandie;14;2;24;456;Moult-Chicheboville;3202;44;3246
28;Normandie;14;2;13;457;Les Moutiers-en-Auge;126;1;127
28;Normandie;14;2;22;458;Les Moutiers-en-Cinglais;520;58;578
28;Normandie;14;3;21;460;Moyaux;1356;31;1387
28;Normandie;14;2;22;461;Mutrécy;429;2;431
28;Normandie;14;1;02;465;Nonant;497;13;510
28;Normandie;14;3;21;466;Norolles;329;9;338
28;Normandie;14;2;13;467;Noron-l'Abbaye;311;7;318
28;Normandie;14;1;23;468;Noron-la-Poterie;380;7;387
28;Normandie;14;2;13;469;Norrey-en-Auge;91;3;94
28;Normandie;14;3;19;474;Notre-Dame-d'Estrées-Corbon;213;3;216
28;Normandie;14;3;19;473;Notre-Dame-de-Livaye;113;3;116
28;Normandie;14;4;25;658;Noues de Sienne;4388;97;4485
28;Normandie;14;2;13;476;Olendon;177;3;180
28;Normandie;14;3;18;478;Orbec;1988;50;2038
28;Normandie;14;1;23;480;Osmanville;528;7;535
28;Normandie;14;2;24;482;Ouézy;235;2;237
28;Normandie;14;2;22;483;Ouffières;189;3;192
28;Normandie;14;3;21;484;Ouilly-du-Houley;242;4;246
28;Normandie;14;2;13;486;Ouilly-le-Tesson;580;9;589
28;Normandie;14;3;21;487;Ouilly-le-Vicomte;792;24;816
28;Normandie;14;2;20;488;Ouistreham;9250;117;9367
28;Normandie;14;4;01;491;Parfouru-sur-Odon;196;11;207
28;Normandie;14;3;15;492;Pennedepie;302;7;309
28;Normandie;14;3;04;494;Périers-en-Auge;133;8;141
28;Normandie;14;2;20;495;Périers-sur-le-Dan;531;10;541
28;Normandie;14;4;10;496;Périgny;58;4;62
28;Normandie;14;2;13;497;Perrières;330;7;337
28;Normandie;14;2;13;498;Pertheville-Ners;243;4;247
28;Normandie;14;3;04;499;Petiville;521;5;526
28;Normandie;14;3;21;500;Pierrefitte-en-Auge;159;6;165
28;Normandie;14;2;13;501;Pierrefitte-en-Cinglais;252;6;258
28;Normandie;14;2;13;502;Pierrepont;91;1;92
28;Normandie;14;3;21;504;Le Pin;813;21;834
28;Normandie;14;1;23;506;Planquery;243;3;246
28;Normandie;14;2;11;509;Plumetot;213;5;218
28;Normandie;14;2;22;510;La Pommeraye;55;3;58
28;Normandie;14;4;25;511;Pont-Bellanger;67;0;67
28;Normandie;14;2;13;764;Pont-d'Ouilly;985;16;1001
28;Normandie;14;3;21;514;Pont-l'Évêque ;4634;70;4704
28;Normandie;14;4;10;512;Pontécoulant;76;0;76
28;Normandie;14;1;03;355;Ponts sur Seulles;1178;20;1198
28;Normandie;14;1;02;515;Port-en-Bessin-Huppain;1940;17;1957
28;Normandie;14;2;13;516;Potigny;2077;19;2096
28;Normandie;14;3;19;520;Le Pré-d'Auge;876;23;899
28;Normandie;14;2;12;519;Préaux-Bocage;126;0;126
28;Normandie;14;3;19;522;Prêtreville;394;7;401
28;Normandie;14;3;04;524;Putot-en-Auge;295;5;300
28;Normandie;14;3;15;528;Quetteville;383;5;388
28;Normandie;14;1;02;529;Ranchy;254;3;257
28;Normandie;14;3;04;530;Ranville;1856;27;1883
28;Normandie;14;2;13;531;Rapilly;48;0;48
28;Normandie;14;3;19;533;Repentigny;93;4;97
28;Normandie;14;3;21;534;Reux;401;6;407
28;Normandie;14;2;03;535;Reviers;559;12;571
28;Normandie;14;3;15;536;La Rivière-Saint-Sauveur;2542;43;2585
28;Normandie;14;3;21;540;Rocques;286;14;300
28;Normandie;14;3;19;541;La Roque-Baignard;121;1;122
28;Normandie;14;2;03;542;Rosel;538;11;549
28;Normandie;14;2;03;543;Rots ;2462;70;2532
28;Normandie;14;2;13;546;Rouvres;221;2;223
28;Normandie;14;1;23;547;Rubercy;164;3;167
28;Normandie;14;3;19;550;Rumesnil;97;1;98
28;Normandie;14;1;02;552;Ryes;511;14;525
28;Normandie;14;3;21;555;Saint-André-d'Hébertot;445;6;451
28;Normandie;14;2;09;556;Saint-André-sur-Orne;1824;23;1847
28;Normandie;14;3;21;557;Saint-Arnoult;1149;12;1161
28;Normandie;14;2;20;558;Saint-Aubin-d'Arquenay;1068;15;1083
28;Normandie;14;4;25;559;Saint-Aubin-des-Bois;232;1;233
28;Normandie;14;2;11;562;Saint-Aubin-sur-Mer;2313;42;2355
28;Normandie;14;3;21;563;Saint-Benoît-d'Hébertot;427;9;436
28;Normandie;14;1;11;565;Saint-Côme-de-Fresné;261;4;265
28;Normandie;14;2;06;566;Saint-Contest;2515;52;2567
28;Normandie;14;3;18;571;Saint-Denis-de-Mailloc;305;5;310
28;Normandie;14;4;10;572;Saint-Denis-de-Méré;806;7;813
28;Normandie;14;3;19;574;Saint-Désir;1731;92;1823
28;Normandie;14;3;21;575;Saint-Étienne-la-Thillaye;396;25;421
28;Normandie;14;3;15;578;Saint-Gatien-des-Bois;1338;30;1368
28;Normandie;14;3;19;582;Saint-Germain-de-Livet;752;25;777
28;Normandie;14;1;23;586;Saint-Germain-du-Pert;172;6;178
28;Normandie;14;2;06;587;Saint-Germain-la-Blanche-Herbe;2302;42;2344
28;Normandie;14;2;13;588;Saint-Germain-Langot;318;3;321
28;Normandie;14;2;22;589;Saint-Germain-le-Vasson;944;9;953
28;Normandie;14;3;21;593;Saint-Hymer;675;10;685
28;Normandie;14;3;19;595;Saint-Jean-de-Livet;233;5;238
28;Normandie;14;3;04;598;Saint-Jouin;210;4;214
28;Normandie;14;3;21;601;Saint-Julien-sur-Calonne;167;5;172
28;Normandie;14;2;22;602;Saint-Lambert;271;3;274
28;Normandie;14;2;22;603;Saint-Laurent-de-Condel;502;8;510
28;Normandie;14;1;23;605;Saint-Laurent-sur-Mer;268;8;276
28;Normandie;14;3;04;606;Saint-Léger-Dubosq;197;2;199
28;Normandie;14;4;01;607;Saint-Louet-sur-Seulles;147;1;148
28;Normandie;14;1;02;609;Saint-Loup-Hors;531;9;540
28;Normandie;14;2;03;610;Saint-Manvieu-Norrey;1916;113;2029
28;Normandie;14;1;23;613;Saint-Marcouf;98;1;99
28;Normandie;14;3;21;620;Saint-Martin-aux-Chartrains;413;9;422
28;Normandie;14;3;18;621;Saint-Martin-de-Bienfaite-la-Cressonnière;443;7;450
28;Normandie;14;1;23;622;Saint-Martin-de-Blagny;129;6;135
28;Normandie;14;2;12;623;Saint-Martin-de-Fontenay;2541;19;2560
28;Normandie;14;3;17;625;Saint-Martin-de-la-Lieue;777;14;791
28;Normandie;14;3;19;626;Saint-Martin-de-Mailloc;912;21;933
28;Normandie;14;2;13;627;Saint-Martin-de-Mieux;405;8;413
28;Normandie;14;1;02;630;Saint-Martin-des-Entrées;695;18;713
28;Normandie;14;2;22;635;Saint-Omer;187;2;189
28;Normandie;14;2;24;637;Saint-Ouen-du-Mesnil-Oger;206;3;209
28;Normandie;14;3;19;639;Saint-Ouen-le-Pin;258;9;267
28;Normandie;14;2;24;640;Saint-Pair;229;1;230
28;Normandie;14;1;23;643;Saint-Paul-du-Vernay;824;14;838
28;Normandie;14;3;21;644;Saint-Philbert-des-Champs;650;14;664
28;Normandie;14;3;21;645;Saint-Pierre-Azif;163;9;172
28;Normandie;14;2;13;646;Saint-Pierre-Canivet;420;8;428
28;Normandie;14;3;19;648;Saint-Pierre-des-Ifs;452;19;471
28;Normandie;14;2;13;649;Saint-Pierre-du-Bû;476;10;486
28;Normandie;14;4;01;650;Saint-Pierre-du-Fresne;192;4;196
28;Normandie;14;2;24;651;Saint-Pierre-du-Jonquet;249;2;251
28;Normandie;14;1;23;652;Saint-Pierre-du-Mont;79;2;81
28;Normandie;14;3;18;654;Saint-Pierre-en-Auge;7503;328;7831
28;Normandie;14;2;22;656;Saint-Rémy;995;16;1011
28;Normandie;14;3;24;657;Saint-Samson;310;4;314
28;Normandie;14;2;22;659;Saint-Sylvain;1432;25;1457
28;Normandie;14;3;04;660;Saint-Vaast-en-Auge;95;3;98
28;Normandie;14;1;03;661;Saint-Vaast-sur-Seulles;150;1;151
28;Normandie;14;1;02;663;Saint-Vigor-le-Grand;2464;51;2515
28;Normandie;14;1;11;569;Sainte-Croix-sur-Mer;241;6;247
28;Normandie;14;1;23;590;Sainte-Honorine-de-Ducy;130;1;131
28;Normandie;14;2;12;592;Sainte-Honorine-du-Fay;1340;22;1362
28;Normandie;14;1;23;614;Sainte-Marguerite-d'Elle;772;13;785
28;Normandie;14;4;25;619;Sainte-Marie-Outre-l'Eau;123;2;125
28;Normandie;14;1;23;664;Sallen;307;4;311
28;Normandie;14;3;04;665;Sallenelles;293;4;297
28;Normandie;14;2;24;666;Sannerville;1912;27;1939
28;Normandie;14;1;23;667;Saon;221;4;225
28;Normandie;14;1;23;668;Saonnet;311;3;314
28;Normandie;14;2;13;669;Sassy;206;2;208
28;Normandie;14;4;01;579;Seulline;1332;24;1356
28;Normandie;14;2;22;674;Soignolles;124;3;127
28;Normandie;14;2;12;675;Soliers;2049;25;2074
28;Normandie;14;1;02;676;Sommervieu;987;23;1010
28;Normandie;14;2;13;677;Soulangy;253;6;259
28;Normandie;14;4;10;061;Souleuvre en Bocage ;8899;156;9055
28;Normandie;14;2;13;678;Soumont-Saint-Quentin;551;8;559
28;Normandie;14;1;02;679;Subles;669;21;690
28;Normandie;14;1;02;680;Sully;147;6;153
28;Normandie;14;1;23;681;Surrain;154;4;158
28;Normandie;14;3;21;682;Surville;447;13;460
28;Normandie;14;4;10;357;Terres de Druance;929;22;951
28;Normandie;14;1;03;684;Tessel;251;3;254
28;Normandie;14;2;03;685;Thaon;1640;31;1671
28;Normandie;14;3;15;687;Le Theil-en-Auge;189;3;192
28;Normandie;14;2;03;098;Thue et Mue ;6139;100;6239
28;Normandie;14;1;03;692;Tilly-sur-Seulles;1722;21;1743
28;Normandie;14;3;21;694;Le Torquesne;509;19;528
28;Normandie;14;3;24;698;Touffréville;383;1;384
28;Normandie;14;3;15;699;Touques;3676;66;3742
28;Normandie;14;1;23;700;Tour-en-Bessin;663;9;672
28;Normandie;14;3;21;701;Tourgéville;790;19;809
28;Normandie;14;1;23;705;Tournières;152;1;153
28;Normandie;14;3;21;706;Tourville-en-Auge;232;11;243
28;Normandie;14;2;05;707;Tourville-sur-Odon;1082;13;1095
28;Normandie;14;4;01;708;Tracy-Bocage;300;7;307
28;Normandie;14;1;02;709;Tracy-sur-Mer;343;7;350
28;Normandie;14;2;13;710;Tréprel;107;0;107
28;Normandie;14;1;23;711;Trévières;919;10;929
28;Normandie;14;2;24;712;Troarn;3481;91;3572
28;Normandie;14;1;23;714;Le Tronquay;778;10;788
28;Normandie;14;3;15;715;Trouville-sur-Mer;4614;89;4703
28;Normandie;14;1;23;716;Trungy;214;3;217
28;Normandie;14;2;22;719;Urville;680;7;687
28;Normandie;14;2;13;720;Ussy;864;28;892
28;Normandie;14;2;12;721;Vacognes-Neuilly;629;9;638
28;Normandie;14;4;01;475;Val d'Arry;2305;43;2348
28;Normandie;14;4;01;672;Val de Drôme ;865;15;880
28;Normandie;14;3;18;576;Val-de-Vie;532;13;545
28;Normandie;14;2;24;005;Valambray;1746;39;1785
28;Normandie;14;4;10;726;Valdallière;5853;118;5971
28;Normandie;14;3;18;570;Valorbiquet;2512;44;2556
28;Normandie;14;3;19;723;Valsemé;273;4;277
28;Normandie;14;3;04;724;Varaville;976;12;988
28;Normandie;14;1;02;728;Vaucelles;509;6;515
28;Normandie;14;3;21;731;Vauville;188;13;201
28;Normandie;14;1;02;732;Vaux-sur-Aure;321;12;333
28;Normandie;14;1;02;733;Vaux-sur-Seulles;309;9;318
28;Normandie;14;1;03;734;Vendes;326;8;334
28;Normandie;14;2;18;735;Vendeuvre;790;11;801
28;Normandie;14;1;11;739;Ver-sur-Mer;1644;36;1680
28;Normandie;14;2;13;737;Versainville;477;8;485
28;Normandie;14;2;05;738;Verson;3649;53;3702
28;Normandie;14;3;18;740;Vespière-Friardel ;1193;18;1211
28;Normandie;14;2;22;741;Le Vey;119;3;122
28;Normandie;14;2;13;742;Vicques;71;0;71
28;Normandie;14;3;19;743;Victot-Pontfol;98;3;101
28;Normandie;14;1;02;744;Vienne-en-Bessin;298;4;302
28;Normandie;14;1;23;745;Vierville-sur-Mer;228;4;232
28;Normandie;14;2;12;747;Vieux;683;8;691
28;Normandie;14;3;21;748;Vieux-Bourg;73;1;74
28;Normandie;14;2;13;751;Vignats;291;9;300
28;Normandie;14;4;01;752;Villers-Bocage;3134;36;3170
28;Normandie;14;2;13;753;Villers-Canivet;750;22;772
28;Normandie;14;3;21;754;Villers-sur-Mer;2593;59;2652
28;Normandie;14;3;15;755;Villerville;594;13;607
28;Normandie;14;4;10;756;La Villette;232;3;235
28;Normandie;14;2;06;758;Villons-les-Buissons;752;24;776
28;Normandie;14;4;01;760;Villy-Bocage;762;6;768
28;Normandie;14;2;13;759;Villy-lez-Falaise;270;10;280
28;Normandie;14;2;24;761;Vimont;781;15;796
28;Normandie;14;4;25;762;Vire Normandie ;16885;889;17774
84;Auvergne-Rhône-Alpes;15;3;07;025;Albepierre-Bredons;243;7;250
84;Auvergne-Rhône-Alpes;15;3;07;001;Allanche;805;9;814
84;Auvergne-Rhône-Alpes;15;3;09;002;Alleuze;219;4;223
84;Auvergne-Rhône-Alpes;15;2;05;003;Ally;599;12;611
84;Auvergne-Rhône-Alpes;15;3;11;004;Andelat;469;9;478
84;Auvergne-Rhône-Alpes;15;3;09;005;Anglards-de-Saint-Flour;352;16;368
84;Auvergne-Rhône-Alpes;15;2;05;006;Anglards-de-Salers;754;28;782
84;Auvergne-Rhône-Alpes;15;3;09;007;Anterrieux;122;7;129
84;Auvergne-Rhône-Alpes;15;2;15;008;Antignac;283;1;284
84;Auvergne-Rhône-Alpes;15;2;10;009;Apchon;186;6;192
84;Auvergne-Rhône-Alpes;15;2;15;010;Arches;185;3;188
84;Auvergne-Rhône-Alpes;15;1;13;011;Arnac;180;3;183
84;Auvergne-Rhône-Alpes;15;1;01;012;Arpajon-sur-Cère;6245;191;6436
84;Auvergne-Rhône-Alpes;15;3;11;013;Auriac-l'Église;148;0;148
84;Auvergne-Rhône-Alpes;15;1;98;014;Aurillac;25531;1291;26822
84;Auvergne-Rhône-Alpes;15;2;10;015;Auzers;166;4;170
84;Auvergne-Rhône-Alpes;15;1;13;016;Ayrens;641;14;655
84;Auvergne-Rhône-Alpes;15;1;14;017;Badailhac;142;6;148
84;Auvergne-Rhône-Alpes;15;2;05;018;Barriac-les-Bosquets;128;1;129
84;Auvergne-Rhône-Alpes;15;2;15;019;Bassignac;235;4;239
84;Auvergne-Rhône-Alpes;15;2;15;020;Beaulieu;95;4;99
84;Auvergne-Rhône-Alpes;15;1;08;269;Besse;128;3;131
84;Auvergne-Rhône-Alpes;15;1;06;021;Boisset;638;16;654
84;Auvergne-Rhône-Alpes;15;3;11;022;Bonnac;164;6;170
84;Auvergne-Rhône-Alpes;15;2;05;024;Brageac;76;0;76
84;Auvergne-Rhône-Alpes;15;3;12;026;Brezons;182;1;183
84;Auvergne-Rhône-Alpes;15;1;14;028;Carlat;354;9;363
84;Auvergne-Rhône-Alpes;15;1;01;029;Cassaniouze;518;16;534
84;Auvergne-Rhône-Alpes;15;1;13;030;Cayrols;294;7;301
84;Auvergne-Rhône-Alpes;15;3;09;032;Celoux;62;3;65
84;Auvergne-Rhône-Alpes;15;3;12;033;Cézens;216;4;220
84;Auvergne-Rhône-Alpes;15;3;09;034;Chaliers;153;6;159
84;Auvergne-Rhône-Alpes;15;2;05;036;Chalvignac;470;8;478
84;Auvergne-Rhône-Alpes;15;2;15;037;Champagnac;1071;25;1096
84;Auvergne-Rhône-Alpes;15;2;15;038;Champs-sur-Tarentaine-Marchal;1046;25;1071
84;Auvergne-Rhône-Alpes;15;3;10;040;Chanterelle;96;7;103
84;Auvergne-Rhône-Alpes;15;3;07;041;La Chapelle-d'Alagnon;250;5;255
84;Auvergne-Rhône-Alpes;15;3;11;042;La Chapelle-Laurent;257;4;261
84;Auvergne-Rhône-Alpes;15;3;07;043;Charmensac;86;2;88
84;Auvergne-Rhône-Alpes;15;3;09;045;Chaudes-Aigues;863;12;875
84;Auvergne-Rhône-Alpes;15;2;05;046;Chaussenac;219;3;222
84;Auvergne-Rhône-Alpes;15;3;09;048;Chazelles;32;1;33
84;Auvergne-Rhône-Alpes;15;3;07;049;Cheylade;221;5;226
84;Auvergne-Rhône-Alpes;15;3;07;050;Le Claux;175;2;177
84;Auvergne-Rhône-Alpes;15;3;09;051;Clavières;208;5;213
84;Auvergne-Rhône-Alpes;15;2;10;052;Collandres;155;12;167
84;Auvergne-Rhône-Alpes;15;3;11;053;Coltines;447;10;457
84;Auvergne-Rhône-Alpes;15;3;10;054;Condat;992;24;1016
84;Auvergne-Rhône-Alpes;15;3;11;055;Coren;440;12;452
84;Auvergne-Rhône-Alpes;15;1;08;056;Crandelles;850;20;870
84;Auvergne-Rhône-Alpes;15;1;13;057;Cros-de-Montvert;191;4;195
84;Auvergne-Rhône-Alpes;15;1;14;058;Cros-de-Ronesque;145;0;145
84;Auvergne-Rhône-Alpes;15;3;12;059;Cussac;124;7;131
84;Auvergne-Rhône-Alpes;15;3;09;060;Deux-Verges;49;1;50
84;Auvergne-Rhône-Alpes;15;3;07;061;Dienne;272;4;276
84;Auvergne-Rhône-Alpes;15;2;05;063;Drugeac;340;14;354
84;Auvergne-Rhône-Alpes;15;2;05;064;Escorailles;80;1;81
84;Auvergne-Rhône-Alpes;15;3;09;065;Espinasse;80;1;81
84;Auvergne-Rhône-Alpes;15;2;10;066;Le Falgoux;116;2;118
84;Auvergne-Rhône-Alpes;15;2;05;067;Le Fau;28;1;29
84;Auvergne-Rhône-Alpes;15;3;11;069;Ferrières-Saint-Mary;246;2;248
84;Auvergne-Rhône-Alpes;15;2;05;070;Fontanges;199;3;202
84;Auvergne-Rhône-Alpes;15;1;08;072;Freix-Anglards;219;6;225
84;Auvergne-Rhône-Alpes;15;3;09;073;Fridefont;97;2;99
84;Auvergne-Rhône-Alpes;15;1;14;074;Giou-de-Mamou;774;21;795
84;Auvergne-Rhône-Alpes;15;1;08;075;Girgols;75;4;79
84;Auvergne-Rhône-Alpes;15;1;13;076;Glénat;172;4;176
84;Auvergne-Rhône-Alpes;15;3;12;077;Gourdièges;60;0;60
84;Auvergne-Rhône-Alpes;15;3;09;078;Jabrun;152;2;154
84;Auvergne-Rhône-Alpes;15;2;15;079;Jaleyrac;371;9;380
84;Auvergne-Rhône-Alpes;15;1;14;081;Jou-sous-Monjou;100;2;102
84;Auvergne-Rhône-Alpes;15;3;07;080;Joursac;146;4;150
84;Auvergne-Rhône-Alpes;15;1;01;082;Junhac;299;11;310
84;Auvergne-Rhône-Alpes;15;1;08;083;Jussac;2021;67;2088
84;Auvergne-Rhône-Alpes;15;1;01;084;Labesserette;294;9;303
84;Auvergne-Rhône-Alpes;15;1;14;085;Labrousse;504;12;516
84;Auvergne-Rhône-Alpes;15;3;12;086;Lacapelle-Barrès;58;2;60
84;Auvergne-Rhône-Alpes;15;1;01;087;Lacapelle-del-Fraisse;352;10;362
84;Auvergne-Rhône-Alpes;15;1;13;088;Lacapelle-Viescamp;515;15;530
84;Auvergne-Rhône-Alpes;15;1;01;089;Ladinhac;458;8;466
84;Auvergne-Rhône-Alpes;15;1;01;090;Lafeuillade-en-Vézie;593;15;608
84;Auvergne-Rhône-Alpes;15;3;07;091;Landeyrat;89;5;94
84;Auvergne-Rhône-Alpes;15;2;15;092;Lanobre;1413;41;1454
84;Auvergne-Rhône-Alpes;15;1;01;093;Lapeyrugue;100;3;103
84;Auvergne-Rhône-Alpes;15;1;13;094;Laroquebrou;855;17;872
84;Auvergne-Rhône-Alpes;15;1;08;095;Laroquevieille;357;3;360
84;Auvergne-Rhône-Alpes;15;1;14;096;Lascelle;292;7;299
84;Auvergne-Rhône-Alpes;15;3;11;097;Lastic;117;5;122
84;Auvergne-Rhône-Alpes;15;3;11;098;Laurie;93;0;93
84;Auvergne-Rhône-Alpes;15;3;07;100;Laveissenet;130;2;132
84;Auvergne-Rhône-Alpes;15;3;07;101;Laveissière;514;14;528
84;Auvergne-Rhône-Alpes;15;3;07;102;Lavigerie;107;0;107
84;Auvergne-Rhône-Alpes;15;1;01;103;Leucamp;235;6;241
84;Auvergne-Rhône-Alpes;15;1;06;104;Leynhac;346;9;355
84;Auvergne-Rhône-Alpes;15;3;11;105;Leyvaux;36;3;39
84;Auvergne-Rhône-Alpes;15;3;09;106;Lieutadès;159;2;161
84;Auvergne-Rhône-Alpes;15;3;09;107;Lorcières;172;4;176
84;Auvergne-Rhône-Alpes;15;3;10;110;Lugarde;137;6;143
84;Auvergne-Rhône-Alpes;15;2;15;111;Madic;208;7;215
84;Auvergne-Rhône-Alpes;15;3;12;112;Malbo;94;4;98
84;Auvergne-Rhône-Alpes;15;1;14;113;Mandailles-Saint-Julien;185;4;189
84;Auvergne-Rhône-Alpes;15;3;10;114;Marcenat;520;7;527
84;Auvergne-Rhône-Alpes;15;3;10;116;Marchastel;154;11;165
84;Auvergne-Rhône-Alpes;15;1;06;117;Marcolès;597;68;665
84;Auvergne-Rhône-Alpes;15;1;08;118;Marmanhac;729;31;760
84;Auvergne-Rhône-Alpes;15;3;11;119;Massiac;1771;69;1840
84;Auvergne-Rhône-Alpes;15;2;05;120;Mauriac;3550;229;3779
84;Auvergne-Rhône-Alpes;15;3;09;121;Maurines;109;1;110
84;Auvergne-Rhône-Alpes;15;1;06;122;Maurs;2128;67;2195
84;Auvergne-Rhône-Alpes;15;2;10;123;Méallet;167;2;169
84;Auvergne-Rhône-Alpes;15;2;10;124;Menet;544;23;567
84;Auvergne-Rhône-Alpes;15;3;11;125;Mentières;127;3;130
84;Auvergne-Rhône-Alpes;15;3;11;126;Molèdes;87;2;89
84;Auvergne-Rhône-Alpes;15;3;11;127;Molompize;284;3;287
84;Auvergne-Rhône-Alpes;15;2;15;128;La Monselie;116;3;119
84;Auvergne-Rhône-Alpes;15;3;10;129;Montboudif;182;6;188
84;Auvergne-Rhône-Alpes;15;3;11;130;Montchamp;137;4;141
84;Auvergne-Rhône-Alpes;15;2;15;131;Le Monteil;285;12;297
84;Auvergne-Rhône-Alpes;15;3;10;132;Montgreleix;45;0;45
84;Auvergne-Rhône-Alpes;15;1;06;133;Montmurat;135;1;136
84;Auvergne-Rhône-Alpes;15;1;01;134;Montsalvy;814;12;826
84;Auvergne-Rhône-Alpes;15;1;13;135;Montvert;117;6;123
84;Auvergne-Rhône-Alpes;15;2;10;137;Moussages;272;7;279
84;Auvergne-Rhône-Alpes;15;3;07;138;Murat ;1855;99;1954
84;Auvergne-Rhône-Alpes;15;3;12;139;Narnhac;70;0;70
84;Auvergne-Rhône-Alpes;15;1;08;140;Naucelles;2052;57;2109
84;Auvergne-Rhône-Alpes;15;3;07;141;Neussargues en Pinatelle ;1811;30;1841
84;Auvergne-Rhône-Alpes;15;3;09;142;Neuvéglise-sur-Truyère ;1744;40;1784
84;Auvergne-Rhône-Alpes;15;1;13;143;Nieudan;103;1;104
84;Auvergne-Rhône-Alpes;15;1;13;144;Omps;334;10;344
84;Auvergne-Rhône-Alpes;15;1;14;146;Pailherols;126;5;131
84;Auvergne-Rhône-Alpes;15;1;13;147;Parlan;444;9;453
84;Auvergne-Rhône-Alpes;15;3;12;148;Paulhac;423;11;434
84;Auvergne-Rhône-Alpes;15;3;12;149;Paulhenc;255;3;258
84;Auvergne-Rhône-Alpes;15;3;07;151;Peyrusse;152;0;152
84;Auvergne-Rhône-Alpes;15;3;12;152;Pierrefort;891;18;909
84;Auvergne-Rhône-Alpes;15;2;05;153;Pleaux;1475;36;1511
84;Auvergne-Rhône-Alpes;15;1;14;154;Polminhac;1176;24;1200
84;Auvergne-Rhône-Alpes;15;3;07;155;Pradiers;88;2;90
84;Auvergne-Rhône-Alpes;15;1;01;156;Prunet;678;15;693
84;Auvergne-Rhône-Alpes;15;1;06;027;Puycapel ;753;14;767
84;Auvergne-Rhône-Alpes;15;1;06;157;Quézac;348;43;391
84;Auvergne-Rhône-Alpes;15;3;09;158;Rageade;102;2;104
84;Auvergne-Rhône-Alpes;15;1;14;159;Raulhac;268;8;276
84;Auvergne-Rhône-Alpes;15;1;08;160;Reilhac;1100;22;1122
84;Auvergne-Rhône-Alpes;15;3;11;161;Rézentières;109;2;111
84;Auvergne-Rhône-Alpes;15;2;10;162;Riom-ès-Montagnes;2491;62;2553
84;Auvergne-Rhône-Alpes;15;1;06;163;Roannes-Saint-Mary;1096;31;1127
84;Auvergne-Rhône-Alpes;15;3;11;164;Roffiac;618;18;636
84;Auvergne-Rhône-Alpes;15;1;13;165;Rouffiac;204;3;207
84;Auvergne-Rhône-Alpes;15;1;13;268;Le Rouget-Pers;1237;26;1263
84;Auvergne-Rhône-Alpes;15;1;13;166;Roumégoux;311;10;321
84;Auvergne-Rhône-Alpes;15;1;06;167;Rouziers;119;8;127
84;Auvergne-Rhône-Alpes;15;3;09;168;Ruynes-en-Margeride;711;25;736
84;Auvergne-Rhône-Alpes;15;2;15;169;Saignes;828;16;844
84;Auvergne-Rhône-Alpes;15;3;10;170;Saint-Amandin;231;4;235
84;Auvergne-Rhône-Alpes;15;1;06;172;Saint-Antoine;99;1;100
84;Auvergne-Rhône-Alpes;15;3;10;173;Saint-Bonnet-de-Condat;116;5;121
84;Auvergne-Rhône-Alpes;15;2;05;174;Saint-Bonnet-de-Salers;274;6;280
84;Auvergne-Rhône-Alpes;15;1;08;175;Saint-Cernin;1072;27;1099
84;Auvergne-Rhône-Alpes;15;2;08;176;Saint-Chamant;240;9;249
84;Auvergne-Rhône-Alpes;15;1;14;178;Saint-Cirgues-de-Jordanne;141;7;148
84;Auvergne-Rhône-Alpes;15;1;08;179;Saint-Cirgues-de-Malbert;249;4;253
84;Auvergne-Rhône-Alpes;15;1;14;180;Saint-Clément;75;3;78
84;Auvergne-Rhône-Alpes;15;1;06;181;Saint-Constant-Fournoulès;591;11;602
84;Auvergne-Rhône-Alpes;15;1;13;182;Saint-Étienne-Cantalès;138;3;141
84;Auvergne-Rhône-Alpes;15;1;14;183;Saint-Étienne-de-Carlat;134;0;134
84;Auvergne-Rhône-Alpes;15;2;10;185;Saint-Étienne-de-Chomeil;236;11;247
84;Auvergne-Rhône-Alpes;15;1;06;184;Saint-Étienne-de-Maurs;785;19;804
84;Auvergne-Rhône-Alpes;15;3;99;187;Saint-Flour;6365;542;6907
84;Auvergne-Rhône-Alpes;15;3;09;188;Saint-Georges;1183;30;1213
84;Auvergne-Rhône-Alpes;15;1;13;189;Saint-Gérons;219;7;226
84;Auvergne-Rhône-Alpes;15;2;10;190;Saint-Hippolyte;110;3;113
84;Auvergne-Rhône-Alpes;15;1;08;191;Saint-Illide;650;9;659
84;Auvergne-Rhône-Alpes;15;1;14;192;Saint-Jacques-des-Blats;312;4;316
84;Auvergne-Rhône-Alpes;15;1;06;194;Saint-Julien-de-Toursac;108;6;114
84;Auvergne-Rhône-Alpes;15;1;06;196;Saint-Mamet-la-Salvetat;1549;52;1601
84;Auvergne-Rhône-Alpes;15;3;09;199;Saint-Martial;78;0;78
84;Auvergne-Rhône-Alpes;15;2;05;200;Saint-Martin-Cantalès;146;3;149
84;Auvergne-Rhône-Alpes;15;3;12;201;Saint-Martin-sous-Vigouroux;229;3;232
84;Auvergne-Rhône-Alpes;15;2;05;202;Saint-Martin-Valmeroux;727;17;744
84;Auvergne-Rhône-Alpes;15;3;11;203;Saint-Mary-le-Plain;166;3;169
84;Auvergne-Rhône-Alpes;15;2;05;205;Saint-Paul-de-Salers;105;5;110
84;Auvergne-Rhône-Alpes;15;1;13;204;Saint-Paul-des-Landes;1531;42;1573
84;Auvergne-Rhône-Alpes;15;2;15;206;Saint-Pierre;138;2;140
84;Auvergne-Rhône-Alpes;15;3;11;207;Saint-Poncy;358;12;370
84;Auvergne-Rhône-Alpes;15;2;08;208;Saint-Projet-de-Salers;136;4;140
84;Auvergne-Rhône-Alpes;15;3;09;209;Saint-Rémy-de-Chaudes-Aigues;122;5;127
84;Auvergne-Rhône-Alpes;15;1;13;211;Saint-Santin-Cantalès;303;5;308
84;Auvergne-Rhône-Alpes;15;1;06;212;Saint-Santin-de-Maurs;362;15;377
84;Auvergne-Rhône-Alpes;15;3;07;213;Saint-Saturnin;204;4;208
84;Auvergne-Rhône-Alpes;15;1;13;214;Saint-Saury;181;5;186
84;Auvergne-Rhône-Alpes;15;1;14;215;Saint-Simon;1127;37;1164
84;Auvergne-Rhône-Alpes;15;3;09;216;Saint-Urcize;409;14;423
84;Auvergne-Rhône-Alpes;15;1;13;217;Saint-Victor;107;3;110
84;Auvergne-Rhône-Alpes;15;2;10;218;Saint-Vincent-de-Salers;67;2;69
84;Auvergne-Rhône-Alpes;15;2;05;186;Sainte-Eulalie;227;3;230
84;Auvergne-Rhône-Alpes;15;3;12;198;Sainte-Marie;107;1;108
84;Auvergne-Rhône-Alpes;15;2;05;219;Salers;328;5;333
84;Auvergne-Rhône-Alpes;15;2;05;220;Salins;145;2;147
84;Auvergne-Rhône-Alpes;15;1;06;221;Sansac-de-Marmiesse;1362;33;1395
84;Auvergne-Rhône-Alpes;15;1;01;222;Sansac-Veinazès;217;10;227
84;Auvergne-Rhône-Alpes;15;2;15;223;Sauvat;214;6;220
84;Auvergne-Rhône-Alpes;15;1;13;224;La Ségalassière;127;12;139
84;Auvergne-Rhône-Alpes;15;3;07;225;Ségur-les-Villas;207;4;211
84;Auvergne-Rhône-Alpes;15;1;01;226;Sénezergues;199;4;203
84;Auvergne-Rhône-Alpes;15;1;13;228;Siran;470;10;480
84;Auvergne-Rhône-Alpes;15;3;09;229;Soulages;80;2;82
84;Auvergne-Rhône-Alpes;15;2;15;230;Sourniac;199;9;208
84;Auvergne-Rhône-Alpes;15;3;11;231;Talizat;589;20;609
84;Auvergne-Rhône-Alpes;15;3;12;232;Tanavelle;229;7;236
84;Auvergne-Rhône-Alpes;15;1;08;233;Teissières-de-Cornet;297;5;302
84;Auvergne-Rhône-Alpes;15;1;14;234;Teissières-lès-Bouliès;329;6;335
84;Auvergne-Rhône-Alpes;15;3;12;235;Les Ternes;579;23;602
84;Auvergne-Rhône-Alpes;15;1;14;236;Thiézac;601;14;615
84;Auvergne-Rhône-Alpes;15;3;11;237;Tiviers;174;6;180
84;Auvergne-Rhône-Alpes;15;1;08;238;Tournemire;128;3;131
84;Auvergne-Rhône-Alpes;15;2;15;240;Trémouille;174;7;181
84;Auvergne-Rhône-Alpes;15;3;09;241;La Trinitat;48;3;51
84;Auvergne-Rhône-Alpes;15;1;06;242;Le Trioulou;101;3;104
84;Auvergne-Rhône-Alpes;15;2;10;243;Trizac;507;9;516
84;Auvergne-Rhône-Alpes;15;3;07;244;Ussel;476;10;486
84;Auvergne-Rhône-Alpes;15;3;09;245;Vabres;251;4;255
84;Auvergne-Rhône-Alpes;15;3;09;108;Val d'Arcomie;989;23;1012
84;Auvergne-Rhône-Alpes;15;2;10;246;Valette;232;2;234
84;Auvergne-Rhône-Alpes;15;3;11;247;Valjouze;24;0;24
84;Auvergne-Rhône-Alpes;15;3;12;248;Valuéjols;564;12;576
84;Auvergne-Rhône-Alpes;15;2;10;249;Le Vaulmier;67;2;69
84;Auvergne-Rhône-Alpes;15;2;15;250;Vebret;508;17;525
84;Auvergne-Rhône-Alpes;15;3;09;251;Védrines-Saint-Loup;140;6;146
84;Auvergne-Rhône-Alpes;15;1;14;252;Velzic;421;18;439
84;Auvergne-Rhône-Alpes;15;3;07;253;Vernols;64;1;65
84;Auvergne-Rhône-Alpes;15;2;15;254;Veyrières;116;2;118
84;Auvergne-Rhône-Alpes;15;1;14;255;Vézac;1229;34;1263
84;Auvergne-Rhône-Alpes;15;3;07;256;Vèze;54;5;59
84;Auvergne-Rhône-Alpes;15;1;14;257;Vezels-Roussy;127;4;131
84;Auvergne-Rhône-Alpes;15;1;14;258;Vic-sur-Cère;1829;35;1864
84;Auvergne-Rhône-Alpes;15;3;11;259;Vieillespesse;245;3;248
84;Auvergne-Rhône-Alpes;15;1;01;260;Vieillevie;110;4;114
84;Auvergne-Rhône-Alpes;15;2;05;261;Le Vigean;824;21;845
84;Auvergne-Rhône-Alpes;15;3;12;262;Villedieu;563;11;574
84;Auvergne-Rhône-Alpes;15;3;07;263;Virargues;128;5;133
84;Auvergne-Rhône-Alpes;15;1;06;264;Vitrac;269;6;275
84;Auvergne-Rhône-Alpes;15;2;15;265;Ydes;1660;28;1688
84;Auvergne-Rhône-Alpes;15;1;14;266;Yolet;547;10;557
84;Auvergne-Rhône-Alpes;15;1;02;267;Ytrac;4315;104;4419
75;Nouvelle-Aquitaine;16;3;10;001;Abzac;493;1;494
75;Nouvelle-Aquitaine;16;3;08;002;Les Adjots;522;8;530
75;Nouvelle-Aquitaine;16;1;19;003;Agris;854;10;864
75;Nouvelle-Aquitaine;16;3;08;005;Aigre ;1585;39;1624
75;Nouvelle-Aquitaine;16;3;06;007;Alloue;465;11;476
75;Nouvelle-Aquitaine;16;3;05;008;Ambérac;315;2;317
75;Nouvelle-Aquitaine;16;3;10;009;Ambernac;374;6;380
75;Nouvelle-Aquitaine;16;2;07;010;Ambleville;173;4;177
75;Nouvelle-Aquitaine;16;3;05;011;Anais;574;21;595
75;Nouvelle-Aquitaine;16;2;07;012;Angeac-Champagne;507;9;516
75;Nouvelle-Aquitaine;16;2;07;013;Angeac-Charente;324;8;332
75;Nouvelle-Aquitaine;16;2;09;014;Angeduc;127;0;127
75;Nouvelle-Aquitaine;16;1;98;015;Angoulême;41711;1685;43396
75;Nouvelle-Aquitaine;16;3;10;016;Ansac-sur-Vienne;827;23;850
75;Nouvelle-Aquitaine;16;2;12;018;Ars;714;18;732
75;Nouvelle-Aquitaine;16;1;18;019;Asnières-sur-Nouère;1233;23;1256
75;Nouvelle-Aquitaine;16;1;17;020;Aubeterre-sur-Dronne;364;5;369
75;Nouvelle-Aquitaine;16;3;05;023;Aunac-sur-Charente;605;12;617
75;Nouvelle-Aquitaine;16;3;05;024;Aussac-Vadalle;511;9;520
75;Nouvelle-Aquitaine;16;2;09;025;Baignes-Sainte-Radegonde;1238;31;1269
75;Nouvelle-Aquitaine;16;1;14;026;Balzac;1348;27;1375
75;Nouvelle-Aquitaine;16;3;08;027;Barbezières;126;3;129
75;Nouvelle-Aquitaine;16;2;09;028;Barbezieux-Saint-Hilaire;4678;180;4858
75;Nouvelle-Aquitaine;16;1;17;029;Bardenac;227;5;232
75;Nouvelle-Aquitaine;16;2;09;030;Barret;1040;22;1062
75;Nouvelle-Aquitaine;16;3;08;031;Barro;411;11;422
75;Nouvelle-Aquitaine;16;2;15;032;Bassac;516;7;523
75;Nouvelle-Aquitaine;16;1;17;034;Bazac;144;2;146
75;Nouvelle-Aquitaine;16;3;06;035;Beaulieu-sur-Sonnette;203;5;208
75;Nouvelle-Aquitaine;16;2;09;036;Bécheresse;289;9;298
75;Nouvelle-Aquitaine;16;2;07;204;Bellevigne;1313;36;1349
75;Nouvelle-Aquitaine;16;1;17;037;Bellon;148;5;153
75;Nouvelle-Aquitaine;16;3;06;038;Benest;311;8;319
75;Nouvelle-Aquitaine;16;3;08;039;Bernac;481;12;493
75;Nouvelle-Aquitaine;16;2;09;040;Berneuil;311;6;317
75;Nouvelle-Aquitaine;16;1;17;041;Bessac;109;1;110
75;Nouvelle-Aquitaine;16;3;08;042;Bessé;112;7;119
75;Nouvelle-Aquitaine;16;3;08;044;Bioussac;221;7;228
75;Nouvelle-Aquitaine;16;2;07;045;Birac;364;6;370
75;Nouvelle-Aquitaine;16;1;17;047;Blanzaguet-Saint-Cybard;294;6;300
75;Nouvelle-Aquitaine;16;2;09;048;Boisbreteau;133;0;133
75;Nouvelle-Aquitaine;16;1;17;082;Boisné-La Tude;679;12;691
75;Nouvelle-Aquitaine;16;1;17;049;Bonnes;391;8;399
75;Nouvelle-Aquitaine;16;2;07;050;Bonneuil;256;8;264
75;Nouvelle-Aquitaine;16;2;09;053;Bors (Canton de Charente-Sud);117;1;118
75;Nouvelle-Aquitaine;16;1;17;052;Bors (Canton de Tude-et-Lavalette);257;3;260
75;Nouvelle-Aquitaine;16;3;06;054;Le Bouchage;172;1;173
75;Nouvelle-Aquitaine;16;1;04;055;Bouëx;893;11;904
75;Nouvelle-Aquitaine;16;2;15;056;Bourg-Charente;897;18;915
75;Nouvelle-Aquitaine;16;2;07;057;Bouteville;321;6;327
75;Nouvelle-Aquitaine;16;2;11;058;Boutiers-Saint-Trojan;1419;51;1470
75;Nouvelle-Aquitaine;16;3;08;059;Brettes;175;5;180
75;Nouvelle-Aquitaine;16;2;11;060;Bréville;462;13;475
75;Nouvelle-Aquitaine;16;1;16;061;Brie;4227;81;4308
75;Nouvelle-Aquitaine;16;2;09;062;Brie-sous-Barbezieux;132;1;133
75;Nouvelle-Aquitaine;16;1;17;063;Brie-sous-Chalais;156;0;156
75;Nouvelle-Aquitaine;16;3;10;064;Brigueuil;1103;17;1120
75;Nouvelle-Aquitaine;16;3;10;065;Brillac;618;6;624
75;Nouvelle-Aquitaine;16;2;09;066;Brossac;475;8;483
75;Nouvelle-Aquitaine;16;1;19;067;Bunzac;467;10;477
75;Nouvelle-Aquitaine;16;3;05;068;Cellefrouin;568;6;574
75;Nouvelle-Aquitaine;16;3;05;069;Cellettes;392;3;395
75;Nouvelle-Aquitaine;16;3;10;070;Chabanais;1610;33;1643
75;Nouvelle-Aquitaine;16;3;10;071;Chabrac;580;16;596
75;Nouvelle-Aquitaine;16;1;17;072;Chadurie;508;10;518
75;Nouvelle-Aquitaine;16;1;17;073;Chalais;1768;31;1799
75;Nouvelle-Aquitaine;16;2;09;074;Challignac;329;8;337
75;Nouvelle-Aquitaine;16;3;06;076;Champagne-Mouton;878;9;887
75;Nouvelle-Aquitaine;16;2;09;075;Champagne-Vigny;243;3;246
75;Nouvelle-Aquitaine;16;2;18;077;Champmillon;492;9;501
75;Nouvelle-Aquitaine;16;1;14;078;Champniers;5149;117;5266
75;Nouvelle-Aquitaine;16;2;09;079;Chantillac;342;3;345
75;Nouvelle-Aquitaine;16;3;05;081;La Chapelle;214;5;219
75;Nouvelle-Aquitaine;16;3;08;083;Charmé;347;6;353
75;Nouvelle-Aquitaine;16;1;19;084;Charras;334;3;337
75;Nouvelle-Aquitaine;16;3;06;085;Chasseneuil-sur-Bonnieure;3065;264;3329
75;Nouvelle-Aquitaine;16;3;10;086;Chassenon;870;17;887
75;Nouvelle-Aquitaine;16;3;06;087;Chassiecq;142;2;144
75;Nouvelle-Aquitaine;16;2;15;088;Chassors;1097;37;1134
75;Nouvelle-Aquitaine;16;2;12;089;Châteaubernard;3738;65;3803
75;Nouvelle-Aquitaine;16;2;07;090;Châteauneuf-sur-Charente;3541;63;3604
75;Nouvelle-Aquitaine;16;1;17;091;Châtignac;173;2;175
75;Nouvelle-Aquitaine;16;1;19;093;Chazelles;1581;25;1606
75;Nouvelle-Aquitaine;16;3;05;095;Chenon;132;4;136
75;Nouvelle-Aquitaine;16;3;06;096;Cherves-Châtelars;416;3;419
75;Nouvelle-Aquitaine;16;2;11;097;Cherves-Richemont;2302;100;2402
75;Nouvelle-Aquitaine;16;3;08;098;La Chèvrerie;140;2;142
75;Nouvelle-Aquitaine;16;2;09;099;Chillac;221;2;223
75;Nouvelle-Aquitaine;16;3;10;100;Chirac;759;14;773
75;Nouvelle-Aquitaine;16;1;04;101;Claix;1041;18;1059
75;Nouvelle-Aquitaine;16;2;99;102;Cognac;18628;434;19062
75;Nouvelle-Aquitaine;16;1;17;103;Combiers;123;5;128
75;Nouvelle-Aquitaine;16;3;08;104;Condac;470;9;479
75;Nouvelle-Aquitaine;16;2;09;105;Condéon;614;5;619
75;Nouvelle-Aquitaine;16;3;10;106;Confolens;2673;154;2827
75;Nouvelle-Aquitaine;16;2;09;046;Coteaux-du-Blanzacais ;1018;12;1030
75;Nouvelle-Aquitaine;16;1;19;107;Coulgens;535;6;541
75;Nouvelle-Aquitaine;16;3;05;108;Coulonges;132;1;133
75;Nouvelle-Aquitaine;16;2;18;109;Courbillac;747;8;755
75;Nouvelle-Aquitaine;16;3;08;110;Courcôme ;778;21;799
75;Nouvelle-Aquitaine;16;1;17;111;Courgeac;179;3;182
75;Nouvelle-Aquitaine;16;1;17;112;Courlac;56;2;58
75;Nouvelle-Aquitaine;16;1;13;113;La Couronne;7759;259;8018
75;Nouvelle-Aquitaine;16;3;08;114;Couture;162;3;165
75;Nouvelle-Aquitaine;16;2;07;116;Criteuil-la-Magdeleine;397;9;406
75;Nouvelle-Aquitaine;16;1;17;117;Curac;123;3;126
75;Nouvelle-Aquitaine;16;1;17;118;Deviat;140;0;140
75;Nouvelle-Aquitaine;16;1;04;119;Dignac;1339;15;1354
75;Nouvelle-Aquitaine;16;1;04;120;Dirac;1519;21;1540
75;Nouvelle-Aquitaine;16;2;18;121;Douzat;454;13;467
75;Nouvelle-Aquitaine;16;3;08;122;Ébréon;141;4;145
75;Nouvelle-Aquitaine;16;2;18;123;Échallat;492;10;502
75;Nouvelle-Aquitaine;16;1;19;124;Écuras;576;10;586
75;Nouvelle-Aquitaine;16;1;17;125;Édon;257;3;260
75;Nouvelle-Aquitaine;16;3;08;127;Empuré;99;3;102
75;Nouvelle-Aquitaine;16;3;10;128;Épenède;180;6;186
75;Nouvelle-Aquitaine;16;1;17;130;Les Essards;190;7;197
75;Nouvelle-Aquitaine;16;3;10;131;Esse;497;7;504
75;Nouvelle-Aquitaine;16;3;10;132;Étagnac;991;9;1000
75;Nouvelle-Aquitaine;16;2;09;133;Étriac;199;3;202
75;Nouvelle-Aquitaine;16;3;10;134;Exideuil-sur-Vienne;1014;27;1041
75;Nouvelle-Aquitaine;16;1;19;135;Eymouthiers;308;4;312
75;Nouvelle-Aquitaine;16;3;08;136;La Faye;576;12;588
75;Nouvelle-Aquitaine;16;1;19;137;Feuillade;310;6;316
75;Nouvelle-Aquitaine;16;1;01;138;Fléac;3772;103;3875
75;Nouvelle-Aquitaine;16;2;15;139;Fleurac;238;2;240
75;Nouvelle-Aquitaine;16;3;05;140;Fontclaireau;437;15;452
75;Nouvelle-Aquitaine;16;3;05;141;Fontenille;321;12;333
75;Nouvelle-Aquitaine;16;3;08;142;La Forêt-de-Tessé;194;4;198
75;Nouvelle-Aquitaine;16;1;17;143;Fouquebrune;693;13;706
75;Nouvelle-Aquitaine;16;3;08;144;Fouqueure;414;6;420
75;Nouvelle-Aquitaine;16;2;15;145;Foussignac;635;19;654
75;Nouvelle-Aquitaine;16;1;04;146;Garat;2094;35;2129
75;Nouvelle-Aquitaine;16;1;17;147;Gardes-le-Pontaroux;269;6;275
75;Nouvelle-Aquitaine;16;2;18;148;Genac-Bignac ;1002;14;1016
75;Nouvelle-Aquitaine;16;2;07;150;Gensac-la-Pallue;1540;41;1581
75;Nouvelle-Aquitaine;16;2;07;151;Genté;885;21;906
75;Nouvelle-Aquitaine;16;2;12;152;Gimeux;719;20;739
75;Nouvelle-Aquitaine;16;1;14;154;Gond-Pontouvre;6057;114;6171
75;Nouvelle-Aquitaine;16;3;08;155;Les Gours;109;1;110
75;Nouvelle-Aquitaine;16;3;06;157;Le Grand-Madieu;168;3;171
75;Nouvelle-Aquitaine;16;1;19;158;Grassac;315;5;320
75;Nouvelle-Aquitaine;16;2;07;297;Graves-Saint-Amant;332;12;344
75;Nouvelle-Aquitaine;16;2;09;160;Guimps;480;7;487
75;Nouvelle-Aquitaine;16;2;09;161;Guizengeard;167;3;170
75;Nouvelle-Aquitaine;16;1;17;162;Gurat;181;0;181
75;Nouvelle-Aquitaine;16;2;18;163;Hiersac;1137;21;1158
75;Nouvelle-Aquitaine;16;3;10;164;Hiesse;243;2;245
75;Nouvelle-Aquitaine;16;2;15;165;Houlette;368;4;372
75;Nouvelle-Aquitaine;16;1;02;166;L' Isle-d'Espagnac;5592;151;5743
75;Nouvelle-Aquitaine;16;2;15;167;Jarnac;4411;133;4544
75;Nouvelle-Aquitaine;16;1;16;168;Jauldes;812;8;820
75;Nouvelle-Aquitaine;16;2;12;169;Javrezac;571;8;579
75;Nouvelle-Aquitaine;16;1;17;170;Juignac;404;2;406
75;Nouvelle-Aquitaine;16;2;07;171;Juillac-le-Coq;650;13;663
75;Nouvelle-Aquitaine;16;3;05;173;Juillé;184;4;188
75;Nouvelle-Aquitaine;16;2;15;174;Julienne;505;11;516
75;Nouvelle-Aquitaine;16;2;09;176;Lachaise;307;7;314
75;Nouvelle-Aquitaine;16;2;09;177;Ladiville;121;2;123
75;Nouvelle-Aquitaine;16;2;09;178;Lagarde-sur-le-Né;187;5;192
75;Nouvelle-Aquitaine;16;1;17;180;Laprade;247;6;253
75;Nouvelle-Aquitaine;16;3;06;183;Lésignac-Durand;182;4;186
75;Nouvelle-Aquitaine;16;3;10;181;Lessac;525;11;536
75;Nouvelle-Aquitaine;16;3;10;182;Lesterps;462;13;475
75;Nouvelle-Aquitaine;16;3;05;184;Lichères;87;1;88
75;Nouvelle-Aquitaine;16;3;08;185;Ligné;157;2;159
75;Nouvelle-Aquitaine;16;2;07;186;Lignières-Sonneville;568;18;586
75;Nouvelle-Aquitaine;16;1;18;187;Linars;2063;46;2109
75;Nouvelle-Aquitaine;16;3;06;188;Le Lindois;343;4;347
75;Nouvelle-Aquitaine;16;3;08;189;Londigny;252;6;258
75;Nouvelle-Aquitaine;16;3;08;190;Longré;187;6;193
75;Nouvelle-Aquitaine;16;3;05;191;Lonnes;179;1;180
75;Nouvelle-Aquitaine;16;2;11;193;Louzac-Saint-André;991;17;1008
75;Nouvelle-Aquitaine;16;3;08;194;Lupsault;102;1;103
75;Nouvelle-Aquitaine;16;3;06;195;Lussac;292;7;299
75;Nouvelle-Aquitaine;16;3;05;196;Luxé;725;9;734
75;Nouvelle-Aquitaine;16;3;08;197;La Magdeleine;112;7;119
75;Nouvelle-Aquitaine;16;1;17;198;Magnac-Lavalette-Villars;438;5;443
75;Nouvelle-Aquitaine;16;1;16;199;Magnac-sur-Touvre;3179;68;3247
75;Nouvelle-Aquitaine;16;3;05;200;Maine-de-Boixe;481;4;485
75;Nouvelle-Aquitaine;16;2;15;153;Mainxe-Gondeville;1164;22;1186
75;Nouvelle-Aquitaine;16;1;19;203;Mainzac;112;0;112
75;Nouvelle-Aquitaine;16;3;10;205;Manot;546;5;551
75;Nouvelle-Aquitaine;16;3;05;206;Mansle;1676;17;1693
75;Nouvelle-Aquitaine;16;2;18;207;Marcillac-Lanville;502;9;511
75;Nouvelle-Aquitaine;16;2;18;208;Mareuil;405;4;409
75;Nouvelle-Aquitaine;16;1;19;209;Marillac-le-Franc;824;9;833
75;Nouvelle-Aquitaine;16;1;18;210;Marsac;822;10;832
75;Nouvelle-Aquitaine;16;1;19;211;Marthon;560;6;566
75;Nouvelle-Aquitaine;16;3;06;212;Massignac;393;6;399
75;Nouvelle-Aquitaine;16;3;06;213;Mazerolles;296;5;301
75;Nouvelle-Aquitaine;16;1;17;215;Médillac;157;5;162
75;Nouvelle-Aquitaine;16;2;15;216;Mérignac;842;14;856
75;Nouvelle-Aquitaine;16;2;12;217;Merpins;1103;24;1127
75;Nouvelle-Aquitaine;16;2;11;218;Mesnac;407;12;419
75;Nouvelle-Aquitaine;16;2;15;220;Les Métairies;722;15;737
75;Nouvelle-Aquitaine;16;2;18;221;Mons;244;4;248
75;Nouvelle-Aquitaine;16;1;17;222;Montboyer;331;7;338
75;Nouvelle-Aquitaine;16;1;19;223;Montbron;2017;28;2045
75;Nouvelle-Aquitaine;16;3;06;225;Montembœuf;651;31;682
75;Nouvelle-Aquitaine;16;3;05;226;Montignac-Charente;723;9;732
75;Nouvelle-Aquitaine;16;1;17;227;Montignac-le-Coq;139;0;139
75;Nouvelle-Aquitaine;16;3;08;229;Montjean;239;4;243
75;Nouvelle-Aquitaine;16;2;09;224;Montmérac;716;18;734
75;Nouvelle-Aquitaine;16;1;17;230;Montmoreau ;2573;102;2675
75;Nouvelle-Aquitaine;16;3;10;231;Montrollet;316;2;318
75;Nouvelle-Aquitaine;16;1;16;232;Mornac;2162;50;2212
75;Nouvelle-Aquitaine;16;2;07;233;Mosnac;449;5;454
75;Nouvelle-Aquitaine;16;2;18;234;Moulidars;729;8;737
75;Nouvelle-Aquitaine;16;1;19;406;Moulins-sur-Tardoire ;777;15;792
75;Nouvelle-Aquitaine;16;1;04;236;Mouthiers-sur-Boëme;2416;73;2489
75;Nouvelle-Aquitaine;16;3;05;237;Mouton;225;0;225
75;Nouvelle-Aquitaine;16;3;05;238;Moutonneau;116;0;116
75;Nouvelle-Aquitaine;16;3;06;239;Mouzon;133;2;135
75;Nouvelle-Aquitaine;16;1;17;240;Nabinaud;100;0;100
75;Nouvelle-Aquitaine;16;3;05;241;Nanclars;204;4;208
75;Nouvelle-Aquitaine;16;3;08;242;Nanteuil-en-Vallée;1384;17;1401
75;Nouvelle-Aquitaine;16;2;15;243;Nercillac;1064;21;1085
75;Nouvelle-Aquitaine;16;1;13;244;Nersac;2382;54;2436
75;Nouvelle-Aquitaine;16;3;06;245;Nieuil;933;23;956
75;Nouvelle-Aquitaine;16;1;17;246;Nonac;271;8;279
75;Nouvelle-Aquitaine;16;3;08;248;Oradour;155;1;156
75;Nouvelle-Aquitaine;16;3;10;249;Oradour-Fanais;402;3;405
75;Nouvelle-Aquitaine;16;1;19;250;Orgedeuil;225;2;227
75;Nouvelle-Aquitaine;16;2;09;251;Oriolles;254;6;260
75;Nouvelle-Aquitaine;16;1;17;252;Orival;153;3;156
75;Nouvelle-Aquitaine;16;3;08;253;Paizay-Naudouin-Embourie;362;3;365
75;Nouvelle-Aquitaine;16;1;17;254;Palluaud;224;8;232
75;Nouvelle-Aquitaine;16;3;06;255;Parzac;142;5;147
75;Nouvelle-Aquitaine;16;2;09;256;Passirac;241;11;252
75;Nouvelle-Aquitaine;16;2;09;258;Pérignac;473;9;482
75;Nouvelle-Aquitaine;16;1;17;260;Pillac;269;7;276
75;Nouvelle-Aquitaine;16;3;06;261;Les Pins;469;18;487
75;Nouvelle-Aquitaine;16;1;04;263;Plassac-Rouffiac;403;5;408
75;Nouvelle-Aquitaine;16;3;10;264;Pleuville;333;6;339
75;Nouvelle-Aquitaine;16;1;17;267;Poullignac;88;1;89
75;Nouvelle-Aquitaine;16;3;08;268;Poursac;207;2;209
75;Nouvelle-Aquitaine;16;1;19;269;Pranzac;898;10;908
75;Nouvelle-Aquitaine;16;3;10;270;Pressignac;347;5;352
75;Nouvelle-Aquitaine;16;1;13;271;Puymoyen;2381;145;2526
75;Nouvelle-Aquitaine;16;3;05;272;Puyréaux;537;9;546
75;Nouvelle-Aquitaine;16;3;08;273;Raix;132;6;138
75;Nouvelle-Aquitaine;16;3;08;275;Ranville-Breuillaud;175;2;177
75;Nouvelle-Aquitaine;16;2;09;276;Reignac;753;17;770
75;Nouvelle-Aquitaine;16;2;15;277;Réparsac;597;11;608
75;Nouvelle-Aquitaine;16;1;17;279;Rioux-Martin;229;3;232
75;Nouvelle-Aquitaine;16;1;19;280;Rivières;1998;31;2029
75;Nouvelle-Aquitaine;16;1;19;281;Rochefoucauld-en-Angoumois ;3976;156;4132
75;Nouvelle-Aquitaine;16;1;19;282;La Rochette;533;11;544
75;Nouvelle-Aquitaine;16;1;17;283;Ronsenac;571;7;578
75;Nouvelle-Aquitaine;16;1;17;284;Rouffiac;120;1;121
75;Nouvelle-Aquitaine;16;1;17;285;Rougnac;407;5;412
75;Nouvelle-Aquitaine;16;2;18;286;Rouillac ;2959;49;3008
75;Nouvelle-Aquitaine;16;1;04;287;Roullet-Saint-Estèphe;4251;68;4319
75;Nouvelle-Aquitaine;16;3;06;289;Roussines;287;2;289
75;Nouvelle-Aquitaine;16;1;19;290;Rouzède;242;4;246
75;Nouvelle-Aquitaine;16;1;16;291;Ruelle-sur-Touvre;7246;192;7438
75;Nouvelle-Aquitaine;16;3;08;292;Ruffec;3377;149;3526
75;Nouvelle-Aquitaine;16;1;19;293;Saint-Adjutory;486;7;493
75;Nouvelle-Aquitaine;16;3;05;295;Saint-Amant-de-Boixe;1347;24;1371
75;Nouvelle-Aquitaine;16;2;18;298;Saint-Amant-de-Nouère;388;5;393
75;Nouvelle-Aquitaine;16;2;09;301;Saint-Aulais-la-Chapelle;231;3;234
75;Nouvelle-Aquitaine;16;1;17;302;Saint-Avit;208;2;210
75;Nouvelle-Aquitaine;16;2;09;303;Saint-Bonnet;407;12;419
75;Nouvelle-Aquitaine;16;2;11;304;Saint-Brice;966;35;1001
75;Nouvelle-Aquitaine;16;3;10;306;Saint-Christophe;319;8;327
75;Nouvelle-Aquitaine;16;3;05;307;Saint-Ciers-sur-Bonnieure;333;14;347
75;Nouvelle-Aquitaine;16;3;06;308;Saint-Claud;1056;23;1079
75;Nouvelle-Aquitaine;16;3;06;310;Saint-Coutant;218;2;220
75;Nouvelle-Aquitaine;16;2;18;312;Saint-Cybardeaux;822;13;835
75;Nouvelle-Aquitaine;16;2;09;315;Saint-Félix;109;1;110
75;Nouvelle-Aquitaine;16;2;07;316;Saint-Fort-sur-le-Né;378;6;384
75;Nouvelle-Aquitaine;16;3;08;317;Saint-Fraigne;444;5;449
75;Nouvelle-Aquitaine;16;3;05;318;Saint-Front;367;2;369
75;Nouvelle-Aquitaine;16;2;18;320;Saint-Genis-d'Hiersac;901;17;918
75;Nouvelle-Aquitaine;16;3;08;321;Saint-Georges;50;0;50
75;Nouvelle-Aquitaine;16;1;19;323;Saint-Germain-de-Montbron;475;11;486
75;Nouvelle-Aquitaine;16;3;08;325;Saint-Gourson;136;3;139
75;Nouvelle-Aquitaine;16;3;05;326;Saint-Groux;136;0;136
75;Nouvelle-Aquitaine;16;3;06;329;Saint-Laurent-de-Céris;780;15;795
75;Nouvelle-Aquitaine;16;2;12;330;Saint-Laurent-de-Cognac;827;28;855
75;Nouvelle-Aquitaine;16;1;17;331;Saint-Laurent-des-Combes;90;3;93
75;Nouvelle-Aquitaine;16;1;17;334;Saint-Martial;128;3;131
75;Nouvelle-Aquitaine;16;3;08;335;Saint-Martin-du-Clocher;123;3;126
75;Nouvelle-Aquitaine;16;3;06;336;Saint-Mary;346;3;349
75;Nouvelle-Aquitaine;16;3;10;337;Saint-Maurice-des-Lions;890;30;920
75;Nouvelle-Aquitaine;16;2;09;338;Saint-Médard;322;5;327
75;Nouvelle-Aquitaine;16;2;15;340;Saint-Même-les-Carrières;1050;28;1078
75;Nouvelle-Aquitaine;16;1;13;341;Saint-Michel;3223;39;3262
75;Nouvelle-Aquitaine;16;2;09;342;Saint-Palais-du-Né;294;7;301
75;Nouvelle-Aquitaine;16;2;07;343;Saint-Preuil;295;9;304
75;Nouvelle-Aquitaine;16;1;17;346;Saint-Quentin-de-Chalais;250;8;258
75;Nouvelle-Aquitaine;16;3;10;345;Saint-Quentin-sur-Charente;216;2;218
75;Nouvelle-Aquitaine;16;1;17;347;Saint-Romain;512;12;524
75;Nouvelle-Aquitaine;16;1;18;348;Saint-Saturnin;1294;32;1326
75;Nouvelle-Aquitaine;16;1;17;350;Saint-Séverin;794;10;804
75;Nouvelle-Aquitaine;16;2;07;351;Saint-Simeux;577;12;589
75;Nouvelle-Aquitaine;16;2;07;352;Saint-Simon;209;8;217
75;Nouvelle-Aquitaine;16;1;19;353;Saint-Sornin;794;16;810
75;Nouvelle-Aquitaine;16;2;11;355;Saint-Sulpice-de-Cognac;1206;16;1222
75;Nouvelle-Aquitaine;16;3;08;356;Saint-Sulpice-de-Ruffec;31;0;31
75;Nouvelle-Aquitaine;16;2;09;357;Saint-Vallier;135;2;137
75;Nouvelle-Aquitaine;16;1;14;358;Saint-Yrieix-sur-Charente;7327;235;7562
75;Nouvelle-Aquitaine;16;2;15;349;Sainte-Sévère;516;11;527
75;Nouvelle-Aquitaine;16;2;09;354;Sainte-Souline;118;3;121
75;Nouvelle-Aquitaine;16;2;07;359;Salles-d'Angles;1018;27;1045
75;Nouvelle-Aquitaine;16;2;09;360;Salles-de-Barbezieux;415;88;503
75;Nouvelle-Aquitaine;16;3;08;361;Salles-de-Villefagnan;318;6;324
75;Nouvelle-Aquitaine;16;1;17;362;Salles-Lavalette;339;12;351
75;Nouvelle-Aquitaine;16;3;10;363;Saulgond;530;10;540
75;Nouvelle-Aquitaine;16;3;06;364;Sauvagnac;63;2;65
75;Nouvelle-Aquitaine;16;2;09;365;Sauvignac;106;0;106
75;Nouvelle-Aquitaine;16;2;07;366;Segonzac;2082;77;2159
75;Nouvelle-Aquitaine;16;1;04;368;Sers;879;21;900
75;Nouvelle-Aquitaine;16;2;15;369;Sigogne;988;20;1008
75;Nouvelle-Aquitaine;16;1;18;370;Sireuil;1158;41;1199
75;Nouvelle-Aquitaine;16;1;19;372;Souffrignac;131;2;133
75;Nouvelle-Aquitaine;16;3;08;373;Souvigné;202;6;208
75;Nouvelle-Aquitaine;16;1;03;374;Soyaux;9553;309;9862
75;Nouvelle-Aquitaine;16;3;06;375;Suaux;388;6;394
75;Nouvelle-Aquitaine;16;3;05;377;La Tâche;115;0;115
75;Nouvelle-Aquitaine;16;3;08;378;Taizé-Aizie;570;15;585
75;Nouvelle-Aquitaine;16;1;19;379;Taponnat-Fleurignac;1486;27;1513
75;Nouvelle-Aquitaine;16;2;09;380;Le Tâtre;403;3;406
75;Nouvelle-Aquitaine;16;3;  ;192;Terres-de-Haute-Charente ;3931;106;4037
75;Nouvelle-Aquitaine;16;3;08;381;Theil-Rabier;167;2;169
75;Nouvelle-Aquitaine;16;1;04;382;Torsac;729;31;760
75;Nouvelle-Aquitaine;16;3;05;383;Tourriers;757;10;767
75;Nouvelle-Aquitaine;16;2;09;384;Touvérac;597;7;604
75;Nouvelle-Aquitaine;16;1;16;385;Touvre;1164;26;1190
75;Nouvelle-Aquitaine;16;2;15;387;Triac-Lautrait;451;62;513
75;Nouvelle-Aquitaine;16;1;18;388;Trois-Palis;948;22;970
75;Nouvelle-Aquitaine;16;3;06;389;Turgon;86;2;88
75;Nouvelle-Aquitaine;16;3;08;390;Tusson;223;7;230
75;Nouvelle-Aquitaine;16;2;18;339;Val-d'Auge ;807;19;826
75;Nouvelle-Aquitaine;16;3;05;300;Val-de-Bonnieure ;1301;16;1317
75;Nouvelle-Aquitaine;16;2;09;175;Val des Vignes;1409;35;1444
75;Nouvelle-Aquitaine;16;3;05;392;Valence;193;6;199
75;Nouvelle-Aquitaine;16;3;05;393;Vars;2113;33;2146
75;Nouvelle-Aquitaine;16;1;17;394;Vaux-Lavalette;88;2;90
75;Nouvelle-Aquitaine;16;2;18;395;Vaux-Rouillac;296;4;300
75;Nouvelle-Aquitaine;16;3;05;396;Ventouse;125;0;125
75;Nouvelle-Aquitaine;16;3;08;397;Verdille;365;7;372
75;Nouvelle-Aquitaine;16;3;06;398;Verneuil;101;5;106
75;Nouvelle-Aquitaine;16;2;07;399;Verrières;350;9;359
75;Nouvelle-Aquitaine;16;3;08;400;Verteuil-sur-Charente;638;12;650
75;Nouvelle-Aquitaine;16;3;05;401;Vervant;145;2;147
75;Nouvelle-Aquitaine;16;2;07;402;Vibrac;282;5;287
75;Nouvelle-Aquitaine;16;3;06;403;Le Vieux-Cérier;129;3;132
75;Nouvelle-Aquitaine;16;3;06;404;Vieux-Ruffec;107;2;109
75;Nouvelle-Aquitaine;16;2;09;405;Vignolles;166;9;175
75;Nouvelle-Aquitaine;16;1;17;408;Villebois-Lavalette;730;19;749
75;Nouvelle-Aquitaine;16;3;08;409;Villefagnan;988;11;999
75;Nouvelle-Aquitaine;16;3;05;412;Villejoubert;334;1;335
75;Nouvelle-Aquitaine;16;3;08;413;Villiers-le-Roux;137;2;139
75;Nouvelle-Aquitaine;16;3;05;414;Villognon;316;4;320
75;Nouvelle-Aquitaine;16;1;18;415;Vindelle;1086;19;1105
75;Nouvelle-Aquitaine;16;3;06;416;Vitrac-Saint-Vincent;514;8;522
75;Nouvelle-Aquitaine;16;3;05;419;Vouharte;331;2;333
75;Nouvelle-Aquitaine;16;1;04;420;Voulgézac;245;4;249
75;Nouvelle-Aquitaine;16;1;19;421;Vouthon;410;6;416
75;Nouvelle-Aquitaine;16;1;04;422;Vouzan;791;8;799
75;Nouvelle-Aquitaine;16;1;04;418;Vœuil-et-Giget;1528;28;1556
75;Nouvelle-Aquitaine;16;3;05;423;Xambes;273;4;277
75;Nouvelle-Aquitaine;16;1;17;424;Yviers;518;8;526
75;Nouvelle-Aquitaine;16;1;19;425;Yvrac-et-Malleyrand;554;11;565
75;Nouvelle-Aquitaine;17;1;07;002;Agudelle;134;4;138
75;Nouvelle-Aquitaine;17;2;23;003;Aigrefeuille-d'Aunis;4117;73;4190
75;Nouvelle-Aquitaine;17;1;07;005;Allas-Bocage;198;1;199
75;Nouvelle-Aquitaine;17;1;07;006;Allas-Champagne;254;4;258
75;Nouvelle-Aquitaine;17;2;06;007;Anais;316;7;323
75;Nouvelle-Aquitaine;17;3;09;008;Andilly;2254;33;2287
75;Nouvelle-Aquitaine;17;3;09;009;Angliers;1096;8;1104
75;Nouvelle-Aquitaine;17;3;03;010;Angoulins;3995;100;4095
75;Nouvelle-Aquitaine;17;5;18;011;Annepont;386;4;390
75;Nouvelle-Aquitaine;17;5;18;012;Annezay;156;5;161
75;Nouvelle-Aquitaine;17;5;11;013;Antezant-la-Chapelle;344;8;352
75;Nouvelle-Aquitaine;17;4;21;015;Arces;762;9;771
75;Nouvelle-Aquitaine;17;1;07;016;Archiac;777;12;789
75;Nouvelle-Aquitaine;17;5;18;017;Archingeay;674;13;687
75;Nouvelle-Aquitaine;17;2;23;018;Ardillières;852;13;865
75;Nouvelle-Aquitaine;17;3;05;019;Ars-en-Ré;1301;24;1325
75;Nouvelle-Aquitaine;17;1;07;020;Arthenac;347;4;351
75;Nouvelle-Aquitaine;17;2;26;021;Arvert;3489;83;3572
75;Nouvelle-Aquitaine;17;5;11;022;Asnières-la-Giraud;1027;24;1051
75;Nouvelle-Aquitaine;17;5;02;023;Aujac;371;7;378
75;Nouvelle-Aquitaine;17;5;11;024;Aulnay;1344;25;1369
75;Nouvelle-Aquitaine;17;5;02;025;Aumagne;706;29;735
75;Nouvelle-Aquitaine;17;5;02;026;Authon-Ébéon;382;5;387
75;Nouvelle-Aquitaine;17;1;12;027;Avy;476;7;483
75;Nouvelle-Aquitaine;17;3;01;028;Aytré;9205;166;9371
75;Nouvelle-Aquitaine;17;5;11;029;Bagnizeau;207;1;208
75;Nouvelle-Aquitaine;17;4;19;030;Balanzac;548;5;553
75;Nouvelle-Aquitaine;17;5;11;031;Ballans;196;2;198
75;Nouvelle-Aquitaine;17;2;23;032;Ballon;800;17;817
75;Nouvelle-Aquitaine;17;1;27;033;La Barde;497;5;502
75;Nouvelle-Aquitaine;17;4;21;034;Barzan;467;7;474
75;Nouvelle-Aquitaine;17;5;11;035;Bazauges;114;2;116
75;Nouvelle-Aquitaine;17;2;10;036;Beaugeay;779;14;793
75;Nouvelle-Aquitaine;17;5;11;037;Beauvais-sur-Matha;643;9;652
75;Nouvelle-Aquitaine;17;1;27;038;Bedenac;689;6;695
75;Nouvelle-Aquitaine;17;1;12;039;Belluire;209;1;210
75;Nouvelle-Aquitaine;17;3;09;041;Benon;1650;15;1665
75;Nouvelle-Aquitaine;17;5;02;042;Bercloux;441;9;450
75;Nouvelle-Aquitaine;17;5;18;043;Bernay-Saint-Martin;760;13;773
75;Nouvelle-Aquitaine;17;4;24;044;Berneuil;1147;22;1169
75;Nouvelle-Aquitaine;17;4;19;045;Beurlay;1030;18;1048
75;Nouvelle-Aquitaine;17;5;18;046;Bignay;399;8;407
75;Nouvelle-Aquitaine;17;1;12;047;Biron;234;1;235
75;Nouvelle-Aquitaine;17;5;11;048;Blanzac-lès-Matha;320;4;324
75;Nouvelle-Aquitaine;17;5;11;049;Blanzay-sur-Boutonne;78;5;83
75;Nouvelle-Aquitaine;17;1;12;050;Bois;523;138;661
75;Nouvelle-Aquitaine;17;3;05;051;Le Bois-Plage-en-Ré;2246;30;2276
75;Nouvelle-Aquitaine;17;1;12;052;Boisredon;699;9;708
75;Nouvelle-Aquitaine;17;5;18;053;Bords;1335;27;1362
75;Nouvelle-Aquitaine;17;1;27;054;Boresse-et-Martron;207;9;216
75;Nouvelle-Aquitaine;17;1;27;055;Boscamnant;374;5;379
75;Nouvelle-Aquitaine;17;1;12;056;Bougneau;602;14;616
75;Nouvelle-Aquitaine;17;2;06;057;Bouhet;911;16;927
75;Nouvelle-Aquitaine;17;2;10;058;Bourcefranc-le-Chapus;3461;125;3586
75;Nouvelle-Aquitaine;17;3;06;059;Bourgneuf;1334;24;1358
75;Nouvelle-Aquitaine;17;4;21;060;Boutenac-Touvent;227;5;232
75;Nouvelle-Aquitaine;17;1;27;061;Bran;134;2;136
75;Nouvelle-Aquitaine;17;2;04;486;La Brée-les-Bains;689;6;695
75;Nouvelle-Aquitaine;17;5;11;062;Bresdon;219;3;222
75;Nouvelle-Aquitaine;17;2;23;063;Breuil-la-Réorte;456;7;463
75;Nouvelle-Aquitaine;17;2;25;065;Breuil-Magné;1731;51;1782
75;Nouvelle-Aquitaine;17;2;26;064;Breuillet;2988;62;3050
75;Nouvelle-Aquitaine;17;1;07;066;Brie-sous-Archiac;238;2;240
75;Nouvelle-Aquitaine;17;5;11;067;Brie-sous-Matha;176;4;180
75;Nouvelle-Aquitaine;17;4;21;068;Brie-sous-Mortagne;239;3;242
75;Nouvelle-Aquitaine;17;1;24;069;Brives-sur-Charente;234;6;240
75;Nouvelle-Aquitaine;17;5;02;070;Brizambourg;915;14;929
75;Nouvelle-Aquitaine;17;5;11;071;La Brousse;514;9;523
75;Nouvelle-Aquitaine;17;4;02;072;Burie;1287;27;1314
75;Nouvelle-Aquitaine;17;1;27;074;Bussac-Forêt;1046;15;1061
75;Nouvelle-Aquitaine;17;4;02;073;Bussac-sur-Charente;1271;44;1315
75;Nouvelle-Aquitaine;17;2;25;075;Cabariot;1364;22;1386
75;Nouvelle-Aquitaine;17;1;07;076;Celles;322;3;325
75;Nouvelle-Aquitaine;17;1;27;077;Cercoux;1203;19;1222
75;Nouvelle-Aquitaine;17;1;12;078;Chadenac;504;7;511
75;Nouvelle-Aquitaine;17;2;26;079;Chaillevette;1587;33;1620
75;Nouvelle-Aquitaine;17;2;23;080;Chambon;945;12;957
75;Nouvelle-Aquitaine;17;1;27;081;Chamouillac;373;7;380
75;Nouvelle-Aquitaine;17;1;07;082;Champagnac;527;8;535
75;Nouvelle-Aquitaine;17;2;10;083;Champagne;615;12;627
75;Nouvelle-Aquitaine;17;1;12;084;Champagnolles;662;8;670
75;Nouvelle-Aquitaine;17;5;18;085;Champdolent;406;6;412
75;Nouvelle-Aquitaine;17;4;02;086;Chaniers;3588;83;3671
75;Nouvelle-Aquitaine;17;5;18;087;Chantemerle-sur-la-Soie;195;2;197
75;Nouvelle-Aquitaine;17;4;02;089;La Chapelle-des-Pots;1004;26;1030
75;Nouvelle-Aquitaine;17;3;09;091;Charron;1995;27;2022
75;Nouvelle-Aquitaine;17;1;27;092;Chartuzac;156;4;160
75;Nouvelle-Aquitaine;17;2;04;093;Le Château-d'Oléron;4229;78;4307
75;Nouvelle-Aquitaine;17;3;03;094;Châtelaillon-Plage;5871;92;5963
75;Nouvelle-Aquitaine;17;1;27;095;Chatenet;216;6;222
75;Nouvelle-Aquitaine;17;1;07;096;Chaunac;77;2;79
75;Nouvelle-Aquitaine;17;4;22;097;Le Chay;767;15;782
75;Nouvelle-Aquitaine;17;4;21;098;Chenac-Saint-Seurin-d'Uzet;599;13;612
75;Nouvelle-Aquitaine;17;1;27;099;Chepniers;640;11;651
75;Nouvelle-Aquitaine;17;4;02;100;Chérac;1113;16;1129
75;Nouvelle-Aquitaine;17;5;11;101;Cherbonnières;333;1;334
75;Nouvelle-Aquitaine;17;4;24;102;Chermignac;1255;35;1290
75;Nouvelle-Aquitaine;17;1;27;104;Chevanceaux;1073;108;1181
75;Nouvelle-Aquitaine;17;5;11;105;Chives;323;1;324
75;Nouvelle-Aquitaine;17;1;07;106;Cierzac;310;5;315
75;Nouvelle-Aquitaine;17;2;23;107;Ciré-d'Aunis;1381;22;1403
75;Nouvelle-Aquitaine;17;1;07;108;Clam;413;15;428
75;Nouvelle-Aquitaine;17;3;06;109;Clavette;1423;20;1443
75;Nouvelle-Aquitaine;17;1;27;110;Clérac;971;15;986
75;Nouvelle-Aquitaine;17;1;07;111;Clion;820;12;832
75;Nouvelle-Aquitaine;17;4;24;112;La Clisse;701;16;717
75;Nouvelle-Aquitaine;17;1;27;113;La Clotte;713;7;720
75;Nouvelle-Aquitaine;17;5;11;114;Coivert;212;2;214
75;Nouvelle-Aquitaine;17;4;24;115;Colombiers;311;7;318
75;Nouvelle-Aquitaine;17;1;07;116;Consac;218;5;223
75;Nouvelle-Aquitaine;17;5;11;117;Contré;143;0;143
75;Nouvelle-Aquitaine;17;1;27;118;Corignac;352;10;362
75;Nouvelle-Aquitaine;17;4;22;119;Corme-Écluse;1121;20;1141
75;Nouvelle-Aquitaine;17;4;24;120;Corme-Royal;1854;38;1892
75;Nouvelle-Aquitaine;17;3;05;121;La Couarde-sur-Mer;1172;19;1191
75;Nouvelle-Aquitaine;17;1;24;122;Coulonges;235;4;239
75;Nouvelle-Aquitaine;17;5;18;124;Courant;421;5;426
75;Nouvelle-Aquitaine;17;5;11;125;Courcelles;467;10;477
75;Nouvelle-Aquitaine;17;5;11;126;Courcerac;297;6;303
75;Nouvelle-Aquitaine;17;4;24;128;Courcoury;692;12;704
75;Nouvelle-Aquitaine;17;1;12;129;Courpignac;415;6;421
75;Nouvelle-Aquitaine;17;3;09;127;Courçon;1750;29;1779
75;Nouvelle-Aquitaine;17;1;27;130;Coux;465;13;478
75;Nouvelle-Aquitaine;17;4;21;131;Cozes;2147;43;2190
75;Nouvelle-Aquitaine;17;3;09;132;Cramchaban;653;18;671
75;Nouvelle-Aquitaine;17;4;21;133;Cravans;880;75;955
75;Nouvelle-Aquitaine;17;4;19;134;Crazannes;433;9;442
75;Nouvelle-Aquitaine;17;5;11;135;Cressé;235;2;237
75;Nouvelle-Aquitaine;17;3;06;136;Croix-Chapeau;1266;28;1294
75;Nouvelle-Aquitaine;17;5;18;137;La Croix-Comtesse;223;3;226
75;Nouvelle-Aquitaine;17;5;11;138;Dampierre-sur-Boutonne;284;3;287
75;Nouvelle-Aquitaine;17;2;18;457;Devise ;1151;17;1168
75;Nouvelle-Aquitaine;17;2;04;140;Dolus-d'Oléron;3187;63;3250
75;Nouvelle-Aquitaine;17;4;02;141;Dompierre-sur-Charente;464;9;473
75;Nouvelle-Aquitaine;17;3;01;142;Dompierre-sur-Mer;5560;141;5701
75;Nouvelle-Aquitaine;17;4;02;143;Le Douhet;708;13;721
75;Nouvelle-Aquitaine;17;5;18;139;Dœuil-sur-le-Mignon;337;7;344
75;Nouvelle-Aquitaine;17;1;12;145;Échebrune;484;8;492
75;Nouvelle-Aquitaine;17;2;25;146;Échillais;3546;70;3616
75;Nouvelle-Aquitaine;17;4;02;147;Écoyeux;1356;22;1378
75;Nouvelle-Aquitaine;17;4;19;148;Écurat;465;10;475
75;Nouvelle-Aquitaine;17;5;11;149;Les Éduts;59;2;61
75;Nouvelle-Aquitaine;17;5;11;150;Les Églises-d'Argenteuil;517;7;524
75;Nouvelle-Aquitaine;17;2;22;151;L' Éguille;878;23;901
75;Nouvelle-Aquitaine;17;4;21;152;Épargnes;854;8;862
75;Nouvelle-Aquitaine;17;3;08;153;Esnandes;2072;32;2104
75;Nouvelle-Aquitaine;17;4;19;154;Les Essards;704;8;712
75;Nouvelle-Aquitaine;17;5;18;277;Essouvert;1125;89;1214
75;Nouvelle-Aquitaine;17;2;26;155;Étaules;2546;43;2589
75;Nouvelle-Aquitaine;17;1;27;156;Expiremont;128;3;131
75;Nouvelle-Aquitaine;17;5;18;157;Fenioux;162;2;164
75;Nouvelle-Aquitaine;17;3;09;158;Ferrières;968;7;975
75;Nouvelle-Aquitaine;17;1;12;159;Fléac-sur-Seugne;367;7;374
75;Nouvelle-Aquitaine;17;4;21;160;Floirac;392;13;405
75;Nouvelle-Aquitaine;17;3;05;161;La Flotte;2759;40;2799
75;Nouvelle-Aquitaine;17;5;11;162;Fontaine-Chalendray;199;1;200
75;Nouvelle-Aquitaine;17;1;07;163;Fontaines-d'Ozillac;517;10;527
75;Nouvelle-Aquitaine;17;4;02;164;Fontcouverte;2323;53;2376
75;Nouvelle-Aquitaine;17;5;11;165;Fontenet;390;13;403
75;Nouvelle-Aquitaine;17;2;23;166;Forges;1315;14;1329
75;Nouvelle-Aquitaine;17;1;27;167;Le Fouilloux;773;11;784
75;Nouvelle-Aquitaine;17;2;03;168;Fouras;3968;76;4044
75;Nouvelle-Aquitaine;17;4;19;171;Geay;754;18;772
75;Nouvelle-Aquitaine;17;4;21;172;Gémozac;2848;30;2878
75;Nouvelle-Aquitaine;17;1;27;173;La Genétouze;232;6;238
75;Nouvelle-Aquitaine;17;2;25;174;Genouillé;904;9;913
75;Nouvelle-Aquitaine;17;1;07;175;Germignac;640;7;647
75;Nouvelle-Aquitaine;17;5;11;176;Gibourne;109;4;113
75;Nouvelle-Aquitaine;17;5;11;177;Le Gicq;118;0;118
75;Nouvelle-Aquitaine;17;1;12;178;Givrezac;69;1;70
75;Nouvelle-Aquitaine;17;4;24;179;Les Gonds;1755;85;1840
75;Nouvelle-Aquitaine;17;5;11;180;Gourvillette;89;3;92
75;Nouvelle-Aquitaine;17;2;04;485;Le Grand-Village-Plage;1060;13;1073
75;Nouvelle-Aquitaine;17;5;18;181;Grandjean;304;6;310
75;Nouvelle-Aquitaine;17;3;09;182;La Grève-sur-Mignon;560;11;571
75;Nouvelle-Aquitaine;17;4;21;183;Grézac;932;12;944
75;Nouvelle-Aquitaine;17;2;10;184;La Gripperie-Saint-Symphorien;589;12;601
75;Nouvelle-Aquitaine;17;2;10;185;Le Gua;2099;32;2131
75;Nouvelle-Aquitaine;17;3;09;186;Le Gué-d'Alleré;945;11;956
75;Nouvelle-Aquitaine;17;1;07;187;Guitinières;530;17;547
75;Nouvelle-Aquitaine;17;5;11;188;Haimps;457;9;466
75;Nouvelle-Aquitaine;17;3;08;190;L' Houmeau;2850;55;2905
75;Nouvelle-Aquitaine;17;2;03;004;Île-d'Aix;211;5;216
75;Nouvelle-Aquitaine;17;4;24;191;La Jard;424;9;433
75;Nouvelle-Aquitaine;17;1;07;192;Jarnac-Champagne;810;18;828
75;Nouvelle-Aquitaine;17;3;06;193;La Jarne;2516;54;2570
75;Nouvelle-Aquitaine;17;3;06;194;La Jarrie;3300;75;3375
75;Nouvelle-Aquitaine;17;5;18;195;La Jarrie-Audouin;269;5;274
75;Nouvelle-Aquitaine;17;4;21;196;Jazennes;542;6;548
75;Nouvelle-Aquitaine;17;1;07;197;Jonzac;3457;222;3679
75;Nouvelle-Aquitaine;17;5;02;198;Juicq;295;0;295
75;Nouvelle-Aquitaine;17;1;27;199;Jussas;155;2;157
75;Nouvelle-Aquitaine;17;3;08;200;Lagord;7130;155;7285
75;Nouvelle-Aquitaine;17;3;09;201;La Laigne;476;6;482
75;Nouvelle-Aquitaine;17;5;18;202;Landes;599;13;612
75;Nouvelle-Aquitaine;17;2;23;203;Landrais;733;9;742
75;Nouvelle-Aquitaine;17;1;07;204;Léoville;310;8;318
75;Nouvelle-Aquitaine;17;2;25;205;Loire-les-Marais;396;9;405
75;Nouvelle-Aquitaine;17;5;11;206;Loiré-sur-Nie;284;3;287
75;Nouvelle-Aquitaine;17;3;05;207;Loix;731;17;748
75;Nouvelle-Aquitaine;17;3;09;208;Longèves;1002;15;1017
75;Nouvelle-Aquitaine;17;1;07;209;Lonzac;270;4;274
75;Nouvelle-Aquitaine;17;1;12;210;Lorignac;499;3;502
75;Nouvelle-Aquitaine;17;5;18;211;Loulay;759;9;768
75;Nouvelle-Aquitaine;17;5;11;212;Louzignac;163;2;165
75;Nouvelle-Aquitaine;17;5;18;213;Lozay;134;4;138
75;Nouvelle-Aquitaine;17;4;24;214;Luchat;535;11;546
75;Nouvelle-Aquitaine;17;1;07;215;Lussac;48;0;48
75;Nouvelle-Aquitaine;17;2;25;216;Lussant;1009;14;1023
75;Nouvelle-Aquitaine;17;5;11;217;Macqueville;290;7;297
75;Nouvelle-Aquitaine;17;3;09;218;Marans;4489;63;4552
75;Nouvelle-Aquitaine;17;2;10;219;Marennes-Hiers-Brouage ;6250;103;6353
75;Nouvelle-Aquitaine;17;1;12;220;Marignac;415;17;432
75;Nouvelle-Aquitaine;17;2;23;221;Marsais;931;21;952
75;Nouvelle-Aquitaine;17;3;08;222;Marsilly;3087;91;3178
75;Nouvelle-Aquitaine;17;5;11;223;Massac;179;2;181
75;Nouvelle-Aquitaine;17;5;11;224;Matha;2161;80;2241
75;Nouvelle-Aquitaine;17;2;26;225;Les Mathes;2042;31;2073
75;Nouvelle-Aquitaine;17;5;18;226;Mazeray;968;14;982
75;Nouvelle-Aquitaine;17;1;12;227;Mazerolles;224;3;227
75;Nouvelle-Aquitaine;17;4;22;228;Médis;2936;70;3006
75;Nouvelle-Aquitaine;17;1;27;229;Mérignac;221;3;224
75;Nouvelle-Aquitaine;17;2;21;230;Meschers-sur-Gironde;3117;72;3189
75;Nouvelle-Aquitaine;17;1;27;231;Messac;105;5;110
75;Nouvelle-Aquitaine;17;4;21;232;Meursac;1510;21;1531
75;Nouvelle-Aquitaine;17;1;07;233;Meux;321;1;322
75;Nouvelle-Aquitaine;17;5;18;234;Migré;340;5;345
75;Nouvelle-Aquitaine;17;4;02;235;Migron;723;14;737
75;Nouvelle-Aquitaine;17;1;12;236;Mirambeau;1496;30;1526
75;Nouvelle-Aquitaine;17;2;10;237;Moëze;574;4;578
75;Nouvelle-Aquitaine;17;5;11;239;Mons;441;8;449
75;Nouvelle-Aquitaine;17;1;27;240;Montendre;3230;49;3279
75;Nouvelle-Aquitaine;17;1;27;241;Montguyon;1569;19;1588
75;Nouvelle-Aquitaine;17;4;24;242;Montils;866;13;879
75;Nouvelle-Aquitaine;17;1;27;243;Montlieu-la-Garde;1231;10;1241
75;Nouvelle-Aquitaine;17;4;21;244;Montpellier-de-Médillan;686;8;694
75;Nouvelle-Aquitaine;17;3;06;245;Montroy;906;13;919
75;Nouvelle-Aquitaine;17;2;25;246;Moragne;510;7;517
75;Nouvelle-Aquitaine;17;2;26;247;Mornac-sur-Seudre;848;12;860
75;Nouvelle-Aquitaine;17;4;21;248;Mortagne-sur-Gironde;911;19;930
75;Nouvelle-Aquitaine;17;1;07;249;Mortiers;177;1;178
75;Nouvelle-Aquitaine;17;1;12;250;Mosnac;473;5;478
75;Nouvelle-Aquitaine;17;5;18;252;Le Mung;301;7;308
75;Nouvelle-Aquitaine;17;2;25;253;Muron;1346;16;1362
75;Nouvelle-Aquitaine;17;5;18;254;Nachamps;190;4;194
75;Nouvelle-Aquitaine;17;4;19;255;Nancras;797;12;809
75;Nouvelle-Aquitaine;17;5;02;256;Nantillé;326;12;338
75;Nouvelle-Aquitaine;17;5;11;257;Néré;709;6;715
75;Nouvelle-Aquitaine;17;1;07;258;Neuillac;302;5;307
75;Nouvelle-Aquitaine;17;1;07;259;Neulles;151;2;153
75;Nouvelle-Aquitaine;17;1;27;260;Neuvicq;458;5;463
75;Nouvelle-Aquitaine;17;5;11;261;Neuvicq-le-Château;317;6;323
75;Nouvelle-Aquitaine;17;1;07;263;Nieul-le-Virouil;581;11;592
75;Nouvelle-Aquitaine;17;4;19;262;Nieul-lès-Saintes;1260;22;1282
75;Nouvelle-Aquitaine;17;3;08;264;Nieul-sur-Mer;5720;144;5864
75;Nouvelle-Aquitaine;17;2;10;265;Nieulle-sur-Seudre;1217;20;1237
75;Nouvelle-Aquitaine;17;5;18;266;Les Nouillers;712;7;719
75;Nouvelle-Aquitaine;17;3;09;267;Nuaillé-d'Aunis;1140;15;1155
75;Nouvelle-Aquitaine;17;5;11;268;Nuaillé-sur-Boutonne;192;7;199
75;Nouvelle-Aquitaine;17;1;27;269;Orignolles;681;7;688
75;Nouvelle-Aquitaine;17;1;07;270;Ozillac;623;14;637
75;Nouvelle-Aquitaine;17;5;11;271;Paillé;318;6;324
75;Nouvelle-Aquitaine;17;1;24;273;Pérignac;1014;13;1027
75;Nouvelle-Aquitaine;17;3;01;274;Périgny;8575;185;8760
75;Nouvelle-Aquitaine;17;4;24;275;Pessines;763;25;788
75;Nouvelle-Aquitaine;17;1;27;276;Le Pin;78;1;79
75;Nouvelle-Aquitaine;17;4;24;278;Pisany;742;9;751
75;Nouvelle-Aquitaine;17;1;12;279;Plassac;612;12;624
75;Nouvelle-Aquitaine;17;4;19;280;Plassay;727;16;743
75;Nouvelle-Aquitaine;17;1;27;281;Polignac;165;3;168
75;Nouvelle-Aquitaine;17;1;27;282;Pommiers-Moulons;213;2;215
75;Nouvelle-Aquitaine;17;1;12;283;Pons;4202;249;4451
75;Nouvelle-Aquitaine;17;4;19;284;Pont-l'Abbé-d'Arnoult;1791;262;2053
75;Nouvelle-Aquitaine;17;4;19;285;Port-d'Envaux;1151;27;1178
75;Nouvelle-Aquitaine;17;2;25;484;Port-des-Barques;1773;15;1788
75;Nouvelle-Aquitaine;17;3;05;286;Les Portes-en-Ré;599;10;609
75;Nouvelle-Aquitaine;17;1;27;287;Pouillac;248;0;248
75;Nouvelle-Aquitaine;17;5;11;288;Poursay-Garnaud;314;6;320
75;Nouvelle-Aquitaine;17;4;24;289;Préguillac;443;17;460
75;Nouvelle-Aquitaine;17;5;11;290;Prignac;296;9;305
75;Nouvelle-Aquitaine;17;3;01;291;Puilboreau;6369;121;6490
75;Nouvelle-Aquitaine;17;5;18;292;Puy-du-Lac;500;5;505
75;Nouvelle-Aquitaine;17;2;23;293;Puyravault;684;11;695
75;Nouvelle-Aquitaine;17;5;18;294;Puyrolland;204;0;204
75;Nouvelle-Aquitaine;17;1;07;295;Réaux sur Trèfle;808;17;825
75;Nouvelle-Aquitaine;17;4;24;296;Rétaud;1066;19;1085
75;Nouvelle-Aquitaine;17;4;24;298;Rioux;977;18;995
75;Nouvelle-Aquitaine;17;3;05;297;Rivedoux-Plage;2291;43;2334
75;Nouvelle-Aquitaine;17;2;13;299;Rochefort;23583;687;24270
75;Nouvelle-Aquitaine;17;3;99;300;La Rochelle;76114;2150;78264
75;Nouvelle-Aquitaine;17;5;11;301;Romazières;71;1;72
75;Nouvelle-Aquitaine;17;4;19;302;Romegoux;597;9;606
75;Nouvelle-Aquitaine;17;3;09;303;La Ronde;1040;17;1057
75;Nouvelle-Aquitaine;17;4;24;304;Rouffiac;468;5;473
75;Nouvelle-Aquitaine;17;1;27;305;Rouffignac;420;9;429
75;Nouvelle-Aquitaine;17;2;17;306;Royan;18499;529;19028
75;Nouvelle-Aquitaine;17;4;22;307;Sablonceaux;1394;32;1426
75;Nouvelle-Aquitaine;17;2;10;308;Saint-Agnant;2691;61;2752
75;Nouvelle-Aquitaine;17;1;27;309;Saint-Aigulin;1903;39;1942
75;Nouvelle-Aquitaine;17;4;21;310;Saint-André-de-Lidon;1106;14;1120
75;Nouvelle-Aquitaine;17;2;26;311;Saint-Augustin;1374;25;1399
75;Nouvelle-Aquitaine;17;1;12;312;Saint-Bonnet-sur-Gironde;829;14;843
75;Nouvelle-Aquitaine;17;4;02;313;Saint-Bris-des-Bois;387;9;396
75;Nouvelle-Aquitaine;17;4;02;314;Saint-Césaire;884;16;900
75;Nouvelle-Aquitaine;17;3;06;315;Saint-Christophe;1351;28;1379
75;Nouvelle-Aquitaine;17;1;07;316;Saint-Ciers-Champagne;407;11;418
75;Nouvelle-Aquitaine;17;1;12;317;Saint-Ciers-du-Taillon;555;5;560
75;Nouvelle-Aquitaine;17;3;05;318;Saint-Clément-des-Baleines;663;11;674
75;Nouvelle-Aquitaine;17;2;25;320;Saint-Coutant-le-Grand;417;6;423
75;Nouvelle-Aquitaine;17;2;18;321;Saint-Crépin;353;3;356
75;Nouvelle-Aquitaine;17;3;09;322;Saint-Cyr-du-Doret;665;4;669
75;Nouvelle-Aquitaine;17;2;04;323;Saint-Denis-d'Oléron;1302;22;1324
75;Nouvelle-Aquitaine;17;1;07;324;Saint-Dizant-du-Bois;111;0;111
75;Nouvelle-Aquitaine;17;1;12;325;Saint-Dizant-du-Gua;536;3;539
75;Nouvelle-Aquitaine;17;1;07;326;Saint-Eugène;280;5;285
75;Nouvelle-Aquitaine;17;5;18;327;Saint-Félix;305;3;308
75;Nouvelle-Aquitaine;17;1;12;328;Saint-Fort-sur-Gironde;906;10;916
75;Nouvelle-Aquitaine;17;2;10;329;Saint-Froult;346;2;348
75;Nouvelle-Aquitaine;17;1;12;331;Saint-Genis-de-Saintonge;1255;50;1305
75;Nouvelle-Aquitaine;17;1;07;332;Saint-Georges-Antignac;385;6;391
75;Nouvelle-Aquitaine;17;2;04;337;Saint-Georges-d'Oléron;3738;54;3792
75;Nouvelle-Aquitaine;17;2;17;333;Saint-Georges-de-Didonne;5340;115;5455
75;Nouvelle-Aquitaine;17;5;11;334;Saint-Georges-de-Longuepierre;228;4;232
75;Nouvelle-Aquitaine;17;1;12;335;Saint-Georges-des-Agoûts;287;3;290
75;Nouvelle-Aquitaine;17;4;19;336;Saint-Georges-des-Coteaux;2708;57;2765
75;Nouvelle-Aquitaine;17;2;23;338;Saint-Georges-du-Bois;1768;33;1801
75;Nouvelle-Aquitaine;17;1;07;339;Saint-Germain-de-Lusignan;1290;124;1414
75;Nouvelle-Aquitaine;17;1;07;341;Saint-Germain-de-Vibrac;188;2;190
75;Nouvelle-Aquitaine;17;1;12;342;Saint-Germain-du-Seudre;427;9;436
75;Nouvelle-Aquitaine;17;1;12;343;Saint-Grégoire-d'Ardennes;148;3;151
75;Nouvelle-Aquitaine;17;5;02;344;Saint-Hilaire-de-Villefranche ;1320;15;1335
75;Nouvelle-Aquitaine;17;1;07;345;Saint-Hilaire-du-Bois;320;15;335
75;Nouvelle-Aquitaine;17;2;25;346;Saint-Hippolyte;1436;25;1461
75;Nouvelle-Aquitaine;17;5;18;347;Saint-Jean-d'Angély;6886;436;7322
75;Nouvelle-Aquitaine;17;2;10;348;Saint-Jean-d'Angle;692;7;699
75;Nouvelle-Aquitaine;17;3;09;349;Saint-Jean-de-Liversay;2953;42;2995
75;Nouvelle-Aquitaine;17;5;11;350;Saint-Julien-de-l'Escap;881;16;897
75;Nouvelle-Aquitaine;17;2;10;351;Saint-Just-Luzac;2006;33;2039
75;Nouvelle-Aquitaine;17;2;03;353;Saint-Laurent-de-la-Prée;2163;60;2223
75;Nouvelle-Aquitaine;17;1;12;354;Saint-Léger;639;12;651
75;Nouvelle-Aquitaine;17;5;18;356;Saint-Loup;307;4;311
75;Nouvelle-Aquitaine;17;1;07;357;Saint-Maigrin;535;9;544
75;Nouvelle-Aquitaine;17;5;11;358;Saint-Mandé-sur-Brédoire;310;6;316
75;Nouvelle-Aquitaine;17;2;23;359;Saint-Mard;1206;20;1226
75;Nouvelle-Aquitaine;17;5;11;361;Saint-Martial;115;5;120
75;Nouvelle-Aquitaine;17;1;12;362;Saint-Martial-de-Mirambeau;284;7;291
75;Nouvelle-Aquitaine;17;1;07;363;Saint-Martial-de-Vitaterne;546;14;560
75;Nouvelle-Aquitaine;17;1;07;364;Saint-Martial-sur-Né;445;14;459
75;Nouvelle-Aquitaine;17;1;27;365;Saint-Martin-d'Ary;470;9;479
75;Nouvelle-Aquitaine;17;1;27;366;Saint-Martin-de-Coux;474;4;478
75;Nouvelle-Aquitaine;17;5;11;367;Saint-Martin-de-Juillers;157;4;161
75;Nouvelle-Aquitaine;17;3;05;369;Saint-Martin-de-Ré;2207;20;2227
75;Nouvelle-Aquitaine;17;1;07;372;Saint-Médard;77;1;78
75;Nouvelle-Aquitaine;17;3;06;373;Saint-Médard-d'Aunis;2279;43;2322
75;Nouvelle-Aquitaine;17;2;25;375;Saint-Nazaire-sur-Charente;1191;25;1216
75;Nouvelle-Aquitaine;17;3;09;376;Saint-Ouen-d'Aunis;1812;32;1844
75;Nouvelle-Aquitaine;17;5;11;377;Saint-Ouen-la-Thène;119;6;125
75;Nouvelle-Aquitaine;17;1;27;378;Saint-Palais-de-Négrignac;436;6;442
75;Nouvelle-Aquitaine;17;1;12;379;Saint-Palais-de-Phiolin;208;3;211
75;Nouvelle-Aquitaine;17;2;26;380;Saint-Palais-sur-Mer;3905;85;3990
75;Nouvelle-Aquitaine;17;5;11;381;Saint-Pardoult;235;3;238
75;Nouvelle-Aquitaine;17;2;23;382;Saint-Pierre-d'Amilly;533;5;538
75;Nouvelle-Aquitaine;17;2;04;385;Saint-Pierre-d'Oléron;6683;98;6781
75;Nouvelle-Aquitaine;17;5;11;383;Saint-Pierre-de-Juillers;356;4;360
75;Nouvelle-Aquitaine;17;5;11;384;Saint-Pierre-de-l'Isle;261;4;265
75;Nouvelle-Aquitaine;17;1;27;386;Saint-Pierre-du-Palais;360;10;370
75;Nouvelle-Aquitaine;17;2;23;340;Saint-Pierre-La-Noue;1556;76;1632
75;Nouvelle-Aquitaine;17;4;19;387;Saint-Porchaire;1869;30;1899
75;Nouvelle-Aquitaine;17;1;12;388;Saint-Quantin-de-Rançanne;257;7;264
75;Nouvelle-Aquitaine;17;3;06;391;Saint-Rogatien;2279;47;2326
75;Nouvelle-Aquitaine;17;4;22;393;Saint-Romain-de-Benet;1724;27;1751
75;Nouvelle-Aquitaine;17;2;23;394;Saint-Saturnin-du-Bois;909;18;927
75;Nouvelle-Aquitaine;17;4;02;395;Saint-Sauvant;487;8;495
75;Nouvelle-Aquitaine;17;3;09;396;Saint-Sauveur-d'Aunis;1717;29;1746
75;Nouvelle-Aquitaine;17;5;18;397;Saint-Savinien;2440;110;2550
75;Nouvelle-Aquitaine;17;1;12;398;Saint-Seurin-de-Palenne;165;7;172
75;Nouvelle-Aquitaine;17;4;24;400;Saint-Sever-de-Saintonge;622;13;635
75;Nouvelle-Aquitaine;17;5;11;401;Saint-Séverin-sur-Boutonne;96;7;103
75;Nouvelle-Aquitaine;17;1;07;402;Saint-Sigismond-de-Clermont;158;3;161
75;Nouvelle-Aquitaine;17;1;07;403;Saint-Simon-de-Bordes;741;13;754
75;Nouvelle-Aquitaine;17;4;21;404;Saint-Simon-de-Pellouaille;657;19;676
75;Nouvelle-Aquitaine;17;1;12;405;Saint-Sorlin-de-Conac;200;2;202
75;Nouvelle-Aquitaine;17;2;10;406;Saint-Sornin;403;3;406
75;Nouvelle-Aquitaine;17;4;19;408;Saint-Sulpice-d'Arnoult;873;10;883
75;Nouvelle-Aquitaine;17;2;22;409;Saint-Sulpice-de-Royan;3259;65;3324
75;Nouvelle-Aquitaine;17;1;12;410;Saint-Thomas-de-Conac;567;9;576
75;Nouvelle-Aquitaine;17;2;04;411;Saint-Trojan-les-Bains;1204;22;1226
75;Nouvelle-Aquitaine;17;4;02;412;Saint-Vaize;662;8;670
75;Nouvelle-Aquitaine;17;3;03;413;Saint-Vivien;1333;20;1353
75;Nouvelle-Aquitaine;17;3;08;414;Saint-Xandre;4905;158;5063
75;Nouvelle-Aquitaine;17;1;27;319;Sainte-Colombe;108;1;109
75;Nouvelle-Aquitaine;17;4;19;330;Sainte-Gemme;1324;15;1339
75;Nouvelle-Aquitaine;17;1;07;355;Sainte-Lheurine;506;10;516
75;Nouvelle-Aquitaine;17;3;05;360;Sainte-Marie-de-Ré;3367;105;3472
75;Nouvelle-Aquitaine;17;5;02;374;Sainte-Même;243;2;245
75;Nouvelle-Aquitaine;17;4;19;389;Sainte-Radegonde;579;9;588
75;Nouvelle-Aquitaine;17;1;12;390;Sainte-Ramée;118;1;119
75;Nouvelle-Aquitaine;17;3;06;407;Sainte-Soulle;4703;95;4798
75;Nouvelle-Aquitaine;17;4;20;415;Saintes;25148;1398;26546
75;Nouvelle-Aquitaine;17;5;11;416;Saleignes;61;2;63
75;Nouvelle-Aquitaine;17;1;12;417;Salignac-de-Mirambeau;164;1;165
75;Nouvelle-Aquitaine;17;1;24;418;Salignac-sur-Charente;602;16;618
75;Nouvelle-Aquitaine;17;3;03;420;Salles-sur-Mer;2208;61;2269
75;Nouvelle-Aquitaine;17;4;22;421;Saujon;7146;116;7262
75;Nouvelle-Aquitaine;17;5;11;422;Seigné;75;0;75
75;Nouvelle-Aquitaine;17;1;12;423;Semillac;73;1;74
75;Nouvelle-Aquitaine;17;1;12;424;Semoussac;371;3;374
75;Nouvelle-Aquitaine;17;4;22;425;Semussac;2379;45;2424
75;Nouvelle-Aquitaine;17;4;02;426;Le Seure;254;4;258
75;Nouvelle-Aquitaine;17;5;11;427;Siecq;217;5;222
75;Nouvelle-Aquitaine;17;5;11;428;Sonnac;502;10;512
75;Nouvelle-Aquitaine;17;2;25;429;Soubise;3024;30;3054
75;Nouvelle-Aquitaine;17;1;12;430;Soubran;393;7;400
75;Nouvelle-Aquitaine;17;4;19;431;Soulignonne;697;6;703
75;Nouvelle-Aquitaine;17;1;27;432;Souméras;362;6;368
75;Nouvelle-Aquitaine;17;1;27;433;Sousmoulins;217;7;224
75;Nouvelle-Aquitaine;17;2;23;434;Surgères;6797;177;6974
75;Nouvelle-Aquitaine;17;5;18;435;Taillant;179;1;180
75;Nouvelle-Aquitaine;17;5;18;436;Taillebourg;743;22;765
75;Nouvelle-Aquitaine;17;4;21;437;Talmont-sur-Gironde;100;1;101
75;Nouvelle-Aquitaine;17;4;21;438;Tanzac;308;7;315
75;Nouvelle-Aquitaine;17;3;09;439;Taugon;788;14;802
75;Nouvelle-Aquitaine;17;5;18;440;Ternant;380;8;388
75;Nouvelle-Aquitaine;17;4;24;441;Tesson;1105;24;1129
75;Nouvelle-Aquitaine;17;4;21;442;Thaims;386;3;389
75;Nouvelle-Aquitaine;17;3;06;443;Thairé;1707;43;1750
75;Nouvelle-Aquitaine;17;4;24;444;Thénac;1676;267;1943
75;Nouvelle-Aquitaine;17;4;24;445;Thézac;325;8;333
75;Nouvelle-Aquitaine;17;5;11;446;Thors;462;6;468
75;Nouvelle-Aquitaine;17;2;23;447;Le Thou;1932;31;1963
75;Nouvelle-Aquitaine;17;5;18;448;Tonnay-Boutonne;1161;14;1175
75;Nouvelle-Aquitaine;17;2;25;449;Tonnay-Charente;8048;137;8185
75;Nouvelle-Aquitaine;17;5;18;450;Torxé;216;3;219
75;Nouvelle-Aquitaine;17;5;11;451;Les Touches-de-Périgny;559;10;569
75;Nouvelle-Aquitaine;17;2;26;452;La Tremblade;4340;63;4403
75;Nouvelle-Aquitaine;17;4;19;453;Trizay;1471;33;1504
75;Nouvelle-Aquitaine;17;1;27;454;Tugéras-Saint-Maurice;378;6;384
75;Nouvelle-Aquitaine;17;4;19;455;La Vallée;674;11;685
75;Nouvelle-Aquitaine;17;1;27;458;Vanzac;160;0;160
75;Nouvelle-Aquitaine;17;5;11;459;Varaize;560;10;570
75;Nouvelle-Aquitaine;17;4;24;460;Varzay;824;17;841
75;Nouvelle-Aquitaine;17;2;17;461;Vaux-sur-Mer;3862;80;3942
75;Nouvelle-Aquitaine;17;4;02;462;Vénérand;762;15;777
75;Nouvelle-Aquitaine;17;2;25;463;Vergeroux;1218;21;1239
75;Nouvelle-Aquitaine;17;5;18;465;La Vergne;588;8;596
75;Nouvelle-Aquitaine;17;5;18;464;Vergné;144;6;150
75;Nouvelle-Aquitaine;17;3;06;466;Vérines;2271;32;2303
75;Nouvelle-Aquitaine;17;5;11;467;Vervant;236;2;238
75;Nouvelle-Aquitaine;17;1;07;468;Vibrac;150;3;153
75;Nouvelle-Aquitaine;17;4;21;469;Villars-en-Pons;570;12;582
75;Nouvelle-Aquitaine;17;4;02;470;Villars-les-Bois;235;9;244
75;Nouvelle-Aquitaine;17;5;11;471;La Villedieu;208;3;211
75;Nouvelle-Aquitaine;17;3;09;472;Villedoux;2235;17;2252
75;Nouvelle-Aquitaine;17;5;11;473;Villemorin;107;0;107
75;Nouvelle-Aquitaine;17;5;18;474;Villeneuve-la-Comtesse;740;15;755
75;Nouvelle-Aquitaine;17;1;07;476;Villexavier;272;3;275
75;Nouvelle-Aquitaine;17;5;11;477;Villiers-Couture;112;1;113
75;Nouvelle-Aquitaine;17;5;11;478;Vinax;60;1;61
75;Nouvelle-Aquitaine;17;4;21;479;Virollet;288;4;292
75;Nouvelle-Aquitaine;17;2;23;480;Virson;762;10;772
75;Nouvelle-Aquitaine;17;5;18;481;Voissay;160;3;163
75;Nouvelle-Aquitaine;17;2;23;482;Vouhé;646;11;657
75;Nouvelle-Aquitaine;17;3;03;483;Yves;1482;26;1508
24;Centre-Val de Loire;18;1;15;001;Achères;377;8;385
24;Centre-Val de Loire;18;2;08;002;Ainay-le-Vieil;188;4;192
24;Centre-Val de Loire;18;1;14;003;Les Aix-d'Angillon;1903;28;1931
24;Centre-Val de Loire;18;1;15;004;Allogny;1043;18;1061
24;Centre-Val de Loire;18;3;11;005;Allouis;1069;21;1090
24;Centre-Val de Loire;18;1;17;006;Annoix;235;2;237
24;Centre-Val de Loire;18;2;10;007;Apremont-sur-Allier;71;3;74
24;Centre-Val de Loire;18;2;08;009;Arcomps;294;11;305
24;Centre-Val de Loire;18;2;08;010;Ardenais;200;7;207
24;Centre-Val de Loire;18;3;01;011;Argent-sur-Sauldre;2082;40;2122
24;Centre-Val de Loire;18;1;02;012;Argenvières;450;5;455
24;Centre-Val de Loire;18;2;09;013;Arpheuilles;301;5;306
24;Centre-Val de Loire;18;1;17;008;Arçay;505;10;515
24;Centre-Val de Loire;18;1;16;014;Assigny;148;7;155
24;Centre-Val de Loire;18;3;01;015;Aubigny-sur-Nère;5477;127;5604
24;Centre-Val de Loire;18;1;14;016;Aubinges;397;3;400
24;Centre-Val de Loire;18;2;09;017;Augy-sur-Aubois;289;3;292
24;Centre-Val de Loire;18;1;02;018;Avord;2677;37;2714
24;Centre-Val de Loire;18;1;14;019;Azy;445;7;452
24;Centre-Val de Loire;18;1;16;020;Bannay;882;13;895
24;Centre-Val de Loire;18;2;09;021;Bannegon;274;4;278
24;Centre-Val de Loire;18;1;16;022;Barlieu;347;8;355
24;Centre-Val de Loire;18;1;02;023;Baugy;1693;55;1748
24;Centre-Val de Loire;18;2;08;024;Beddes;96;3;99
24;Centre-Val de Loire;18;1;02;025;Beffes;629;12;641
24;Centre-Val de Loire;18;1;16;026;Belleville-sur-Loire;1034;27;1061
24;Centre-Val de Loire;18;1;02;027;Bengy-sur-Craon;660;67;727
24;Centre-Val de Loire;18;3;11;028;Berry-Bouy;1191;37;1228
24;Centre-Val de Loire;18;2;09;029;Bessais-le-Fromental;302;4;306
24;Centre-Val de Loire;18;3;01;030;Blancafort;1028;22;1050
24;Centre-Val de Loire;18;2;10;031;Blet;574;5;579
24;Centre-Val de Loire;18;1;16;032;Boulleret;1416;37;1453
24;Centre-Val de Loire;18;1;98;033;Bourges;64668;2073;66741
24;Centre-Val de Loire;18;2;12;034;Bouzais;311;9;320
24;Centre-Val de Loire;18;1;14;035;Brécy;1030;24;1054
24;Centre-Val de Loire;18;3;11;036;Brinay;517;7;524
24;Centre-Val de Loire;18;3;01;037;Brinon-sur-Sauldre;979;14;993
24;Centre-Val de Loire;18;2;12;038;Bruère-Allichamps;567;4;571
24;Centre-Val de Loire;18;1;16;039;Bué;316;8;324
24;Centre-Val de Loire;18;2;09;040;Bussy;371;3;374
24;Centre-Val de Loire;18;2;08;041;La Celette;187;2;189
24;Centre-Val de Loire;18;2;12;042;La Celle;349;2;351
24;Centre-Val de Loire;18;2;08;043;La Celle-Condé;199;0;199
24;Centre-Val de Loire;18;3;11;044;Cerbois;426;4;430
24;Centre-Val de Loire;18;2;09;045;Chalivoy-Milon;424;8;432
24;Centre-Val de Loire;18;2;17;046;Chambon;171;3;174
24;Centre-Val de Loire;18;3;01;047;La Chapelle-d'Angillon;621;8;629
24;Centre-Val de Loire;18;2;10;048;La Chapelle-Hugon;385;5;390
24;Centre-Val de Loire;18;1;02;049;La Chapelle-Montlinard;471;8;479
24;Centre-Val de Loire;18;1;13;050;La Chapelle-Saint-Ursin;3609;75;3684
24;Centre-Val de Loire;18;1;14;051;La Chapelotte;143;2;145
24;Centre-Val de Loire;18;2;09;052;Charenton-du-Cher;1026;21;1047
24;Centre-Val de Loire;18;1;02;053;Charentonnay;291;8;299
24;Centre-Val de Loire;18;2;10;054;Charly;247;3;250
24;Centre-Val de Loire;18;1;07;055;Chârost;961;23;984
24;Centre-Val de Loire;18;1;02;056;Chassy;239;5;244
24;Centre-Val de Loire;18;2;08;057;Châteaumeillant;1768;20;1788
24;Centre-Val de Loire;18;2;17;058;Châteauneuf-sur-Cher;1455;19;1474
24;Centre-Val de Loire;18;2;08;059;Le Châtelet;968;12;980
24;Centre-Val de Loire;18;2;09;060;Chaumont;52;2;54
24;Centre-Val de Loire;18;1;02;061;Chaumoux-Marcilly;93;0;93
24;Centre-Val de Loire;18;2;10;062;Le Chautay;280;2;282
24;Centre-Val de Loire;18;2;17;063;Chavannes;167;6;173
24;Centre-Val de Loire;18;3;11;064;Chéry;217;7;224
24;Centre-Val de Loire;18;2;08;065;Chezal-Benoît;827;12;839
24;Centre-Val de Loire;18;1;07;066;Civray;913;15;928
24;Centre-Val de Loire;18;3;01;067;Clémont;715;9;724
24;Centre-Val de Loire;18;2;09;068;Cogny;35;2;37
24;Centre-Val de Loire;18;2;12;069;Colombiers;410;15;425
24;Centre-Val de Loire;18;1;16;070;Concressault;203;2;205
24;Centre-Val de Loire;18;2;09;071;Contres;32;0;32
24;Centre-Val de Loire;18;2;10;072;Cornusse;268;4;272
24;Centre-Val de Loire;18;2;17;073;Corquoy;206;8;214
24;Centre-Val de Loire;18;1;16;074;Couargues;202;4;206
24;Centre-Val de Loire;18;2;10;075;Cours-les-Barres;1024;26;1050
24;Centre-Val de Loire;18;2;09;076;Coust;441;8;449
24;Centre-Val de Loire;18;1;02;077;Couy;359;9;368
24;Centre-Val de Loire;18;1;16;079;Crézancy-en-Sancerre;470;6;476
24;Centre-Val de Loire;18;2;17;078;Crézançay-sur-Cher;58;1;59
24;Centre-Val de Loire;18;2;10;080;Croisy;158;2;160
24;Centre-Val de Loire;18;1;02;081;Crosses;396;3;399
24;Centre-Val de Loire;18;2;10;082;Cuffy;1054;31;1085
24;Centre-Val de Loire;18;2;08;083;Culan;732;7;739
24;Centre-Val de Loire;18;1;16;084;Dampierre-en-Crot;203;4;207
24;Centre-Val de Loire;18;3;19;085;Dampierre-en-Graçay;250;6;256
24;Centre-Val de Loire;18;2;12;086;Drevant;546;17;563
24;Centre-Val de Loire;18;2;09;087;Dun-sur-Auron;3749;78;3827
24;Centre-Val de Loire;18;3;01;088;Ennordres;211;7;218
24;Centre-Val de Loire;18;2;08;089;Épineuil-le-Fleuriel;436;10;446
24;Centre-Val de Loire;18;1;02;090;Étréchy;442;11;453
24;Centre-Val de Loire;18;2;12;091;Farges-Allichamps;245;6;251
24;Centre-Val de Loire;18;1;02;092;Farges-en-Septaine;1007;25;1032
24;Centre-Val de Loire;18;2;08;093;Faverdines;141;3;144
24;Centre-Val de Loire;18;1;16;094;Feux;340;8;348
24;Centre-Val de Loire;18;2;10;095;Flavigny;193;5;198
24;Centre-Val de Loire;18;3;11;096;Foëcy;2091;25;2116
24;Centre-Val de Loire;18;1;15;097;Fussy;1970;32;2002
24;Centre-Val de Loire;18;1;16;098;Gardefort;135;4;139
24;Centre-Val de Loire;18;1;02;099;Garigny;224;3;227
24;Centre-Val de Loire;18;3;19;100;Genouilly;674;16;690
24;Centre-Val de Loire;18;2;10;101;Germigny-l'Exempt;301;10;311
24;Centre-Val de Loire;18;2;09;102;Givardon;300;2;302
24;Centre-Val de Loire;18;3;19;103;Graçay;1441;14;1455
24;Centre-Val de Loire;18;1;02;104;Groises;132;2;134
24;Centre-Val de Loire;18;1;02;105;Gron;458;17;475
24;Centre-Val de Loire;18;2;09;106;Grossouvre;270;3;273
24;Centre-Val de Loire;18;2;12;107;La Groutte;126;8;134
24;Centre-Val de Loire;18;2;10;108;La Guerche-sur-l'Aubois;3225;35;3260
24;Centre-Val de Loire;18;1;14;109;Henrichemont;1743;21;1764
24;Centre-Val de Loire;18;1;02;110;Herry;977;24;1001
24;Centre-Val de Loire;18;1;14;111;Humbligny;186;1;187
24;Centre-Val de Loire;18;2;08;112;Ids-Saint-Roch;291;1;292
24;Centre-Val de Loire;18;2;10;113;Ignol;181;3;184
24;Centre-Val de Loire;18;2;08;114;Ineuil;232;4;236
24;Centre-Val de Loire;18;3;01;115;Ivoy-le-Pré;796;8;804
24;Centre-Val de Loire;18;1;16;116;Jalognes;284;2;286
24;Centre-Val de Loire;18;1;16;117;Jars;503;5;508
24;Centre-Val de Loire;18;2;10;118;Jouet-sur-l'Aubois;1335;35;1370
24;Centre-Val de Loire;18;1;02;119;Jussy-Champagne;199;5;204
24;Centre-Val de Loire;18;1;02;120;Jussy-le-Chaudrier;600;13;613
24;Centre-Val de Loire;18;2;09;121;Lantan;91;2;93
24;Centre-Val de Loire;18;1;17;122;Lapan;210;2;212
24;Centre-Val de Loire;18;3;11;124;Lazenay;327;3;330
24;Centre-Val de Loire;18;1;16;125;Léré;1083;23;1106
24;Centre-Val de Loire;18;1;17;126;Levet;1386;42;1428
24;Centre-Val de Loire;18;2;08;127;Lignières;1357;27;1384
24;Centre-Val de Loire;18;3;11;128;Limeux;163;0;163
24;Centre-Val de Loire;18;1;17;129;Lissay-Lochy;227;6;233
24;Centre-Val de Loire;18;2;08;130;Loye-sur-Arnon;301;6;307
24;Centre-Val de Loire;18;2;10;131;Lugny-Bourbonnais;34;0;34
24;Centre-Val de Loire;18;1;02;132;Lugny-Champagne;139;1;140
24;Centre-Val de Loire;18;1;07;133;Lunery;1576;15;1591
24;Centre-Val de Loire;18;3;11;134;Lury-sur-Arnon;664;16;680
24;Centre-Val de Loire;18;2;08;135;Maisonnais;239;5;244
24;Centre-Val de Loire;18;1;07;137;Mareuil-sur-Arnon;519;10;529
24;Centre-Val de Loire;18;1;13;138;Marmagne;1937;57;1994
24;Centre-Val de Loire;18;1;02;139;Marseilles-lès-Aubigny;656;9;665
24;Centre-Val de Loire;18;2;12;136;Marçais;287;5;292
24;Centre-Val de Loire;18;3;11;140;Massay;1378;24;1402
24;Centre-Val de Loire;18;3;11;141;Mehun-sur-Yèvre;6574;129;6703
24;Centre-Val de Loire;18;2;12;142;Meillant;686;17;703
24;Centre-Val de Loire;18;2;10;143;Menetou-Couture;371;7;378
24;Centre-Val de Loire;18;1;16;144;Menetou-Râtel;475;10;485
24;Centre-Val de Loire;18;1;15;145;Menetou-Salon;1609;40;1649
24;Centre-Val de Loire;18;1;16;146;Ménétréol-sous-Sancerre;315;13;328
24;Centre-Val de Loire;18;3;01;147;Ménétréol-sur-Sauldre;208;3;211
24;Centre-Val de Loire;18;3;11;148;Méreau;2608;62;2670
24;Centre-Val de Loire;18;3;01;149;Méry-ès-Bois;575;13;588
24;Centre-Val de Loire;18;3;19;150;Méry-sur-Cher;686;15;701
24;Centre-Val de Loire;18;1;14;151;Montigny;370;13;383
24;Centre-Val de Loire;18;2;08;152;Montlouis;109;2;111
24;Centre-Val de Loire;18;2;08;153;Morlac;333;3;336
24;Centre-Val de Loire;18;2;10;154;Mornay-Berry;179;4;183
24;Centre-Val de Loire;18;2;09;155;Mornay-sur-Allier;431;9;440
24;Centre-Val de Loire;18;1;14;156;Morogues;437;9;446
24;Centre-Val de Loire;18;1;07;157;Morthomiers;762;24;786
24;Centre-Val de Loire;18;1;02;158;Moulins-sur-Yèvre;853;18;871
24;Centre-Val de Loire;18;3;01;159;Nançay;825;29;854
24;Centre-Val de Loire;18;2;10;160;Nérondes;1474;30;1504
24;Centre-Val de Loire;18;2;09;161;Neuilly-en-Dun;221;2;223
24;Centre-Val de Loire;18;1;14;162;Neuilly-en-Sancerre;251;1;252
24;Centre-Val de Loire;18;1;14;163;Neuvy-Deux-Clochers;272;5;277
24;Centre-Val de Loire;18;2;09;164;Neuvy-le-Barrois;135;3;138
24;Centre-Val de Loire;18;3;01;165;Neuvy-sur-Barangeon;1114;30;1144
24;Centre-Val de Loire;18;1;02;166;Nohant-en-Goût;587;11;598
24;Centre-Val de Loire;18;3;19;167;Nohant-en-Graçay;303;2;305
24;Centre-Val de Loire;18;1;16;168;Le Noyer;218;2;220
24;Centre-Val de Loire;18;2;12;169;Nozières;213;7;220
24;Centre-Val de Loire;18;3;01;170;Oizon;671;14;685
24;Centre-Val de Loire;18;2;12;171;Orcenais;251;4;255
24;Centre-Val de Loire;18;2;12;172;Orval;1806;44;1850
24;Centre-Val de Loire;18;2;09;173;Osmery;254;2;256
24;Centre-Val de Loire;18;1;02;174;Osmoy;262;3;265
24;Centre-Val de Loire;18;2;10;175;Ourouer-les-Bourdelins;616;3;619
24;Centre-Val de Loire;18;1;14;176;Parassy;410;5;415
24;Centre-Val de Loire;18;2;09;177;Parnay;60;0;60
24;Centre-Val de Loire;18;2;08;178;La Perche;202;3;205
24;Centre-Val de Loire;18;1;15;179;Pigny;980;20;1000
24;Centre-Val de Loire;18;1;17;180;Plaimpied-Givaudins;2019;66;2085
24;Centre-Val de Loire;18;1;07;181;Plou;534;8;542
24;Centre-Val de Loire;18;1;07;182;Poisieux;220;5;225
24;Centre-Val de Loire;18;2;09;183;Le Pondy;146;3;149
24;Centre-Val de Loire;18;1;02;184;Précy;347;1;348
24;Centre-Val de Loire;18;3;01;185;Presly;232;1;233
24;Centre-Val de Loire;18;3;11;186;Preuilly;432;8;440
24;Centre-Val de Loire;18;2;08;187;Préveranges;519;9;528
24;Centre-Val de Loire;18;1;07;188;Primelles;248;5;253
24;Centre-Val de Loire;18;1;15;189;Quantilly;475;4;479
24;Centre-Val de Loire;18;3;11;190;Quincy;859;18;877
24;Centre-Val de Loire;18;2;09;191;Raymond;189;2;191
24;Centre-Val de Loire;18;2;08;192;Reigny;246;3;249
24;Centre-Val de Loire;18;2;08;193;Rezay;206;5;211
24;Centre-Val de Loire;18;1;14;194;Rians;967;19;986
24;Centre-Val de Loire;18;2;09;195;Sagonne;194;5;199
24;Centre-Val de Loire;18;2;09;196;Saint-Aignan-des-Noyers;88;2;90
24;Centre-Val de Loire;18;2;12;197;Saint-Amand-Montrond;9531;283;9814
24;Centre-Val de Loire;18;1;07;198;Saint-Ambroix;367;16;383
24;Centre-Val de Loire;18;2;08;199;Saint-Baudel;252;4;256
24;Centre-Val de Loire;18;1;16;200;Saint-Bouize;310;15;325
24;Centre-Val de Loire;18;1;17;201;Saint-Caprais;769;15;784
24;Centre-Val de Loire;18;1;14;202;Saint-Céols;14;0;14
24;Centre-Val de Loire;18;2;08;203;Saint-Christophe-le-Chaudry;101;1;102
24;Centre-Val de Loire;18;2;09;204;Saint-Denis-de-Palin;294;8;302
24;Centre-Val de Loire;18;1;13;205;Saint-Doulchard;9549;238;9787
24;Centre-Val de Loire;18;1;15;206;Saint-Éloy-de-Gy;1538;52;1590
24;Centre-Val de Loire;18;1;07;207;Saint-Florent-sur-Cher;6457;101;6558
24;Centre-Val de Loire;18;2;08;209;Saint-Georges-de-Poisieux;451;15;466
24;Centre-Val de Loire;18;3;19;210;Saint-Georges-sur-la-Prée;608;10;618
24;Centre-Val de Loire;18;1;15;211;Saint-Georges-sur-Moulon;690;12;702
24;Centre-Val de Loire;18;2;09;212;Saint-Germain-des-Bois;630;15;645
24;Centre-Val de Loire;18;1;14;213;Saint-Germain-du-Puy;5079;117;5196
24;Centre-Val de Loire;18;3;19;214;Saint-Hilaire-de-Court;594;2;596
24;Centre-Val de Loire;18;2;10;215;Saint-Hilaire-de-Gondilly;167;2;169
24;Centre-Val de Loire;18;2;08;216;Saint-Hilaire-en-Lignières;487;13;500
24;Centre-Val de Loire;18;2;08;217;Saint-Jeanvrin;149;4;153
24;Centre-Val de Loire;18;1;17;218;Saint-Just;650;5;655
24;Centre-Val de Loire;18;3;15;219;Saint-Laurent;506;11;517
24;Centre-Val de Loire;18;1;02;220;Saint-Léger-le-Petit;352;4;356
24;Centre-Val de Loire;18;2;17;221;Saint-Loup-des-Chaumes;299;2;301
24;Centre-Val de Loire;18;1;15;223;Saint-Martin-d'Auxigny;2415;38;2453
24;Centre-Val de Loire;18;1;02;224;Saint-Martin-des-Champs;300;9;309
24;Centre-Val de Loire;18;2;08;225;Saint-Maur;286;9;295
24;Centre-Val de Loire;18;1;14;226;Saint-Michel-de-Volangis;459;15;474
24;Centre-Val de Loire;18;3;19;228;Saint-Outrille;218;3;221
24;Centre-Val de Loire;18;1;15;229;Saint-Palais;615;19;634
24;Centre-Val de Loire;18;2;08;230;Saint-Pierre-les-Bois;283;11;294
24;Centre-Val de Loire;18;2;09;231;Saint-Pierre-les-Étieux;726;18;744
24;Centre-Val de Loire;18;2;08;232;Saint-Priest-la-Marche;235;3;238
24;Centre-Val de Loire;18;1;16;233;Saint-Satur;1413;49;1462
24;Centre-Val de Loire;18;2;08;234;Saint-Saturnin;424;8;432
24;Centre-Val de Loire;18;2;17;236;Saint-Symphorien;134;2;136
24;Centre-Val de Loire;18;2;08;238;Saint-Vitte;129;3;132
24;Centre-Val de Loire;18;1;16;208;Sainte-Gemme-en-Sancerrois;419;7;426
24;Centre-Val de Loire;18;3;01;227;Sainte-Montaine;177;3;180
24;Centre-Val de Loire;18;1;14;235;Sainte-Solange;1129;18;1147
24;Centre-Val de Loire;18;3;11;237;Sainte-Thorette;479;4;483
24;Centre-Val de Loire;18;1;02;240;Sancergues;648;7;655
24;Centre-Val de Loire;18;1;16;241;Sancerre;1371;34;1405
24;Centre-Val de Loire;18;2;09;242;Sancoins;3025;34;3059
24;Centre-Val de Loire;18;1;16;243;Santranges;405;8;413
24;Centre-Val de Loire;18;1;07;244;Saugy;79;0;79
24;Centre-Val de Loire;18;2;08;245;Saulzais-le-Potier;494;9;503
24;Centre-Val de Loire;18;1;16;246;Savigny-en-Sancerre;1068;21;1089
24;Centre-Val de Loire;18;1;02;247;Savigny-en-Septaine;719;15;734
24;Centre-Val de Loire;18;1;17;248;Senneçay;471;6;477
24;Centre-Val de Loire;18;1;16;249;Sens-Beaujeu;401;14;415
24;Centre-Val de Loire;18;2;17;250;Serruelles;71;2;73
24;Centre-Val de Loire;18;1;02;251;Sévry;60;2;62
24;Centre-Val de Loire;18;2;08;252;Sidiailles;298;5;303
24;Centre-Val de Loire;18;1;14;253;Soulangis;487;13;500
24;Centre-Val de Loire;18;1;17;254;Soye-en-Septaine;596;15;611
24;Centre-Val de Loire;18;1;07;255;Le Subdray;1024;204;1228
24;Centre-Val de Loire;18;1;16;256;Subligny;340;7;347
24;Centre-Val de Loire;18;1;16;258;Sury-en-Vaux;696;16;712
24;Centre-Val de Loire;18;1;16;259;Sury-ès-Bois;276;3;279
24;Centre-Val de Loire;18;1;16;257;Sury-près-Léré;697;14;711
24;Centre-Val de Loire;18;2;10;260;Tendron;90;2;92
24;Centre-Val de Loire;18;2;09;261;Thaumiers;418;7;425
24;Centre-Val de Loire;18;1;16;262;Thauvenay;329;8;337
24;Centre-Val de Loire;18;3;19;263;Thénioux;663;3;666
24;Centre-Val de Loire;18;1;16;264;Thou;78;2;80
24;Centre-Val de Loire;18;2;10;265;Torteron;794;13;807
24;Centre-Val de Loire;18;2;08;266;Touchay;246;6;252
24;Centre-Val de Loire;18;1;17;267;Trouy;3953;116;4069
24;Centre-Val de Loire;18;2;17;268;Uzay-le-Venon;402;10;412
24;Centre-Val de Loire;18;1;16;269;Vailly-sur-Sauldre;653;13;666
24;Centre-Val de Loire;18;2;17;270;Vallenay;726;21;747
24;Centre-Val de Loire;18;1;15;271;Vasselay;1474;33;1507
24;Centre-Val de Loire;18;1;16;272;Veaugues;633;22;655
24;Centre-Val de Loire;18;2;17;273;Venesmes;818;16;834
24;Centre-Val de Loire;18;1;16;274;Verdigny;306;3;309
24;Centre-Val de Loire;18;2;09;275;Vereaux;141;7;148
24;Centre-Val de Loire;18;2;09;276;Vernais;191;1;192
24;Centre-Val de Loire;18;2;09;277;Verneuil;35;0;35
24;Centre-Val de Loire;18;2;08;278;Vesdun;559;10;569
24;Centre-Val de Loire;18;3;99;279;Vierzon;25725;536;26261
24;Centre-Val de Loire;18;1;15;280;Vignoux-sous-les-Aix;725;21;746
24;Centre-Val de Loire;18;3;15;281;Vignoux-sur-Barangeon;2121;38;2159
24;Centre-Val de Loire;18;1;02;282;Villabon;580;13;593
24;Centre-Val de Loire;18;2;08;283;Villecelin;89;0;89
24;Centre-Val de Loire;18;1;16;284;Villegenon;216;4;220
24;Centre-Val de Loire;18;1;07;285;Villeneuve-sur-Cher;432;6;438
24;Centre-Val de Loire;18;1;02;286;Villequiers;473;9;482
24;Centre-Val de Loire;18;1;16;287;Vinon;291;9;300
24;Centre-Val de Loire;18;1;17;288;Vorly;238;7;245
24;Centre-Val de Loire;18;1;02;289;Vornay;592;17;609
24;Centre-Val de Loire;18;3;15;290;Vouzeron;580;10;590
75;Nouvelle-Aquitaine;19;2;15;001;Affieux;357;14;371
75;Nouvelle-Aquitaine;19;3;17;002;Aix;394;8;402
75;Nouvelle-Aquitaine;19;1;10;003;Albignac;246;10;256
75;Nouvelle-Aquitaine;19;2;02;004;Albussac;737;9;746
75;Nouvelle-Aquitaine;19;1;01;005;Allassac;3941;104;4045
75;Nouvelle-Aquitaine;19;3;12;006;Alleyrat;102;0;102
75;Nouvelle-Aquitaine;19;1;02;007;Altillac;852;25;877
75;Nouvelle-Aquitaine;19;3;12;008;Ambrugeat;209;4;213
75;Nouvelle-Aquitaine;19;2;11;009;Les Angles-sur-Corrèze;115;1;116
75;Nouvelle-Aquitaine;19;2;89;010;Argentat-sur-Dordogne;2956;118;3074
75;Nouvelle-Aquitaine;19;1;18;011;Arnac-Pompadour;1134;12;1146
75;Nouvelle-Aquitaine;19;1;10;012;Astaillac;226;5;231
75;Nouvelle-Aquitaine;19;1;10;013;Aubazines;901;22;923
75;Nouvelle-Aquitaine;19;2;02;014;Auriac;226;5;231
75;Nouvelle-Aquitaine;19;1;19;015;Ayen;708;7;715
75;Nouvelle-Aquitaine;19;2;11;016;Bar;304;9;313
75;Nouvelle-Aquitaine;19;2;02;017;Bassignac-le-Bas;89;1;90
75;Nouvelle-Aquitaine;19;2;02;018;Bassignac-le-Haut;168;4;172
75;Nouvelle-Aquitaine;19;1;10;019;Beaulieu-sur-Dordogne ;1290;20;1310
75;Nouvelle-Aquitaine;19;2;15;020;Beaumont;112;8;120
75;Nouvelle-Aquitaine;19;3;12;021;Bellechassagne;89;3;92
75;Nouvelle-Aquitaine;19;1;18;022;Benayes;224;5;229
75;Nouvelle-Aquitaine;19;1;10;023;Beynat;1245;20;1265
75;Nouvelle-Aquitaine;19;1;18;024;Beyssac;606;23;629
75;Nouvelle-Aquitaine;19;1;18;025;Beyssenac;363;4;367
75;Nouvelle-Aquitaine;19;1;10;026;Bilhac;248;4;252
75;Nouvelle-Aquitaine;19;2;12;027;Bonnefond;114;0;114
75;Nouvelle-Aquitaine;19;3;08;028;Bort-les-Orgues;2661;100;2761
75;Nouvelle-Aquitaine;19;1;10;029;Branceilles;279;5;284
75;Nouvelle-Aquitaine;19;1;19;030;Brignac-la-Plaine;971;17;988
75;Nouvelle-Aquitaine;19;1;99;031;Brive-la-Gaillarde;46630;1292;47922
75;Nouvelle-Aquitaine;19;3;12;033;Bugeat;798;12;810
75;Nouvelle-Aquitaine;19;2;02;034;Camps-Saint-Mathurin-Léobazel;228;11;239
75;Nouvelle-Aquitaine;19;1;19;035;Chabrignac;560;19;579
75;Nouvelle-Aquitaine;19;2;15;036;Chamberet;1380;15;1395
75;Nouvelle-Aquitaine;19;2;15;037;Chamboulive;1195;27;1222
75;Nouvelle-Aquitaine;19;2;11;038;Chameyrat;1529;54;1583
75;Nouvelle-Aquitaine;19;3;07;039;Champagnac-la-Noaille;228;7;235
75;Nouvelle-Aquitaine;19;2;14;040;Champagnac-la-Prune;159;5;164
75;Nouvelle-Aquitaine;19;2;14;041;Chanac-les-Mines;460;19;479
75;Nouvelle-Aquitaine;19;2;15;042;Chanteix;619;13;632
75;Nouvelle-Aquitaine;19;1;05;043;La Chapelle-aux-Brocs;435;9;444
75;Nouvelle-Aquitaine;19;1;10;044;La Chapelle-aux-Saints;271;10;281
75;Nouvelle-Aquitaine;19;2;02;045;La Chapelle-Saint-Géraud;198;6;204
75;Nouvelle-Aquitaine;19;3;07;046;Chapelle-Spinasse;114;1;115
75;Nouvelle-Aquitaine;19;1;13;047;Chartrier-Ferrière;366;6;372
75;Nouvelle-Aquitaine;19;2;14;048;Le Chastang;360;12;372
75;Nouvelle-Aquitaine;19;1;13;049;Chasteaux;752;20;772
75;Nouvelle-Aquitaine;19;1;10;050;Chauffour-sur-Vell;415;10;425
75;Nouvelle-Aquitaine;19;3;07;051;Chaumeil;160;4;164
75;Nouvelle-Aquitaine;19;3;12;052;Chavanac;51;1;52
75;Nouvelle-Aquitaine;19;3;12;053;Chaveroche;247;4;251
75;Nouvelle-Aquitaine;19;1;10;054;Chenailler-Mascheix;206;4;210
75;Nouvelle-Aquitaine;19;3;08;055;Chirac-Bellevue;293;12;305
75;Nouvelle-Aquitaine;19;2;14;056;Clergoux;408;12;420
75;Nouvelle-Aquitaine;19;1;10;057;Collonges-la-Rouge;483;19;502
75;Nouvelle-Aquitaine;19;3;12;058;Combressol;343;16;359
75;Nouvelle-Aquitaine;19;1;19;059;Concèze;403;9;412
75;Nouvelle-Aquitaine;19;2;18;060;Condat-sur-Ganaveix;682;12;694
75;Nouvelle-Aquitaine;19;3;08;167;Confolent-Port-Dieu;41;0;41
75;Nouvelle-Aquitaine;19;2;14;061;Cornil;1311;12;1323
75;Nouvelle-Aquitaine;19;2;11;062;Corrèze;1132;48;1180
75;Nouvelle-Aquitaine;19;1;05;063;Cosnac;2976;78;3054
75;Nouvelle-Aquitaine;19;3;17;064;Couffy-sur-Sarsonne;74;2;76
75;Nouvelle-Aquitaine;19;3;17;065;Courteix;69;0;69
75;Nouvelle-Aquitaine;19;1;13;066;Cublac;1715;35;1750
75;Nouvelle-Aquitaine;19;1;10;067;Curemonte;208;9;217
75;Nouvelle-Aquitaine;19;1;09;068;Dampniat;711;6;717
75;Nouvelle-Aquitaine;19;2;02;069;Darazac;139;3;142
75;Nouvelle-Aquitaine;19;3;12;070;Darnets;348;12;360
75;Nouvelle-Aquitaine;19;3;12;071;Davignac;203;3;206
75;Nouvelle-Aquitaine;19;1;01;072;Donzenac;2664;72;2736
75;Nouvelle-Aquitaine;19;3;07;073;Égletons;4316;730;5046
75;Nouvelle-Aquitaine;19;2;15;074;L' Église-aux-Bois;54;0;54
75;Nouvelle-Aquitaine;19;2;14;075;Espagnac;379;14;393
75;Nouvelle-Aquitaine;19;2;18;076;Espartignac;428;9;437
75;Nouvelle-Aquitaine;19;1;13;077;Estivals;127;2;129
75;Nouvelle-Aquitaine;19;1;01;078;Estivaux;427;8;435
75;Nouvelle-Aquitaine;19;2;18;079;Eyburie;495;10;505
75;Nouvelle-Aquitaine;19;3;17;080;Eygurande;686;12;698
75;Nouvelle-Aquitaine;19;2;14;081;Eyrein;503;15;518
75;Nouvelle-Aquitaine;19;2;11;082;Favars;1087;21;1108
75;Nouvelle-Aquitaine;19;3;17;083;Feyt;134;2;136
75;Nouvelle-Aquitaine;19;2;02;084;Forgès;270;12;282
75;Nouvelle-Aquitaine;19;2;11;085;Gimel-les-Cascades;797;17;814
75;Nouvelle-Aquitaine;19;2;02;086;Goulles;333;6;339
75;Nouvelle-Aquitaine;19;2;12;087;Gourdon-Murat;101;3;104
75;Nouvelle-Aquitaine;19;2;12;088;Grandsaigne;52;1;53
75;Nouvelle-Aquitaine;19;2;14;089;Gros-Chastang;184;3;187
75;Nouvelle-Aquitaine;19;2;14;090;Gumond;95;7;102
75;Nouvelle-Aquitaine;19;2;02;091;Hautefage;315;13;328
75;Nouvelle-Aquitaine;19;3;07;092;Le Jardin;79;1;80
75;Nouvelle-Aquitaine;19;1;13;093;Jugeals-Nazareth;968;34;1002
75;Nouvelle-Aquitaine;19;1;19;094;Juillac;1117;25;1142
75;Nouvelle-Aquitaine;19;2;15;095;Lacelle;135;1;136
75;Nouvelle-Aquitaine;19;2;14;096;Ladignac-sur-Rondelles;407;11;418
75;Nouvelle-Aquitaine;19;3;07;097;Lafage-sur-Sombre;129;1;130
75;Nouvelle-Aquitaine;19;2;14;098;Lagarde-Marc-la-Tour ;977;21;998
75;Nouvelle-Aquitaine;19;1;10;099;Lagleygeolle;220;10;230
75;Nouvelle-Aquitaine;19;2;15;100;Lagraulière;1096;23;1119
75;Nouvelle-Aquitaine;19;2;14;101;Laguenne-sur-Avalouze ;1546;47;1593
75;Nouvelle-Aquitaine;19;3;08;102;Lamazière-Basse;298;2;300
75;Nouvelle-Aquitaine;19;3;17;103;Lamazière-Haute;67;2;69
75;Nouvelle-Aquitaine;19;2;18;104;Lamongerie;116;1;117
75;Nouvelle-Aquitaine;19;1;10;105;Lanteuil;496;14;510
75;Nouvelle-Aquitaine;19;3;07;106;Lapleau;373;2;375
75;Nouvelle-Aquitaine;19;1;13;107;Larche;1584;44;1628
75;Nouvelle-Aquitaine;19;3;17;108;Laroche-près-Feyt;61;2;63
75;Nouvelle-Aquitaine;19;1;19;109;Lascaux;224;7;231
75;Nouvelle-Aquitaine;19;3;08;110;Latronche;133;0;133
75;Nouvelle-Aquitaine;19;3;07;111;Laval-sur-Luzège;99;0;99
75;Nouvelle-Aquitaine;19;2;12;112;Lestards;107;0;107
75;Nouvelle-Aquitaine;19;3;08;113;Liginiac;625;40;665
75;Nouvelle-Aquitaine;19;3;12;114;Lignareix;164;10;174
75;Nouvelle-Aquitaine;19;1;10;115;Ligneyrac;301;8;309
75;Nouvelle-Aquitaine;19;1;10;116;Liourdres;250;5;255
75;Nouvelle-Aquitaine;19;1;13;117;Lissac-sur-Couze;712;21;733
75;Nouvelle-Aquitaine;19;2;15;118;Le Lonzac;807;10;817
75;Nouvelle-Aquitaine;19;1;10;119;Lostanges;144;1;145
75;Nouvelle-Aquitaine;19;1;19;120;Louignac;237;1;238
75;Nouvelle-Aquitaine;19;1;18;121;Lubersac;2235;43;2278
75;Nouvelle-Aquitaine;19;2;15;122;Madranges;192;10;202
75;Nouvelle-Aquitaine;19;1;09;123;Malemort;7984;164;8148
75;Nouvelle-Aquitaine;19;1;13;124;Mansac;1442;22;1464
75;Nouvelle-Aquitaine;19;3;07;125;Marcillac-la-Croisille;785;17;802
75;Nouvelle-Aquitaine;19;1;10;126;Marcillac-la-Croze;175;0;175
75;Nouvelle-Aquitaine;19;3;08;128;Margerides;304;6;310
75;Nouvelle-Aquitaine;19;2;18;129;Masseret;671;8;679
75;Nouvelle-Aquitaine;19;3;12;130;Maussac;442;10;452
75;Nouvelle-Aquitaine;19;2;18;131;Meilhards;528;23;551
75;Nouvelle-Aquitaine;19;1;10;132;Ménoire;124;1;125
75;Nouvelle-Aquitaine;19;2;02;133;Mercœur;244;1;245
75;Nouvelle-Aquitaine;19;3;17;134;Merlines;710;21;731
75;Nouvelle-Aquitaine;19;3;08;135;Mestes;352;6;358
75;Nouvelle-Aquitaine;19;3;12;136;Meymac;2322;202;2524
75;Nouvelle-Aquitaine;19;3;11;137;Meyrignac-l'Église;63;0;63
75;Nouvelle-Aquitaine;19;1;10;138;Meyssac;1267;51;1318
75;Nouvelle-Aquitaine;19;3;12;139;Millevaches;78;1;79
75;Nouvelle-Aquitaine;19;2;02;140;Monceaux-sur-Dordogne;638;19;657
75;Nouvelle-Aquitaine;19;3;17;141;Monestier-Merlines;286;6;292
75;Nouvelle-Aquitaine;19;3;08;142;Monestier-Port-Dieu;101;3;104
75;Nouvelle-Aquitaine;19;3;07;143;Montaignac-Saint-Hippolyte;589;14;603
75;Nouvelle-Aquitaine;19;1;18;144;Montgibaud;237;5;242
75;Nouvelle-Aquitaine;19;3;07;145;Moustier-Ventadour;448;77;525
75;Nouvelle-Aquitaine;19;2;11;146;Naves;2314;213;2527
75;Nouvelle-Aquitaine;19;1;13;147;Nespouls;636;14;650
75;Nouvelle-Aquitaine;19;3;08;148;Neuvic;1653;252;1905
75;Nouvelle-Aquitaine;19;2;02;149;Neuville;194;4;198
75;Nouvelle-Aquitaine;19;1;10;150;Noailhac;370;17;387
75;Nouvelle-Aquitaine;19;1;13;151;Noailles;922;18;940
75;Nouvelle-Aquitaine;19;1;10;152;Nonards;441;8;449
75;Nouvelle-Aquitaine;19;1;19;153;Objat;3624;94;3718
75;Nouvelle-Aquitaine;19;2;01;154;Orgnac-sur-Vézère;316;9;325
75;Nouvelle-Aquitaine;19;2;11;155;Orliac-de-Bar;273;5;278
75;Nouvelle-Aquitaine;19;1;10;156;Palazinges;159;2;161
75;Nouvelle-Aquitaine;19;3;08;157;Palisse;224;2;226
75;Nouvelle-Aquitaine;19;2;14;158;Pandrignes;168;4;172
75;Nouvelle-Aquitaine;19;3;12;159;Péret-Bel-Air;90;1;91
75;Nouvelle-Aquitaine;19;3;12;160;Pérols-sur-Vézère;188;2;190
75;Nouvelle-Aquitaine;19;1;19;161;Perpezac-le-Blanc;466;6;472
75;Nouvelle-Aquitaine;19;2;01;162;Perpezac-le-Noir;1198;17;1215
75;Nouvelle-Aquitaine;19;1;10;163;Le Pescher;290;7;297
75;Nouvelle-Aquitaine;19;3;12;164;Peyrelevade;840;11;851
75;Nouvelle-Aquitaine;19;2;15;165;Peyrissac;124;3;127
75;Nouvelle-Aquitaine;19;2;15;166;Pierrefitte;93;0;93
75;Nouvelle-Aquitaine;19;2;12;168;Pradines;86;4;90
75;Nouvelle-Aquitaine;19;1;10;169;Puy-d'Arnac;288;4;292
75;Nouvelle-Aquitaine;19;1;10;170;Queyssac-les-Vignes;206;9;215
75;Nouvelle-Aquitaine;19;2;02;171;Reygade;187;3;190
75;Nouvelle-Aquitaine;19;2;15;172;Rilhac-Treignac;111;5;116
75;Nouvelle-Aquitaine;19;2;02;173;Rilhac-Xaintrie;302;11;313
75;Nouvelle-Aquitaine;19;2;14;174;La Roche-Canillac;135;1;136
75;Nouvelle-Aquitaine;19;3;08;175;Roche-le-Peyroux;95;0;95
75;Nouvelle-Aquitaine;19;3;07;176;Rosiers-d'Égletons;1078;33;1111
75;Nouvelle-Aquitaine;19;1;19;177;Rosiers-de-Juillac;178;4;182
75;Nouvelle-Aquitaine;19;1;01;178;Sadroc;952;22;974
75;Nouvelle-Aquitaine;19;1;10;179;Saillac;203;6;209
75;Nouvelle-Aquitaine;19;3;12;180;Saint-Angel;707;18;725
75;Nouvelle-Aquitaine;19;2;11;181;Saint-Augustin;421;7;428
75;Nouvelle-Aquitaine;19;1;19;182;Saint-Aulaire;770;23;793
75;Nouvelle-Aquitaine;19;1;10;184;Saint-Bazile-de-Meyssac;129;4;133
75;Nouvelle-Aquitaine;19;2;02;186;Saint-Bonnet-Elvert;212;4;216
75;Nouvelle-Aquitaine;19;1;01;188;Saint-Bonnet-l'Enfantier;409;6;415
75;Nouvelle-Aquitaine;19;1;19;187;Saint-Bonnet-la-Rivière;394;5;399
75;Nouvelle-Aquitaine;19;2;02;189;Saint-Bonnet-les-Tours-de-Merle;45;1;46
75;Nouvelle-Aquitaine;19;3;08;190;Saint-Bonnet-près-Bort;192;5;197
75;Nouvelle-Aquitaine;19;1;13;191;Saint-Cernin-de-Larche;650;12;662
75;Nouvelle-Aquitaine;19;2;02;192;Saint-Chamant;494;6;500
75;Nouvelle-Aquitaine;19;2;02;193;Saint-Cirgues-la-Loutre;175;5;180
75;Nouvelle-Aquitaine;19;2;15;194;Saint-Clément;1321;36;1357
75;Nouvelle-Aquitaine;19;1;19;195;Saint-Cyprien;382;6;388
75;Nouvelle-Aquitaine;19;1;19;196;Saint-Cyr-la-Roche;493;20;513
75;Nouvelle-Aquitaine;19;1;18;198;Saint-Éloy-les-Tuileries;103;0;103
75;Nouvelle-Aquitaine;19;3;08;199;Saint-Étienne-aux-Clos;235;5;240
75;Nouvelle-Aquitaine;19;3;08;200;Saint-Étienne-la-Geneste;91;8;99
75;Nouvelle-Aquitaine;19;3;08;201;Saint-Exupéry-les-Roches;595;13;608
75;Nouvelle-Aquitaine;19;3;08;204;Saint-Fréjoux;283;3;286
75;Nouvelle-Aquitaine;19;2;02;205;Saint-Geniez-ô-Merle;89;2;91
75;Nouvelle-Aquitaine;19;3;12;206;Saint-Germain-Lavolps;87;2;89
75;Nouvelle-Aquitaine;19;2;11;207;Saint-Germain-les-Vergnes;1123;32;1155
75;Nouvelle-Aquitaine;19;3;07;208;Saint-Hilaire-Foissac;186;3;189
75;Nouvelle-Aquitaine;19;2;15;209;Saint-Hilaire-les-Courbes;162;2;164
75;Nouvelle-Aquitaine;19;3;08;210;Saint-Hilaire-Luc;68;0;68
75;Nouvelle-Aquitaine;19;2;11;211;Saint-Hilaire-Peyroux;990;20;1010
75;Nouvelle-Aquitaine;19;2;02;212;Saint-Hilaire-Taurieux;103;6;109
75;Nouvelle-Aquitaine;19;2;15;213;Saint-Jal;625;17;642
75;Nouvelle-Aquitaine;19;2;02;214;Saint-Julien-aux-Bois;459;3;462
75;Nouvelle-Aquitaine;19;2;02;215;Saint-Julien-le-Pèlerin;126;2;128
75;Nouvelle-Aquitaine;19;1;18;216;Saint-Julien-le-Vendômois;248;3;251
75;Nouvelle-Aquitaine;19;1;10;217;Saint-Julien-Maumont;155;5;160
75;Nouvelle-Aquitaine;19;2;14;220;Saint-Martial-de-Gimel;484;10;494
75;Nouvelle-Aquitaine;19;2;02;221;Saint-Martial-Entraygues;86;2;88
75;Nouvelle-Aquitaine;19;2;14;222;Saint-Martin-la-Méanne;340;12;352
75;Nouvelle-Aquitaine;19;1;18;223;Saint-Martin-Sepert;271;2;273
75;Nouvelle-Aquitaine;19;3;07;225;Saint-Merd-de-Lapleau;173;2;175
75;Nouvelle-Aquitaine;19;3;12;226;Saint-Merd-les-Oussines;130;3;133
75;Nouvelle-Aquitaine;19;2;11;227;Saint-Mexant;1313;34;1347
75;Nouvelle-Aquitaine;19;3;08;228;Saint-Pantaléon-de-Lapleau;67;1;68
75;Nouvelle-Aquitaine;19;1;13;229;Saint-Pantaléon-de-Larche;4768;92;4860
75;Nouvelle-Aquitaine;19;1;18;230;Saint-Pardoux-Corbier;409;8;417
75;Nouvelle-Aquitaine;19;1;01;234;Saint-Pardoux-l'Ortigier;479;6;485
75;Nouvelle-Aquitaine;19;2;14;231;Saint-Pardoux-la-Croisille;178;2;180
75;Nouvelle-Aquitaine;19;3;17;232;Saint-Pardoux-le-Neuf;77;2;79
75;Nouvelle-Aquitaine;19;3;12;233;Saint-Pardoux-le-Vieux;296;14;310
75;Nouvelle-Aquitaine;19;2;14;235;Saint-Paul;228;6;234
75;Nouvelle-Aquitaine;19;2;14;236;Saint-Priest-de-Gimel;488;10;498
75;Nouvelle-Aquitaine;19;2;02;237;Saint-Privat;1066;22;1088
75;Nouvelle-Aquitaine;19;3;12;238;Saint-Rémy;225;8;233
75;Nouvelle-Aquitaine;19;1;19;239;Saint-Robert;297;7;304
75;Nouvelle-Aquitaine;19;2;15;240;Saint-Salvadour;297;13;310
75;Nouvelle-Aquitaine;19;3;12;241;Saint-Setiers;286;6;292
75;Nouvelle-Aquitaine;19;1;19;242;Saint-Solve;460;17;477
75;Nouvelle-Aquitaine;19;1;18;243;Saint-Sornin-Lavolps;852;17;869
75;Nouvelle-Aquitaine;19;3;12;244;Saint-Sulpice-les-Bois;85;1;86
75;Nouvelle-Aquitaine;19;2;02;245;Saint-Sylvain;134;5;139
75;Nouvelle-Aquitaine;19;1;01;246;Saint-Viance;1868;42;1910
75;Nouvelle-Aquitaine;19;3;08;247;Saint-Victour;190;8;198
75;Nouvelle-Aquitaine;19;2;18;248;Saint-Ybard;689;13;702
75;Nouvelle-Aquitaine;19;3;07;249;Saint-Yrieix-le-Déjalat;342;9;351
75;Nouvelle-Aquitaine;19;1;01;202;Sainte-Féréole;1989;44;2033
75;Nouvelle-Aquitaine;19;2;14;203;Sainte-Fortunade;1779;92;1871
75;Nouvelle-Aquitaine;19;3;08;219;Sainte-Marie-Lapanouze;55;1;56
75;Nouvelle-Aquitaine;19;2;18;250;Salon-la-Tour;664;6;670
75;Nouvelle-Aquitaine;19;3;07;251;Sarran;275;7;282
75;Nouvelle-Aquitaine;19;3;08;252;Sarroux - Saint Julien ;848;16;864
75;Nouvelle-Aquitaine;19;1;19;253;Segonzac;222;2;224
75;Nouvelle-Aquitaine;19;1;18;254;Ségur-le-Château;184;1;185
75;Nouvelle-Aquitaine;19;2;15;255;Seilhac;1758;36;1794
75;Nouvelle-Aquitaine;19;3;08;256;Sérandon;347;6;353
75;Nouvelle-Aquitaine;19;1;10;257;Sérilhac;269;7;276
75;Nouvelle-Aquitaine;19;2;02;258;Servières-le-Château;609;10;619
75;Nouvelle-Aquitaine;19;2;02;259;Sexcles;234;4;238
75;Nouvelle-Aquitaine;19;1;10;260;Sioniac;218;7;225
75;Nouvelle-Aquitaine;19;3;12;261;Sornac;754;15;769
75;Nouvelle-Aquitaine;19;2;15;262;Soudaine-Lavinadière;166;17;183
75;Nouvelle-Aquitaine;19;3;12;263;Soudeilles;295;11;306
75;Nouvelle-Aquitaine;19;3;07;264;Soursac;506;4;510
75;Nouvelle-Aquitaine;19;2;12;265;Tarnac;341;8;349
75;Nouvelle-Aquitaine;19;3;08;266;Thalamy;97;4;101
75;Nouvelle-Aquitaine;19;2;12;268;Toy-Viam;38;0;38
75;Nouvelle-Aquitaine;19;2;15;269;Treignac;1327;77;1404
75;Nouvelle-Aquitaine;19;1;01;270;Troche;554;6;560
75;Nouvelle-Aquitaine;19;1;10;271;Tudeils;242;3;245
75;Nouvelle-Aquitaine;19;2;16;272;Tulle;14705;651;15356
75;Nouvelle-Aquitaine;19;1;13;273;Turenne;825;20;845
75;Nouvelle-Aquitaine;19;1;09;274;Ussac;4186;114;4300
75;Nouvelle-Aquitaine;19;3;17;275;Ussel;9555;368;9923
75;Nouvelle-Aquitaine;19;2;18;276;Uzerche;2796;59;2855
75;Nouvelle-Aquitaine;19;3;08;277;Valiergues;144;5;149
75;Nouvelle-Aquitaine;19;1;09;278;Varetz;2439;42;2481
75;Nouvelle-Aquitaine;19;1;19;279;Vars-sur-Roseix;378;10;388
75;Nouvelle-Aquitaine;19;1;10;280;Végennes;180;4;184
75;Nouvelle-Aquitaine;19;2;15;281;Veix;70;7;77
75;Nouvelle-Aquitaine;19;3;08;283;Veyrières;74;1;75
75;Nouvelle-Aquitaine;19;2;12;284;Viam;90;3;93
75;Nouvelle-Aquitaine;19;2;01;285;Vigeois;1225;29;1254
75;Nouvelle-Aquitaine;19;1;19;286;Vignols;542;9;551
75;Nouvelle-Aquitaine;19;2;07;287;Vitrac-sur-Montane;269;6;275
75;Nouvelle-Aquitaine;19;1;19;288;Voutezac;1248;160;1408
75;Nouvelle-Aquitaine;19;1;19;289;Yssandon;679;8;687
94;Corse;2A;1;08;001;Afa;3181;56;3237
94;Corse;2A;1;98;004;Ajaccio;70817;868;71685
94;Corse;2A;1;05;006;Alata;3350;67;3417
94;Corse;2A;1;11;008;Albitreccia;1738;26;1764
94;Corse;2A;4;09;011;Altagène;52;2;54
94;Corse;2A;1;10;014;Ambiegna;70;1;71
94;Corse;2A;1;08;017;Appietto;1825;37;1862
94;Corse;2A;4;09;018;Arbellara;158;2;160
94;Corse;2A;1;10;019;Arbori;55;0;55
94;Corse;2A;4;11;021;Argiusta-Moriccio;77;1;78
94;Corse;2A;1;10;022;Arro;80;0;80
94;Corse;2A;4;09;024;Aullène;187;1;188
94;Corse;2A;1;11;026;Azilone-Ampaza;187;3;190
94;Corse;2A;1;10;027;Azzana;54;0;54
94;Corse;2A;1;10;028;Balogna;145;6;151
94;Corse;2A;1;08;031;Bastelica;525;6;531
94;Corse;2A;1;05;032;Bastelicaccia;4053;107;4160
94;Corse;2A;4;09;035;Belvédère-Campomoro;162;2;164
94;Corse;2A;4;09;038;Bilia;48;1;49
94;Corse;2A;1;08;040;Bocognano;376;7;383
94;Corse;2A;4;07;041;Bonifacio;3189;55;3244
94;Corse;2A;1;10;048;Calcatoggio;511;5;516
94;Corse;2A;1;11;056;Campo;107;5;112
94;Corse;2A;1;10;060;Cannelle;68;1;69
94;Corse;2A;4;07;061;Carbini;108;1;109
94;Corse;2A;1;08;062;Carbuccia;387;9;396
94;Corse;2A;1;11;064;Cardo-Torgia;32;2;34
94;Corse;2A;1;10;065;Cargèse;1313;22;1335
94;Corse;2A;4;09;066;Cargiaca;57;0;57
94;Corse;2A;1;10;070;Casaglione;394;6;400
94;Corse;2A;4;11;071;Casalabriva;213;5;218
94;Corse;2A;1;11;085;Cauro;1484;37;1521
94;Corse;2A;1;11;089;Ciamannacce;133;0;133
94;Corse;2A;1;10;090;Coggia;688;18;706
94;Corse;2A;1;11;091;Cognocoli-Monticchi;171;1;172
94;Corse;2A;4;06;092;Conca;1134;19;1153
94;Corse;2A;1;11;094;Corrano;72;2;74
94;Corse;2A;1;11;098;Coti-Chiavari;707;9;716
94;Corse;2A;1;11;099;Cozzano;276;0;276
94;Corse;2A;1;10;100;Cristinacce;67;0;67
94;Corse;2A;1;08;103;Cuttoli-Corticchiato;2039;33;2072
94;Corse;2A;1;11;104;Eccica-Suarella;1237;34;1271
94;Corse;2A;1;10;108;Évisa;217;6;223
94;Corse;2A;4;07;114;Figari;1465;28;1493
94;Corse;2A;4;09;115;Foce;154;7;161
94;Corse;2A;1;11;117;Forciolo;80;0;80
94;Corse;2A;4;09;118;Fozzano;208;5;213
94;Corse;2A;1;11;119;Frasseto;130;3;133
94;Corse;2A;4;09;127;Giuncheto;87;2;89
94;Corse;2A;4;09;128;Granace;92;0;92
94;Corse;2A;4;09;129;Grossa;43;1;44
94;Corse;2A;1;11;130;Grosseto-Prugna;3263;53;3316
94;Corse;2A;1;10;131;Guagno;163;2;165
94;Corse;2A;1;11;132;Guargualé;146;1;147
94;Corse;2A;1;11;133;Guitera-les-Bains;150;3;153
94;Corse;2A;4;06;139;Lecci;1786;30;1816
94;Corse;2A;1;10;141;Letia;125;1;126
94;Corse;2A;4;07;142;Levie;667;13;680
94;Corse;2A;1;10;144;Lopigna;104;3;107
94;Corse;2A;4;09;146;Loreto-di-Tallano;53;1;54
94;Corse;2A;1;10;154;Marignana;109;6;115
94;Corse;2A;4;09;158;Mela;28;1;29
94;Corse;2A;4;11;160;Moca-Croce;255;2;257
94;Corse;2A;4;07;163;Monacia-d'Aullène;538;14;552
94;Corse;2A;1;10;174;Murzo;98;3;101
94;Corse;2A;1;08;181;Ocana;628;17;645
94;Corse;2A;1;11;186;Olivese;223;1;224
94;Corse;2A;4;09;189;Olmeto;1211;30;1241
94;Corse;2A;4;09;191;Olmiccia;124;3;127
94;Corse;2A;1;10;196;Orto;53;1;54
94;Corse;2A;1;10;197;Osani;98;0;98
94;Corse;2A;1;10;198;Ota;542;11;553
94;Corse;2A;1;11;200;Palneca;152;3;155
94;Corse;2A;1;10;203;Partinello;100;0;100
94;Corse;2A;1;10;204;Pastricciola;97;1;98
94;Corse;2A;1;08;209;Peri;2011;33;2044
94;Corse;2A;4;11;211;Petreto-Bicchisano;564;17;581
94;Corse;2A;1;10;212;Piana;475;9;484
94;Corse;2A;4;07;215;Pianottoli-Caldarello;904;7;911
94;Corse;2A;1;11;228;Pietrosella;1772;18;1790
94;Corse;2A;1;11;232;Pila-Canale;281;3;284
94;Corse;2A;1;10;240;Poggiolo;112;0;112
94;Corse;2A;4;99;247;Porto-Vecchio;11748;186;11934
94;Corse;2A;4;09;249;Propriano;3706;40;3746
94;Corse;2A;1;11;253;Quasquara;51;0;51
94;Corse;2A;4;09;254;Quenza;195;4;199
94;Corse;2A;1;10;258;Renno;61;4;65
94;Corse;2A;1;10;259;Rezza;58;1;59
94;Corse;2A;1;10;262;Rosazia;49;3;52
94;Corse;2A;4;09;308;Sainte-Lucie-de-Tallano;403;7;410
94;Corse;2A;1;10;266;Salice;90;4;94
94;Corse;2A;1;11;268;Sampolo;80;0;80
94;Corse;2A;4;06;300;San-Gavino-di-Carbini;1097;21;1118
94;Corse;2A;1;10;295;Sant'Andréa-d'Orcino;111;0;111
94;Corse;2A;4;09;310;Santa-Maria-Figaniella;101;0;101
94;Corse;2A;1;11;312;Santa-Maria-Siché;422;10;432
94;Corse;2A;1;10;270;Sari-d'Orcino;337;3;340
94;Corse;2A;4;06;269;Sari-Solenzara;1341;31;1372
94;Corse;2A;1;08;271;Sarrola-Carcopino;3268;51;3319
94;Corse;2A;4;09;272;Sartène;3240;124;3364
94;Corse;2A;1;11;276;Serra-di-Ferro;485;12;497
94;Corse;2A;4;09;278;Serra-di-Scopamène;87;3;90
94;Corse;2A;1;10;279;Serriera;124;0;124
94;Corse;2A;1;10;282;Soccia;147;4;151
94;Corse;2A;4;11;284;Sollacaro;369;5;374
94;Corse;2A;4;09;285;Sorbollano;77;0;77
94;Corse;2A;4;07;288;Sotta;1373;23;1396
94;Corse;2A;1;11;322;Tasso;103;0;103
94;Corse;2A;1;08;323;Tavaco;385;7;392
94;Corse;2A;1;08;324;Tavera;401;4;405
94;Corse;2A;1;08;326;Tolla;123;0;123
94;Corse;2A;1;08;330;Ucciani;502;2;504
94;Corse;2A;1;11;331;Urbalacone;63;0;63
94;Corse;2A;1;08;336;Valle-di-Mezzana;474;10;484
94;Corse;2A;1;08;345;Vero;596;4;600
94;Corse;2A;1;10;348;Vico;902;14;916
94;Corse;2A;4;09;349;Viggianello;810;17;827
94;Corse;2A;1;05;351;Villanova;376;5;381
94;Corse;2A;4;09;357;Zérubia;47;3;50
94;Corse;2A;1;11;358;Zévaco;57;1;58
94;Corse;2A;1;11;359;Zicavo;226;2;228
94;Corse;2A;1;11;360;Zigliara;130;5;135
94;Corse;2A;4;06;362;Zonza;2745;35;2780
94;Corse;2A;4;09;363;Zoza;58;0;58
94;Corse;2B;3;13;002;Aghione;243;4;247
94;Corse;2B;3;14;003;Aiti;27;0;27
94;Corse;2B;3;14;005;Alando;32;2;34
94;Corse;2B;3;14;007;Albertacce;202;3;205
94;Corse;2B;3;13;009;Aléria;2166;26;2192
94;Corse;2B;5;07;010;Algajola;357;6;363
94;Corse;2B;3;13;012;Altiani;49;0;49
94;Corse;2B;3;14;013;Alzi;25;0;25
94;Corse;2B;3;13;015;Ampriani;24;0;24
94;Corse;2B;3;13;016;Antisanti;548;0;548
94;Corse;2B;5;07;020;Aregno;598;15;613
94;Corse;2B;3;14;023;Asco;117;2;119
94;Corse;2B;5;07;025;Avapessa;85;2;87
94;Corse;2B;5;05;029;Barbaggio;302;3;305
94;Corse;2B;2;08;030;Barrettali;133;4;137
94;Corse;2B;2;99;033;Bastia;48044;702;48746
94;Corse;2B;5;15;034;Belgodère;658;9;667
94;Corse;2B;3;14;036;Bigorno;90;0;90
94;Corse;2B;2;05;037;Biguglia;7902;126;8028
94;Corse;2B;3;14;039;Bisinchi;222;2;224
94;Corse;2B;2;06;042;Borgo;8739;140;8879
94;Corse;2B;2;08;043;Brando;1628;39;1667
94;Corse;2B;3;14;045;Bustanico;65;0;65
94;Corse;2B;2;08;046;Cagnano;162;3;165
94;Corse;2B;3;14;047;Calacuccia;276;3;279
94;Corse;2B;5;07;049;Calenzana;2401;29;2430
94;Corse;2B;5;07;050;Calvi;5666;82;5748
94;Corse;2B;3;14;051;Cambia;74;0;74
94;Corse;2B;3;10;052;Campana;19;0;19
94;Corse;2B;3;13;053;Campi;20;2;22
94;Corse;2B;3;14;054;Campile;192;4;196
94;Corse;2B;3;14;055;Campitello;121;1;122
94;Corse;2B;3;10;057;Canale-di-Verde;318;10;328
94;Corse;2B;2;08;058;Canari;317;1;318
94;Corse;2B;3;14;059;Canavaggia;106;1;107
94;Corse;2B;3;10;063;Carcheto-Brustico;31;1;32
94;Corse;2B;3;10;067;Carpineto;33;0;33
94;Corse;2B;3;14;068;Carticasi;26;0;26
94;Corse;2B;3;09;069;Casabianca;95;1;96
94;Corse;2B;3;09;072;Casalta;54;1;55
94;Corse;2B;3;14;073;Casamaccioli;106;0;106
94;Corse;2B;3;11;074;Casanova;398;6;404
94;Corse;2B;3;13;075;Casevecchie;70;2;72
94;Corse;2B;3;09;077;Castellare-di-Casinca;681;5;686
94;Corse;2B;3;14;078;Castellare-di-Mercurio;30;1;31
94;Corse;2B;3;14;079;Castello-di-Rostino;480;1;481
94;Corse;2B;3;14;080;Castifao;145;1;146
94;Corse;2B;3;14;081;Castiglione;43;0;43
94;Corse;2B;3;14;082;Castineta;40;1;41
94;Corse;2B;3;14;083;Castirla;163;2;165
94;Corse;2B;5;07;084;Cateri;224;1;225
94;Corse;2B;2;08;086;Centuri;200;1;201
94;Corse;2B;3;10;087;Cervione;2196;26;2222
94;Corse;2B;3;10;088;Chiatra;212;5;217
94;Corse;2B;3;12;366;Chisa;100;2;102
94;Corse;2B;5;15;093;Corbara;897;32;929
94;Corse;2B;3;14;095;Corscia;128;3;131
94;Corse;2B;3;11;096;Corte;7468;117;7585
94;Corse;2B;5;15;097;Costa;58;1;59
94;Corse;2B;3;09;101;Croce;78;3;81
94;Corse;2B;3;14;102;Crocicchia;74;0;74
94;Corse;2B;3;14;105;Erbajolo;113;0;113
94;Corse;2B;3;14;106;Érone;12;0;12
94;Corse;2B;2;08;107;Ersa;154;1;155
94;Corse;2B;5;08;109;Farinole;233;2;235
94;Corse;2B;3;14;110;Favalello;73;1;74
94;Corse;2B;3;10;111;Felce;52;0;52
94;Corse;2B;5;15;112;Feliceto;229;4;233
94;Corse;2B;3;09;113;Ficaja;54;1;55
94;Corse;2B;3;14;116;Focicchia;27;1;28
94;Corse;2B;2;04;120;Furiani;5628;126;5754
94;Corse;2B;5;07;121;Galéria;349;5;354
94;Corse;2B;3;14;122;Gavignano;55;0;55
94;Corse;2B;3;13;123;Ghisonaccia;4223;55;4278
94;Corse;2B;3;12;124;Ghisoni;211;6;217
94;Corse;2B;3;09;125;Giocatojo;51;0;51
94;Corse;2B;3;13;126;Giuncaggio;68;0;68
94;Corse;2B;5;15;134;L' Île-Rousse;3103;75;3178
94;Corse;2B;3;12;135;Isolaccio-di-Fiumorbo;310;2;312
94;Corse;2B;5;15;136;Lama;146;2;148
94;Corse;2B;3;14;137;Lano;24;0;24
94;Corse;2B;5;07;138;Lavatoggio;149;2;151
94;Corse;2B;3;14;140;Lento;103;0;103
94;Corse;2B;3;13;143;Linguizzetta;1087;8;1095
94;Corse;2B;3;09;145;Loreto-di-Casinca;210;6;216
94;Corse;2B;3;14;147;Lozzi;116;2;118
94;Corse;2B;2;06;148;Lucciana;5893;50;5943
94;Corse;2B;3;12;149;Lugo-di-Nazza;80;1;81
94;Corse;2B;5;07;150;Lumio;1220;37;1257
94;Corse;2B;2;08;152;Luri;842;9;851
94;Corse;2B;5;07;153;Manso;115;2;117
94;Corse;2B;3;13;155;Matra;46;0;46
94;Corse;2B;5;15;156;Mausoléo;20;0;20
94;Corse;2B;3;14;157;Mazzola;29;0;29
94;Corse;2B;2;08;159;Meria;90;1;91
94;Corse;2B;3;13;161;Moïta;70;0;70
94;Corse;2B;3;14;162;Moltifao;693;11;704
94;Corse;2B;3;10;164;Monacia-d'Orezza;24;0;24
94;Corse;2B;5;07;165;Moncale;326;6;332
94;Corse;2B;3;14;166;Monte;619;5;624
94;Corse;2B;5;07;167;Montegrosso;426;14;440
94;Corse;2B;5;15;168;Monticello;1936;41;1977
94;Corse;2B;3;14;169;Morosaglia;986;10;996
94;Corse;2B;2;08;170;Morsiglia;111;2;113
94;Corse;2B;3;11;171;Muracciole;34;1;35
94;Corse;2B;5;05;172;Murato;588;7;595
94;Corse;2B;5;15;173;Muro;242;3;245
94;Corse;2B;5;15;175;Nessa;108;2;110
94;Corse;2B;3;10;176;Nocario;69;2;71
94;Corse;2B;3;12;177;Noceta;61;2;63
94;Corse;2B;2;08;178;Nonza;74;2;76
94;Corse;2B;3;10;179;Novale;62;0;62
94;Corse;2B;5;15;180;Novella;80;1;81
94;Corse;2B;5;15;182;Occhiatana;250;2;252
94;Corse;2B;2;08;183;Ogliastro;97;2;99
94;Corse;2B;2;08;184;Olcani;86;1;87
94;Corse;2B;5;05;185;Oletta;1739;14;1753
94;Corse;2B;2;08;187;Olmeta-di-Capocorso;138;1;139
94;Corse;2B;5;05;188;Olmeta-di-Tuda;514;9;523
94;Corse;2B;5;15;190;Olmi-Cappella;183;5;188
94;Corse;2B;3;14;192;Olmo;156;1;157
94;Corse;2B;3;14;193;Omessa;593;3;596
94;Corse;2B;3;10;194;Ortale;25;0;25
94;Corse;2B;3;14;195;Ortiporio;125;1;126
94;Corse;2B;5;15;199;Palasca;177;5;182
94;Corse;2B;3;13;201;Pancheraccia;192;1;193
94;Corse;2B;3;10;202;Parata;23;0;23
94;Corse;2B;5;08;205;Patrimonio;841;12;853
94;Corse;2B;3;14;206;Penta-Acquatella;35;0;35
94;Corse;2B;3;09;207;Penta-di-Casinca;3386;40;3426
94;Corse;2B;3;10;208;Perelli;110;0;110
94;Corse;2B;3;09;210;Pero-Casevecchie;120;0;120
94;Corse;2B;3;13;213;Pianello;66;0;66
94;Corse;2B;3;09;214;Piano;25;0;25
94;Corse;2B;3;10;216;Piazzali;18;0;18
94;Corse;2B;3;10;217;Piazzole;41;3;44
94;Corse;2B;3;10;222;Pie-d'Orezza;38;0;38
94;Corse;2B;3;13;218;Piedicorte-di-Gaggio;97;3;100
94;Corse;2B;3;10;219;Piedicroce;91;1;92
94;Corse;2B;3;14;220;Piedigriggio;135;3;138
94;Corse;2B;3;10;221;Piedipartino;16;0;16
94;Corse;2B;3;10;225;Pietra-di-Verde;101;2;103
94;Corse;2B;2;08;224;Pietracorbara;653;11;664
94;Corse;2B;5;14;223;Pietralba;503;3;506
94;Corse;2B;3;13;226;Pietraserena;65;1;66
94;Corse;2B;3;10;227;Pietricaggio;34;1;35
94;Corse;2B;3;12;229;Pietroso;319;0;319
94;Corse;2B;5;05;230;Piève;109;5;114
94;Corse;2B;5;15;231;Pigna;98;5;103
94;Corse;2B;2;08;233;Pino;166;2;168
94;Corse;2B;3;10;234;Piobetta;19;0;19
94;Corse;2B;5;15;235;Pioggiola;86;0;86
94;Corse;2B;5;05;239;Poggio-d'Oletta;213;11;224
94;Corse;2B;3;12;236;Poggio-di-Nazza;178;3;181
94;Corse;2B;3;11;238;Poggio-di-Venaco;213;8;221
94;Corse;2B;3;09;241;Poggio-Marinaccio;31;1;32
94;Corse;2B;3;10;242;Poggio-Mezzana;690;13;703
94;Corse;2B;3;09;243;Polveroso;42;0;42
94;Corse;2B;3;14;244;Popolasca;42;0;42
94;Corse;2B;3;09;245;Porri;43;1;44
94;Corse;2B;3;09;246;La Porta;193;1;194
94;Corse;2B;3;14;248;Prato-di-Giovellina;41;1;42
94;Corse;2B;3;14;250;Prunelli-di-Casacconi;151;0;151
94;Corse;2B;3;12;251;Prunelli-di-Fiumorbo;3663;40;3703
94;Corse;2B;3;09;252;Pruno;179;2;181
94;Corse;2B;3;09;255;Quercitello;43;0;43
94;Corse;2B;3;10;256;Rapaggio;26;0;26
94;Corse;2B;5;05;257;Rapale;156;0;156
94;Corse;2B;3;11;260;Riventosa;157;3;160
94;Corse;2B;2;08;261;Rogliano;550;11;561
94;Corse;2B;3;12;263;Rospigliani;70;5;75
94;Corse;2B;3;14;264;Rusio;66;1;67
94;Corse;2B;5;05;265;Rutali;369;6;375
94;Corse;2B;5;05;298;Saint-Florent;1675;19;1694
94;Corse;2B;3;14;267;Saliceto;45;3;48
94;Corse;2B;3;09;297;San-Damiano;59;0;59
94;Corse;2B;3;09;299;San-Gavino-d'Ampugnani;106;1;107
94;Corse;2B;3;12;365;San-Gavino-di-Fiumorbo;106;2;108
94;Corse;2B;5;05;301;San-Gavino-di-Tenda;61;1;62
94;Corse;2B;3;10;302;San-Giovanni-di-Moriani;92;2;94
94;Corse;2B;3;10;303;San-Giuliano;749;6;755
94;Corse;2B;3;14;304;San-Lorenzo;143;0;143
94;Corse;2B;2;08;305;San-Martino-di-Lota;2896;42;2938
94;Corse;2B;3;10;313;San-Nicolao;2031;22;2053
94;Corse;2B;3;14;292;Sant'Andréa-di-Bozio;71;2;73
94;Corse;2B;3;10;293;Sant'Andréa-di-Cotone;215;2;217
94;Corse;2B;5;07;296;Sant'Antonino;130;5;135
94;Corse;2B;3;14;306;Santa-Lucia-di-Mercurio;121;0;121
94;Corse;2B;3;10;307;Santa-Lucia-di-Moriani;1460;29;1489
94;Corse;2B;2;08;309;Santa-Maria-di-Lota;1805;69;1874
94;Corse;2B;3;10;311;Santa-Maria-Poggio;767;11;778
94;Corse;2B;5;15;316;Santa-Reparata-di-Balagna;1001;15;1016
94;Corse;2B;3;10;317;Santa-Reparata-di-Moriani;57;0;57
94;Corse;2B;5;05;314;Santo-Pietro-di-Tenda;353;1;354
94;Corse;2B;3;11;315;Santo-Pietro-di-Venaco;277;5;282
94;Corse;2B;3;09;273;Scata;45;5;50
94;Corse;2B;3;14;274;Scolca;97;1;98
94;Corse;2B;3;14;275;Sermano;67;2;69
94;Corse;2B;3;12;277;Serra-di-Fiumorbo;339;3;342
94;Corse;2B;3;09;280;Silvareccio;122;0;122
94;Corse;2B;2;08;281;Sisco;1167;9;1176
94;Corse;2B;3;12;283;Solaro;714;13;727
94;Corse;2B;3;09;286;Sorbo-Ocagnano;864;8;872
94;Corse;2B;5;05;287;Sorio;144;0;144
94;Corse;2B;3;14;289;Soveria;117;0;117
94;Corse;2B;5;15;290;Speloncato;280;4;284
94;Corse;2B;3;10;291;Stazzona;37;1;38
94;Corse;2B;3;09;318;Taglio-Isolaccio;579;12;591
94;Corse;2B;3;09;319;Talasani;790;7;797
94;Corse;2B;3;13;320;Tallone;298;2;300
94;Corse;2B;3;10;321;Tarrano;16;0;16
94;Corse;2B;2;08;327;Tomino;198;3;201
94;Corse;2B;3;13;328;Tox;96;0;96
94;Corse;2B;3;14;329;Tralonca;111;1;112
94;Corse;2B;5;15;332;Urtaca;230;3;233
94;Corse;2B;3;10;334;Valle-d'Alesani;108;1;109
94;Corse;2B;3;10;338;Valle-d'Orezza;36;0;36
94;Corse;2B;3;10;335;Valle-di-Campoloro;353;7;360
94;Corse;2B;3;14;337;Valle-di-Rostino;130;0;130
94;Corse;2B;5;05;333;Vallecalle;137;3;140
94;Corse;2B;5;15;339;Vallica;26;0;26
94;Corse;2B;3;10;340;Velone-Orneto;123;0;123
94;Corse;2B;3;11;341;Venaco;712;17;729
94;Corse;2B;3;12;342;Ventiseri;2464;45;2509
94;Corse;2B;3;09;343;Venzolasca;1796;14;1810
94;Corse;2B;3;10;344;Verdèse;40;2;42
94;Corse;2B;3;09;346;Vescovato;2855;32;2887
94;Corse;2B;3;12;347;Vezzani;264;0;264
94;Corse;2B;2;06;350;Vignale;177;3;180
94;Corse;2B;5;15;352;Ville-di-Paraso;211;5;216
94;Corse;2B;2;01;353;Ville-di-Pietrabugno;3318;87;3405
94;Corse;2B;3;11;354;Vivario;430;5;435
94;Corse;2B;3;14;355;Volpajola;359;7;366
94;Corse;2B;3;13;356;Zalana;143;1;144
94;Corse;2B;5;07;361;Zilia;288;5;293
94;Corse;2B;3;13;364;Zuani;32;0;32
27;Bourgogne-Franche-Comté;21;1;20;001;Agencourt;462;52;514
27;Bourgogne-Franche-Comté;21;2;23;002;Agey;268;3;271
27;Bourgogne-Franche-Comté;21;2;14;003;Ahuy;1337;25;1362
27;Bourgogne-Franche-Comté;21;3;05;004;Aignay-le-Duc;275;7;282
27;Bourgogne-Franche-Comté;21;2;15;005;Aiserey;1425;16;1441
27;Bourgogne-Franche-Comté;21;3;05;006;Aisey-sur-Seine;173;1;174
27;Bourgogne-Franche-Comté;21;3;22;007;Aisy-sous-Thil;226;30;256
27;Bourgogne-Franche-Comté;21;3;19;008;Alise-Sainte-Reine;571;7;578
27;Bourgogne-Franche-Comté;21;1;01;009;Allerey;173;1;174
27;Bourgogne-Franche-Comté;21;1;17;010;Aloxe-Corton;135;6;141
27;Bourgogne-Franche-Comté;21;3;05;012;Ampilly-le-Sec;345;13;358
27;Bourgogne-Franche-Comté;21;3;05;011;Ampilly-les-Bordes;83;0;83
27;Bourgogne-Franche-Comté;21;2;23;013;Ancey;446;7;453
27;Bourgogne-Franche-Comté;21;1;01;014;Antheuil;61;0;61
27;Bourgogne-Franche-Comté;21;1;01;015;Antigny-la-Ville;94;0;94
27;Bourgogne-Franche-Comté;21;2;21;021;Arc-sur-Tille;2649;50;2699
27;Bourgogne-Franche-Comté;21;2;21;016;Arceau;926;18;944
27;Bourgogne-Franche-Comté;21;1;20;017;Arcenant;505;18;523
27;Bourgogne-Franche-Comté;21;2;23;018;Arcey;53;1;54
27;Bourgogne-Franche-Comté;21;1;01;020;Arconcey;223;8;231
27;Bourgogne-Franche-Comté;21;1;20;022;Argilly;526;12;538
27;Bourgogne-Franche-Comté;21;1;01;023;Arnay-le-Duc;1396;31;1427
27;Bourgogne-Franche-Comté;21;3;22;024;Arnay-sous-Vitteaux;111;0;111
27;Bourgogne-Franche-Comté;21;3;19;025;Arrans;70;2;72
27;Bourgogne-Franche-Comté;21;3;19;026;Asnières-en-Montagne;190;9;199
27;Bourgogne-Franche-Comté;21;2;14;027;Asnières-lès-Dijon;1284;26;1310
27;Bourgogne-Franche-Comté;21;2;02;028;Athée;781;10;791
27;Bourgogne-Franche-Comté;21;3;19;029;Athie;73;1;74
27;Bourgogne-Franche-Comté;21;1;01;030;Aubaine;91;3;94
27;Bourgogne-Franche-Comté;21;1;04;031;Aubigny-en-Plaine;520;5;525
27;Bourgogne-Franche-Comté;21;1;01;032;Aubigny-la-Ronce;168;5;173
27;Bourgogne-Franche-Comté;21;2;23;033;Aubigny-lès-Sombernon;151;5;156
27;Bourgogne-Franche-Comté;21;3;05;034;Autricourt;128;2;130
27;Bourgogne-Franche-Comté;21;1;04;035;Auvillars-sur-Saône;328;4;332
27;Bourgogne-Franche-Comté;21;1;01;036;Auxant;76;3;79
27;Bourgogne-Franche-Comté;21;1;17;037;Auxey-Duresses;300;12;312
27;Bourgogne-Franche-Comté;21;2;02;038;Auxonne;7609;85;7694
27;Bourgogne-Franche-Comté;21;2;16;039;Avelanges;37;0;37
27;Bourgogne-Franche-Comté;21;3;22;040;Avosnes;91;5;96
27;Bourgogne-Franche-Comté;21;2;16;041;Avot;185;2;187
27;Bourgogne-Franche-Comté;21;1;04;042;Bagnot;161;4;165
27;Bourgogne-Franche-Comté;21;3;05;043;Baigneux-les-Juifs;236;30;266
27;Bourgogne-Franche-Comté;21;3;05;044;Balot;98;1;99
27;Bourgogne-Franche-Comté;21;2;23;045;Barbirey-sur-Ouche;213;8;221
27;Bourgogne-Franche-Comté;21;1;01;046;Bard-le-Régulier;70;2;72
27;Bourgogne-Franche-Comté;21;3;22;047;Bard-lès-Époisses;70;1;71
27;Bourgogne-Franche-Comté;21;1;20;048;Barges;637;10;647
27;Bourgogne-Franche-Comté;21;2;16;049;Barjon;42;2;44
27;Bourgogne-Franche-Comté;21;1;01;050;Baubigny;204;6;210
27;Bourgogne-Franche-Comté;21;2;23;051;Baulme-la-Roche;87;3;90
27;Bourgogne-Franche-Comté;21;3;05;052;Beaulieu;26;4;30
27;Bourgogne-Franche-Comté;21;2;21;053;Beaumont-sur-Vingeanne;200;4;204
27;Bourgogne-Franche-Comté;21;1;03;054;Beaune;20711;761;21472
27;Bourgogne-Franche-Comté;21;3;05;055;Beaunotte;16;0;16
27;Bourgogne-Franche-Comté;21;2;21;056;Beire-le-Châtel;867;10;877
27;Bourgogne-Franche-Comté;21;2;15;057;Beire-le-Fort;349;5;354
27;Bourgogne-Franche-Comté;21;3;05;058;Belan-sur-Ource;250;5;255
27;Bourgogne-Franche-Comté;21;2;14;059;Bellefond;876;24;900
27;Bourgogne-Franche-Comté;21;2;21;060;Belleneuve;1621;18;1639
27;Bourgogne-Franche-Comté;21;3;05;061;Bellenod-sur-Seine;71;2;73
27;Bourgogne-Franche-Comté;21;1;01;062;Bellenot-sous-Pouilly;221;9;230
27;Bourgogne-Franche-Comté;21;3;05;063;Beneuvre;90;5;95
27;Bourgogne-Franche-Comté;21;3;19;064;Benoisey;110;0;110
27;Bourgogne-Franche-Comté;21;1;01;065;Bessey-en-Chaume;136;4;140
27;Bourgogne-Franche-Comté;21;1;01;066;Bessey-la-Cour;54;1;55
27;Bourgogne-Franche-Comté;21;2;15;067;Bessey-lès-Cîteaux;693;9;702
27;Bourgogne-Franche-Comté;21;1;01;068;Beurey-Bauguay;105;7;112
27;Bourgogne-Franche-Comté;21;3;22;069;Beurizot;121;1;122
27;Bourgogne-Franche-Comté;21;1;18;070;Bévy;139;4;143
27;Bourgogne-Franche-Comté;21;2;21;071;Bèze;708;20;728
27;Bourgogne-Franche-Comté;21;2;21;072;Bézouotte;198;4;202
27;Bourgogne-Franche-Comté;21;2;02;074;Billey;260;4;264
27;Bourgogne-Franche-Comté;21;3;05;075;Billy-lès-Chanceaux;65;1;66
27;Bourgogne-Franche-Comté;21;2;02;076;Binges;808;8;816
27;Bourgogne-Franche-Comté;21;3;05;077;Bissey-la-Côte;124;2;126
27;Bourgogne-Franche-Comté;21;3;05;078;Bissey-la-Pierre;76;2;78
27;Bourgogne-Franche-Comté;21;2;21;079;Blagny-sur-Vingeanne;131;0;131
27;Bourgogne-Franche-Comté;21;2;23;080;Blaisy-Bas;657;13;670
27;Bourgogne-Franche-Comté;21;2;23;081;Blaisy-Haut;129;1;130
27;Bourgogne-Franche-Comté;21;1;01;082;Blancey;69;2;71
27;Bourgogne-Franche-Comté;21;1;01;083;Blanot;125;1;126
27;Bourgogne-Franche-Comté;21;2;14;085;Bligny-le-Sec;144;3;147
27;Bourgogne-Franche-Comté;21;1;17;086;Bligny-lès-Beaune;1230;29;1259
27;Bourgogne-Franche-Comté;21;1;01;087;Bligny-sur-Ouche;821;11;832
27;Bourgogne-Franche-Comté;21;1;20;088;Boncourt-le-Bois;284;7;291
27;Bourgogne-Franche-Comté;21;1;04;089;Bonnencontre;441;6;447
27;Bourgogne-Franche-Comté;21;3;05;090;Boudreville;61;3;64
27;Bourgogne-Franche-Comté;21;1;01;091;Bouhey;41;0;41
27;Bourgogne-Franche-Comté;21;1;17;092;Bouilland;216;5;221
27;Bourgogne-Franche-Comté;21;3;05;093;Bouix;154;4;158
27;Bourgogne-Franche-Comté;21;2;21;094;Bourberain;398;4;402
27;Bourgogne-Franche-Comté;21;1;04;095;Bousselange;47;1;48
27;Bourgogne-Franche-Comté;21;2;16;096;Boussenois;112;1;113
27;Bourgogne-Franche-Comté;21;3;22;097;Boussey;36;2;38
27;Bourgogne-Franche-Comté;21;3;19;098;Boux-sous-Salmaise;125;2;127
27;Bourgogne-Franche-Comté;21;1;17;099;Bouze-lès-Beaune;313;6;319
27;Bourgogne-Franche-Comté;21;3;22;100;Brain;34;0;34
27;Bourgogne-Franche-Comté;21;3;22;101;Braux;167;4;171
27;Bourgogne-Franche-Comté;21;1;01;102;Brazey-en-Morvan;139;3;142
27;Bourgogne-Franche-Comté;21;1;04;103;Brazey-en-Plaine;2371;43;2414
27;Bourgogne-Franche-Comté;21;3;05;104;Brémur-et-Vaurois;47;0;47
27;Bourgogne-Franche-Comté;21;2;07;105;Bressey-sur-Tille;1120;12;1132
27;Bourgogne-Franche-Comté;21;2;18;106;Bretenière;925;12;937
27;Bourgogne-Franche-Comté;21;2;14;107;Bretigny;904;24;928
27;Bourgogne-Franche-Comté;21;3;22;108;Brianny;118;1;119
27;Bourgogne-Franche-Comté;21;3;05;109;Brion-sur-Ource;230;7;237
27;Bourgogne-Franche-Comté;21;1;18;110;Brochon;625;130;755
27;Bourgogne-Franche-Comté;21;2;14;111;Brognon;313;3;316
27;Bourgogne-Franche-Comté;21;1;04;112;Broin;423;9;432
27;Bourgogne-Franche-Comté;21;1;20;113;Broindon;203;1;204
27;Bourgogne-Franche-Comté;21;3;19;114;Buffon;168;1;169
27;Bourgogne-Franche-Comté;21;3;05;115;Buncey;374;7;381
27;Bourgogne-Franche-Comté;21;3;05;116;Bure-les-Templiers;134;0;134
27;Bourgogne-Franche-Comté;21;3;05;117;Busseaut;48;2;50
27;Bourgogne-Franche-Comté;21;2;16;118;Busserotte-et-Montenaille;22;4;26
27;Bourgogne-Franche-Comté;21;1;01;120;La Bussière-sur-Ouche;159;2;161
27;Bourgogne-Franche-Comté;21;2;16;119;Bussières;42;0;42
27;Bourgogne-Franche-Comté;21;2;23;121;Bussy-la-Pesle;77;1;78
27;Bourgogne-Franche-Comté;21;3;19;122;Bussy-le-Grand;315;8;323
27;Bourgogne-Franche-Comté;21;3;05;123;Buxerolles;32;5;37
27;Bourgogne-Franche-Comté;21;1;01;124;Censerey;173;6;179
27;Bourgogne-Franche-Comté;21;3;05;125;Cérilly;226;8;234
27;Bourgogne-Franche-Comté;21;2;15;126;Cessey-sur-Tille;618;7;625
27;Bourgogne-Franche-Comté;21;2;16;127;Chaignay;516;8;524
27;Bourgogne-Franche-Comté;21;1;01;128;Chailly-sur-Armançon;244;11;255
27;Bourgogne-Franche-Comté;21;3;05;129;Chambain;23;0;23
27;Bourgogne-Franche-Comté;21;2;15;130;Chambeire;392;4;396
27;Bourgogne-Franche-Comté;21;1;04;131;Chamblanc;460;63;523
27;Bourgogne-Franche-Comté;21;1;18;133;Chambolle-Musigny;295;7;302
27;Bourgogne-Franche-Comté;21;1;18;132;Chambœuf;390;6;396
27;Bourgogne-Franche-Comté;21;3;05;134;Chamesson;248;9;257
27;Bourgogne-Franche-Comté;21;3;19;137;Champ-d'Oiseau;94;1;95
27;Bourgogne-Franche-Comté;21;2;21;135;Champagne-sur-Vingeanne;313;8;321
27;Bourgogne-Franche-Comté;21;2;14;136;Champagny;27;0;27
27;Bourgogne-Franche-Comté;21;2;02;138;Champdôtre;602;8;610
27;Bourgogne-Franche-Comté;21;3;22;139;Champeau-en-Morvan;226;5;231
27;Bourgogne-Franche-Comté;21;1;01;140;Champignolles;75;1;76
27;Bourgogne-Franche-Comté;21;3;22;141;Champrenault;35;1;36
27;Bourgogne-Franche-Comté;21;2;16;142;Chanceaux;215;4;219
27;Bourgogne-Franche-Comté;21;3;05;143;Channay;65;3;68
27;Bourgogne-Franche-Comté;21;3;19;144;Charencey;36;0;36
27;Bourgogne-Franche-Comté;21;3;22;145;Charigny;34;1;35
27;Bourgogne-Franche-Comté;21;2;21;146;Charmes;131;3;134
27;Bourgogne-Franche-Comté;21;3;22;147;Charny;34;1;35
27;Bourgogne-Franche-Comté;21;1;04;148;Charrey-sur-Saône;350;1;351
27;Bourgogne-Franche-Comté;21;3;05;149;Charrey-sur-Seine;142;4;146
27;Bourgogne-Franche-Comté;21;1;17;150;Chassagne-Montrachet;302;11;313
27;Bourgogne-Franche-Comté;21;3;22;151;Chassey;87;5;92
27;Bourgogne-Franche-Comté;21;1;01;152;Châteauneuf;82;2;84
27;Bourgogne-Franche-Comté;21;1;01;153;Châtellenot;153;6;159
27;Bourgogne-Franche-Comté;21;3;05;154;Châtillon-sur-Seine;5354;350;5704
27;Bourgogne-Franche-Comté;21;1;01;155;Chaudenay-la-Ville;43;6;49
27;Bourgogne-Franche-Comté;21;1;01;156;Chaudenay-le-Château;50;0;50
27;Bourgogne-Franche-Comté;21;3;05;157;Chaugey;16;0;16
27;Bourgogne-Franche-Comté;21;3;05;159;La Chaume;100;4;104
27;Bourgogne-Franche-Comté;21;2;21;158;Chaume-et-Courchamp;179;5;184
27;Bourgogne-Franche-Comté;21;3;05;160;Chaume-lès-Baigneux;96;1;97
27;Bourgogne-Franche-Comté;21;3;05;161;Chaumont-le-Bois;80;5;85
27;Bourgogne-Franche-Comté;21;1;20;162;Chaux;484;8;492
27;Bourgogne-Franche-Comté;21;2;16;163;Chazeuil;195;5;200
27;Bourgogne-Franche-Comté;21;1;01;164;Chazilly;141;3;144
27;Bourgogne-Franche-Comté;21;3;05;165;Chemin-d'Aisey;74;4;78
27;Bourgogne-Franche-Comté;21;2;06;166;Chenôve;14216;185;14401
27;Bourgogne-Franche-Comté;21;2;21;167;Cheuge;127;4;131
27;Bourgogne-Franche-Comté;21;3;22;168;Chevannay;42;0;42
27;Bourgogne-Franche-Comté;21;1;18;169;Chevannes;163;4;167
27;Bourgogne-Franche-Comté;21;1;17;170;Chevigny-en-Valière;368;5;373
27;Bourgogne-Franche-Comté;21;2;07;171;Chevigny-Saint-Sauveur;11160;215;11375
27;Bourgogne-Franche-Comté;21;1;04;172;Chivres;301;6;307
27;Bourgogne-Franche-Comté;21;1;17;173;Chorey-les-Beaune;635;15;650
27;Bourgogne-Franche-Comté;21;2;02;175;Cirey-lès-Pontailler;199;1;200
27;Bourgogne-Franche-Comté;21;1;01;176;Civry-en-Montagne;126;2;128
27;Bourgogne-Franche-Comté;21;3;22;177;Clamerey;184;1;185
27;Bourgogne-Franche-Comté;21;2;14;179;Clénay;863;10;873
27;Bourgogne-Franche-Comté;21;2;02;180;Cléry;147;4;151
27;Bourgogne-Franche-Comté;21;1;01;181;Clomot;139;2;141
27;Bourgogne-Franche-Comté;21;2;15;183;Collonges-et-Premières ;1046;13;1059
27;Bourgogne-Franche-Comté;21;1;18;182;Collonges-lès-Bévy;95;1;96
27;Bourgogne-Franche-Comté;21;1;01;184;Colombier;67;0;67
27;Bourgogne-Franche-Comté;21;1;17;185;Combertault;541;20;561
27;Bourgogne-Franche-Comté;21;1;20;186;Comblanchien;625;17;642
27;Bourgogne-Franche-Comté;21;1;01;187;Commarin;123;4;127
27;Bourgogne-Franche-Comté;21;1;17;189;Corberon;438;9;447
27;Bourgogne-Franche-Comté;21;1;17;190;Corcelles-les-Arts;452;19;471
27;Bourgogne-Franche-Comté;21;1;20;191;Corcelles-lès-Cîteaux;811;24;835
27;Bourgogne-Franche-Comté;21;2;13;192;Corcelles-les-Monts;632;10;642
27;Bourgogne-Franche-Comté;21;1;17;193;Corgengoux;365;16;381
27;Bourgogne-Franche-Comté;21;1;20;194;Corgoloin;921;12;933
27;Bourgogne-Franche-Comté;21;1;01;195;Cormot-Vauchignon ;216;4;220
27;Bourgogne-Franche-Comté;21;1;17;196;Corpeau;975;16;991
27;Bourgogne-Franche-Comté;21;3;19;197;Corpoyer-la-Chapelle;31;0;31
27;Bourgogne-Franche-Comté;21;3;22;198;Corrombles;250;3;253
27;Bourgogne-Franche-Comté;21;3;22;199;Corsaint;161;2;163
27;Bourgogne-Franche-Comté;21;1;18;200;Couchey;1117;25;1142
27;Bourgogne-Franche-Comté;21;3;05;201;Coulmier-le-Sec;255;5;260
27;Bourgogne-Franche-Comté;21;3;05;202;Courban;158;1;159
27;Bourgogne-Franche-Comté;21;3;22;203;Courcelles-Frémoy;123;2;125
27;Bourgogne-Franche-Comté;21;3;19;204;Courcelles-lès-Montbard;84;1;85
27;Bourgogne-Franche-Comté;21;3;22;205;Courcelles-lès-Semur;243;6;249
27;Bourgogne-Franche-Comté;21;2;16;207;Courlon;82;4;86
27;Bourgogne-Franche-Comté;21;2;16;208;Courtivron;167;4;171
27;Bourgogne-Franche-Comté;21;2;21;209;Couternon;1892;40;1932
27;Bourgogne-Franche-Comté;21;1;01;210;Créancey;523;5;528
27;Bourgogne-Franche-Comté;21;2;16;211;Crécey-sur-Tille;136;2;138
27;Bourgogne-Franche-Comté;21;3;19;212;Crépand;323;4;327
27;Bourgogne-Franche-Comté;21;1;01;214;Crugey;173;4;177
27;Bourgogne-Franche-Comté;21;2;21;215;Cuiserey;185;0;185
27;Bourgogne-Franche-Comté;21;1;01;216;Culètre;102;2;104
27;Bourgogne-Franche-Comté;21;1;18;217;Curley;134;4;138
27;Bourgogne-Franche-Comté;21;2;14;218;Curtil-Saint-Seine;117;0;117
27;Bourgogne-Franche-Comté;21;1;18;219;Curtil-Vergy;138;0;138
27;Bourgogne-Franche-Comté;21;2;16;220;Cussey-les-Forges;141;3;144
27;Bourgogne-Franche-Comté;21;1;01;221;Cussy-la-Colonne;41;2;43
27;Bourgogne-Franche-Comté;21;1;01;222;Cussy-le-Châtel;113;3;116
27;Bourgogne-Franche-Comté;21;2;14;223;Daix;1504;35;1539
27;Bourgogne-Franche-Comté;21;3;22;224;Dampierre-en-Montagne;69;4;73
27;Bourgogne-Franche-Comté;21;2;21;225;Dampierre-et-Flée;133;2;135
27;Bourgogne-Franche-Comté;21;3;19;226;Darcey;340;11;351
27;Bourgogne-Franche-Comté;21;2;14;227;Darois;498;7;505
27;Bourgogne-Franche-Comté;21;1;18;228;Détain-et-Bruant;142;0;142
27;Bourgogne-Franche-Comté;21;1;01;229;Diancey;88;2;90
27;Bourgogne-Franche-Comté;21;2;16;230;Diénay;377;8;385
27;Bourgogne-Franche-Comté;21;2;99;231;Dijon;156854;3332;160186
27;Bourgogne-Franche-Comté;21;3;22;232;Dompierre-en-Morvan;207;5;212
27;Bourgogne-Franche-Comté;21;2;02;233;Drambon;195;1;196
27;Bourgogne-Franche-Comté;21;2;23;234;Drée;61;3;64
27;Bourgogne-Franche-Comté;21;3;05;235;Duesme;53;1;54
27;Bourgogne-Franche-Comté;21;1;17;236;Ébaty;254;6;260
27;Bourgogne-Franche-Comté;21;3;05;237;Échalot;95;3;98
27;Bourgogne-Franche-Comté;21;2;23;238;Échannay;131;2;133
27;Bourgogne-Franche-Comté;21;1;04;239;Échenon;786;11;797
27;Bourgogne-Franche-Comté;21;2;16;240;Échevannes;307;2;309
27;Bourgogne-Franche-Comté;21;1;17;241;Échevronne;290;16;306
27;Bourgogne-Franche-Comté;21;2;15;242;Échigey;291;4;295
27;Bourgogne-Franche-Comté;21;1;01;243;Écutigny;76;4;80
27;Bourgogne-Franche-Comté;21;1;01;244;Éguilly;65;0;65
27;Bourgogne-Franche-Comté;21;2;16;245;Épagny;315;3;318
27;Bourgogne-Franche-Comté;21;1;20;246;Épernay-sous-Gevrey;184;3;187
27;Bourgogne-Franche-Comté;21;3;22;247;Époisses;791;13;804
27;Bourgogne-Franche-Comté;21;3;19;248;Éringes;63;1;64
27;Bourgogne-Franche-Comté;21;1;04;249;Esbarres;683;20;703
27;Bourgogne-Franche-Comté;21;3;05;250;Essarois;88;2;90
27;Bourgogne-Franche-Comté;21;1;01;251;Essey;274;27;301
27;Bourgogne-Franche-Comté;21;3;19;252;Étais;82;4;86
27;Bourgogne-Franche-Comté;21;3;05;253;Étalante;147;4;151
27;Bourgogne-Franche-Comté;21;1;18;254;L' Étang-Vergy;210;10;220
27;Bourgogne-Franche-Comté;21;2;14;255;Étaules;317;3;320
27;Bourgogne-Franche-Comté;21;2;02;256;Étevaux;314;7;321
27;Bourgogne-Franche-Comté;21;3;05;257;Étormay;67;2;69
27;Bourgogne-Franche-Comté;21;3;05;258;Étrochey;226;3;229
27;Bourgogne-Franche-Comté;21;3;19;259;Fain-lès-Montbard;293;10;303
27;Bourgogne-Franche-Comté;21;3;19;260;Fain-lès-Moutiers;153;4;157
27;Bourgogne-Franche-Comté;21;2;15;261;Fauverney;622;20;642
27;Bourgogne-Franche-Comté;21;3;05;262;Faverolles-lès-Lucey;31;0;31
27;Bourgogne-Franche-Comté;21;2;18;263;Fénay;1638;42;1680
27;Bourgogne-Franche-Comté;21;1;01;264;Le Fête;45;0;45
27;Bourgogne-Franche-Comté;21;1;18;265;Fixin;750;21;771
27;Bourgogne-Franche-Comté;21;2;14;266;Flacey;186;1;187
27;Bourgogne-Franche-Comté;21;1;20;267;Flagey-Echézeaux;482;13;495
27;Bourgogne-Franche-Comté;21;2;02;268;Flagey-lès-Auxonne;192;3;195
27;Bourgogne-Franche-Comté;21;2;02;269;Flammerans;436;9;445
27;Bourgogne-Franche-Comté;21;2;13;270;Flavignerot;193;7;200
27;Bourgogne-Franche-Comté;21;3;19;271;Flavigny-sur-Ozerain;293;3;296
27;Bourgogne-Franche-Comté;21;2;23;273;Fleurey-sur-Ouche;1370;18;1388
27;Bourgogne-Franche-Comté;21;1;01;274;Foissy;165;3;168
27;Bourgogne-Franche-Comté;21;2;16;275;Foncegrive;134;3;137
27;Bourgogne-Franche-Comté;21;2;21;277;Fontaine-Française;890;19;909
27;Bourgogne-Franche-Comté;21;2;14;278;Fontaine-lès-Dijon;8844;205;9049
27;Bourgogne-Franche-Comté;21;3;05;276;Fontaines-en-Duesmois;119;4;123
27;Bourgogne-Franche-Comté;21;3;19;279;Fontaines-les-Sèches;25;0;25
27;Bourgogne-Franche-Comté;21;3;22;280;Fontangy;137;6;143
27;Bourgogne-Franche-Comté;21;2;21;281;Fontenelle;169;2;171
27;Bourgogne-Franche-Comté;21;3;22;282;Forléans;102;2;104
27;Bourgogne-Franche-Comté;21;2;16;283;Fraignot-et-Vesvrotte;65;1;66
27;Bourgogne-Franche-Comté;21;2;16;284;Francheville;288;4;292
27;Bourgogne-Franche-Comté;21;1;04;285;Franxault;484;5;489
27;Bourgogne-Franche-Comté;21;2;16;286;Frénois;87;1;88
27;Bourgogne-Franche-Comté;21;3;19;287;Fresnes;164;7;171
27;Bourgogne-Franche-Comté;21;3;19;288;Frôlois;162;1;163
27;Bourgogne-Franche-Comté;21;1;20;289;Fussey;117;8;125
27;Bourgogne-Franche-Comté;21;2;16;290;Gemeaux;873;12;885
27;Bourgogne-Franche-Comté;21;3;22;291;Genay;370;10;380
27;Bourgogne-Franche-Comté;21;2;15;292;Genlis;5272;45;5317
27;Bourgogne-Franche-Comté;21;2;23;293;Gergueil;117;0;117
27;Bourgogne-Franche-Comté;21;1;20;294;Gerland;437;5;442
27;Bourgogne-Franche-Comté;21;1;18;295;Gevrey-Chambertin;3050;41;3091
27;Bourgogne-Franche-Comté;21;3;05;296;Gevrolles;179;1;180
27;Bourgogne-Franche-Comté;21;1;20;297;Gilly-lès-Cîteaux;716;6;722
27;Bourgogne-Franche-Comté;21;3;22;298;Gissey-le-Vieil;110;3;113
27;Bourgogne-Franche-Comté;21;3;19;299;Gissey-sous-Flavigny;88;1;89
27;Bourgogne-Franche-Comté;21;2;23;300;Gissey-sur-Ouche;354;9;363
27;Bourgogne-Franche-Comté;21;1;04;301;Glanon;258;2;260
27;Bourgogne-Franche-Comté;21;3;05;302;Gomméville;129;2;131
27;Bourgogne-Franche-Comté;21;3;05;303;Les Goulles;10;0;10
27;Bourgogne-Franche-Comté;21;2;16;304;Grancey-le-Château-Neuvelle;254;9;263
27;Bourgogne-Franche-Comté;21;3;05;305;Grancey-sur-Ource;198;2;200
27;Bourgogne-Franche-Comté;21;2;23;306;Grenant-lès-Sombernon;211;3;214
27;Bourgogne-Franche-Comté;21;3;19;307;Grésigny-Sainte-Reine;142;2;144
27;Bourgogne-Franche-Comté;21;3;19;308;Grignon;206;12;218
27;Bourgogne-Franche-Comté;21;3;05;309;Griselles;86;3;89
27;Bourgogne-Franche-Comté;21;2;23;310;Grosbois-en-Montagne;113;2;115
27;Bourgogne-Franche-Comté;21;1;04;311;Grosbois-lès-Tichey;75;1;76
27;Bourgogne-Franche-Comté;21;3;05;312;Gurgy-la-Ville;29;3;32
27;Bourgogne-Franche-Comté;21;3;05;313;Gurgy-le-Château;46;0;46
27;Bourgogne-Franche-Comté;21;3;19;314;Hauteroche;80;2;82
27;Bourgogne-Franche-Comté;21;2;14;315;Hauteville-lès-Dijon;1227;16;1243
27;Bourgogne-Franche-Comté;21;2;02;316;Heuilley-sur-Saône;329;5;334
27;Bourgogne-Franche-Comté;21;2;16;317;Is-sur-Tille;4406;56;4462
27;Bourgogne-Franche-Comté;21;2;15;319;Izeure;884;13;897
27;Bourgogne-Franche-Comté;21;2;15;320;Izier;790;14;804
27;Bourgogne-Franche-Comté;21;3;19;321;Jailly-les-Moulins;80;2;82
27;Bourgogne-Franche-Comté;21;1;04;322;Jallanges;318;14;332
27;Bourgogne-Franche-Comté;21;2;21;323;Jancigny;141;4;145
27;Bourgogne-Franche-Comté;21;3;22;324;Jeux-lès-Bard;52;1;53
27;Bourgogne-Franche-Comté;21;1;01;325;Jouey;184;2;186
27;Bourgogne-Franche-Comté;21;3;05;326;Jours-lès-Baigneux;74;4;78
27;Bourgogne-Franche-Comté;21;3;22;328;Juillenay;45;0;45
27;Bourgogne-Franche-Comté;21;3;22;329;Juilly;44;2;46
27;Bourgogne-Franche-Comté;21;2;15;330;Labergement-Foigney;371;3;374
27;Bourgogne-Franche-Comté;21;2;02;331;Labergement-lès-Auxonne;331;4;335
27;Bourgogne-Franche-Comté;21;1;04;332;Labergement-lès-Seurre;998;22;1020
27;Bourgogne-Franche-Comté;21;1;04;333;Labruyère;229;5;234
27;Bourgogne-Franche-Comté;21;1;01;334;Lacanche;537;13;550
27;Bourgogne-Franche-Comté;21;3;22;335;Lacour-d'Arcenay;119;3;122
27;Bourgogne-Franche-Comté;21;1;17;606;Ladoix-Serrigny;1821;47;1868
27;Bourgogne-Franche-Comté;21;3;05;336;Laignes;683;13;696
27;Bourgogne-Franche-Comté;21;2;02;337;Lamarche-sur-Saône;1340;13;1353
27;Bourgogne-Franche-Comté;21;2;16;338;Lamargelle;162;3;165
27;Bourgogne-Franche-Comté;21;2;23;339;Lantenay;510;19;529
27;Bourgogne-Franche-Comté;21;1;04;340;Lanthes;252;5;257
27;Bourgogne-Franche-Comté;21;3;22;341;Lantilly;107;4;111
27;Bourgogne-Franche-Comté;21;1;04;342;Laperrière-sur-Saône;442;9;451
27;Bourgogne-Franche-Comté;21;3;05;343;Larrey;94;1;95
27;Bourgogne-Franche-Comté;21;1;04;344;Lechâtelet;222;5;227
27;Bourgogne-Franche-Comté;21;2;16;345;Léry;192;3;195
27;Bourgogne-Franche-Comté;21;3;05;346;Leuglay;303;3;306
27;Bourgogne-Franche-Comté;21;1;17;347;Levernois;332;17;349
27;Bourgogne-Franche-Comté;21;2;21;348;Licey-sur-Vingeanne;103;1;104
27;Bourgogne-Franche-Comté;21;1;01;349;Liernais;503;12;515
27;Bourgogne-Franche-Comté;21;3;05;350;Lignerolles;52;1;53
27;Bourgogne-Franche-Comté;21;2;15;351;Longchamp;1166;121;1287
27;Bourgogne-Franche-Comté;21;2;15;352;Longeault-Pluvault ;1131;16;1147
27;Bourgogne-Franche-Comté;21;2;15;353;Longecourt-en-Plaine;1244;27;1271
27;Bourgogne-Franche-Comté;21;1;01;354;Longecourt-lès-Culêtre;52;0;52
27;Bourgogne-Franche-Comté;21;2;18;355;Longvic;8416;127;8543
27;Bourgogne-Franche-Comté;21;1;04;356;Losne;1603;36;1639
27;Bourgogne-Franche-Comté;21;3;05;357;Louesme;110;3;113
27;Bourgogne-Franche-Comté;21;3;19;358;Lucenay-le-Duc;184;4;188
27;Bourgogne-Franche-Comté;21;3;05;359;Lucey;59;3;62
27;Bourgogne-Franche-Comté;21;1;01;360;Lusigny-sur-Ouche;114;3;117
27;Bourgogne-Franche-Comté;21;2;16;361;Lux;516;12;528
27;Bourgogne-Franche-Comté;21;1;01;362;Maconge;133;3;136
27;Bourgogne-Franche-Comté;21;1;01;363;Magnien;318;6;324
27;Bourgogne-Franche-Comté;21;3;22;365;Magny-la-Ville;79;0;79
27;Bourgogne-Franche-Comté;21;3;05;364;Magny-Lambert;84;3;87
27;Bourgogne-Franche-Comté;21;1;04;366;Magny-lès-Aubigny;211;3;214
27;Bourgogne-Franche-Comté;21;1;20;368;Magny-lès-Villers;241;12;253
27;Bourgogne-Franche-Comté;21;2;02;367;Magny-Montarlot;262;2;264
27;Bourgogne-Franche-Comté;21;2;21;369;Magny-Saint-Médard;314;4;318
27;Bourgogne-Franche-Comté;21;2;07;370;Magny-sur-Tille;892;18;910
27;Bourgogne-Franche-Comté;21;2;02;371;Les Maillys;814;19;833
27;Bourgogne-Franche-Comté;21;3;05;372;Maisey-le-Duc;84;5;89
27;Bourgogne-Franche-Comté;21;2;23;373;Mâlain;765;15;780
27;Bourgogne-Franche-Comté;21;1;01;374;Maligny;201;7;208
27;Bourgogne-Franche-Comté;21;1;01;375;Manlay;179;5;184
27;Bourgogne-Franche-Comté;21;2;02;376;Marandeuil;109;1;110
27;Bourgogne-Franche-Comté;21;3;22;377;Marcellois;48;0;48
27;Bourgogne-Franche-Comté;21;3;05;378;Marcenay;95;2;97
27;Bourgogne-Franche-Comté;21;1;01;379;Marcheseuil;158;1;159
27;Bourgogne-Franche-Comté;21;3;22;380;Marcigny-sous-Thil;57;2;59
27;Bourgogne-Franche-Comté;21;3;22;381;Marcilly-et-Dracy;93;4;97
27;Bourgogne-Franche-Comté;21;1;01;382;Marcilly-Ogny;194;3;197
27;Bourgogne-Franche-Comté;21;2;16;383;Marcilly-sur-Tille;1680;21;1701
27;Bourgogne-Franche-Comté;21;1;20;384;Marey-lès-Fussey;55;5;60
27;Bourgogne-Franche-Comté;21;2;16;385;Marey-sur-Tille;324;8;332
27;Bourgogne-Franche-Comté;21;3;19;386;Marigny-le-Cahouët;323;12;335
27;Bourgogne-Franche-Comté;21;1;17;387;Marigny-lès-Reullée;220;5;225
27;Bourgogne-Franche-Comté;21;2;15;388;Marliens;596;11;607
27;Bourgogne-Franche-Comté;21;3;19;389;Marmagne;209;1;210
27;Bourgogne-Franche-Comté;21;2;06;390;Marsannay-la-Côte;5330;77;5407
27;Bourgogne-Franche-Comté;21;2;16;391;Marsannay-le-Bois;843;10;853
27;Bourgogne-Franche-Comté;21;1;01;392;Martrois;62;1;63
27;Bourgogne-Franche-Comté;21;3;05;393;Massingy;152;8;160
27;Bourgogne-Franche-Comté;21;3;22;394;Massingy-lès-Semur;162;4;166
27;Bourgogne-Franche-Comté;21;3;22;395;Massingy-lès-Vitteaux;94;1;95
27;Bourgogne-Franche-Comté;21;3;05;396;Mauvilly;69;2;71
27;Bourgogne-Franche-Comté;21;1;17;397;Mavilly-Mandelot;178;3;181
27;Bourgogne-Franche-Comté;21;2;02;398;Maxilly-sur-Saône;354;8;362
27;Bourgogne-Franche-Comté;21;1;01;399;Meilly-sur-Rouvres;205;2;207
27;Bourgogne-Franche-Comté;21;2;16;400;Le Meix;49;0;49
27;Bourgogne-Franche-Comté;21;1;17;401;Meloisey;323;5;328
27;Bourgogne-Franche-Comté;21;3;05;402;Menesble;10;0;10
27;Bourgogne-Franche-Comté;21;1;01;403;Ménessaire;85;1;86
27;Bourgogne-Franche-Comté;21;3;19;404;Ménétreux-le-Pitois;422;16;438
27;Bourgogne-Franche-Comté;21;1;17;405;Merceuil;810;22;832
27;Bourgogne-Franche-Comté;21;2;23;406;Mesmont;246;2;248
27;Bourgogne-Franche-Comté;21;1;18;407;Messanges;234;11;245
27;Bourgogne-Franche-Comté;21;2;14;408;Messigny-et-Vantoux;1675;29;1704
27;Bourgogne-Franche-Comté;21;1;20;409;Meuilley;463;13;476
27;Bourgogne-Franche-Comté;21;3;05;410;Meulson;32;2;34
27;Bourgogne-Franche-Comté;21;1;17;411;Meursanges;562;18;580
27;Bourgogne-Franche-Comté;21;1;17;412;Meursault;1419;45;1464
27;Bourgogne-Franche-Comté;21;3;22;413;Millery;392;15;407
27;Bourgogne-Franche-Comté;21;1;01;414;Mimeure;312;9;321
27;Bourgogne-Franche-Comté;21;3;05;415;Minot;179;5;184
27;Bourgogne-Franche-Comté;21;2;21;416;Mirebeau-sur-Bèze;2045;38;2083
27;Bourgogne-Franche-Comté;21;3;22;417;Missery;106;0;106
27;Bourgogne-Franche-Comté;21;3;05;418;Moitron;60;4;64
27;Bourgogne-Franche-Comté;21;3;05;419;Molesme;264;5;269
27;Bourgogne-Franche-Comté;21;1;01;420;Molinot;163;3;166
27;Bourgogne-Franche-Comté;21;2;16;421;Moloy;233;3;236
27;Bourgogne-Franche-Comté;21;3;22;422;Molphey;130;4;134
27;Bourgogne-Franche-Comté;21;1;01;441;Mont-Saint-Jean;240;7;247
27;Bourgogne-Franche-Comté;21;1;17;423;Montagny-lès-Beaune;709;22;731
27;Bourgogne-Franche-Comté;21;1;04;424;Montagny-lès-Seurre;108;2;110
27;Bourgogne-Franche-Comté;21;3;19;425;Montbard;5004;128;5132
27;Bourgogne-Franche-Comté;21;3;22;426;Montberthault;205;3;208
27;Bourgogne-Franche-Comté;21;1;01;427;Montceau-et-Écharnant;184;5;189
27;Bourgogne-Franche-Comté;21;1;17;428;Monthelie;164;4;168
27;Bourgogne-Franche-Comté;21;3;19;429;Montigny-Montfort;298;6;304
27;Bourgogne-Franche-Comté;21;2;21;433;Montigny-Mornay-Villeneuve-sur-Vingeanne;390;7;397
27;Bourgogne-Franche-Comté;21;3;22;430;Montigny-Saint-Barthélemy;86;5;91
27;Bourgogne-Franche-Comté;21;3;22;431;Montigny-sur-Armançon;149;5;154
27;Bourgogne-Franche-Comté;21;3;05;432;Montigny-sur-Aube;255;4;259
27;Bourgogne-Franche-Comté;21;3;22;434;Montlay-en-Auxois;188;1;189
27;Bourgogne-Franche-Comté;21;3;05;435;Montliot-et-Courcelles;303;6;309
27;Bourgogne-Franche-Comté;21;1;04;436;Montmain;154;3;157
27;Bourgogne-Franche-Comté;21;2;02;437;Montmançon;245;5;250
27;Bourgogne-Franche-Comté;21;3;05;438;Montmoyen;76;3;79
27;Bourgogne-Franche-Comté;21;2;23;439;Montoillot;84;0;84
27;Bourgogne-Franche-Comté;21;1;04;440;Montot;194;5;199
27;Bourgogne-Franche-Comté;21;1;18;442;Morey-Saint-Denis;665;11;676
27;Bourgogne-Franche-Comté;21;3;05;444;Mosson;70;0;70
27;Bourgogne-Franche-Comté;21;3;22;445;La Motte-Ternant;147;2;149
27;Bourgogne-Franche-Comté;21;3;19;446;Moutiers-Saint-Jean;261;5;266
27;Bourgogne-Franche-Comté;21;1;01;447;Musigny;82;0;82
27;Bourgogne-Franche-Comté;21;3;19;448;Mussy-la-Fosse;87;1;88
27;Bourgogne-Franche-Comté;21;3;22;449;Nan-sous-Thil;184;3;187
27;Bourgogne-Franche-Comté;21;1;17;450;Nantoux;167;5;172
27;Bourgogne-Franche-Comté;21;3;19;451;Nesle-et-Massoult;75;3;78
27;Bourgogne-Franche-Comté;21;2;07;452;Neuilly-Crimolois ;2789;31;2820
27;Bourgogne-Franche-Comté;21;3;05;454;Nicey;110;0;110
27;Bourgogne-Franche-Comté;21;3;05;455;Nod-sur-Seine;204;9;213
27;Bourgogne-Franche-Comté;21;3;19;456;Nogent-lès-Montbard;154;8;162
27;Bourgogne-Franche-Comté;21;3;22;457;Noidan;74;5;79
27;Bourgogne-Franche-Comté;21;1;20;458;Noiron-sous-Gevrey;1131;16;1147
27;Bourgogne-Franche-Comté;21;2;21;459;Noiron-sur-Bèze;236;5;241
27;Bourgogne-Franche-Comté;21;3;05;460;Noiron-sur-Seine;69;1;70
27;Bourgogne-Franche-Comté;21;1;01;461;Nolay;1450;22;1472
27;Bourgogne-Franche-Comté;21;2;14;462;Norges-la-Ville;949;18;967
27;Bourgogne-Franche-Comté;21;3;22;463;Normier;51;1;52
27;Bourgogne-Franche-Comté;21;1;20;464;Nuits-Saint-Georges;5421;91;5512
27;Bourgogne-Franche-Comté;21;3;05;465;Obtrée;76;1;77
27;Bourgogne-Franche-Comté;21;3;05;466;Oigny;38;4;42
27;Bourgogne-Franche-Comté;21;2;21;467;Oisilly;128;4;132
27;Bourgogne-Franche-Comté;21;2;21;468;Orain;91;1;92
27;Bourgogne-Franche-Comté;21;2;14;469;Orgeux;460;13;473
27;Bourgogne-Franche-Comté;21;3;05;470;Origny;51;3;54
27;Bourgogne-Franche-Comté;21;3;05;471;Orret;16;0;16
27;Bourgogne-Franche-Comté;21;2;16;472;Orville;170;1;171
27;Bourgogne-Franche-Comté;21;2;18;473;Ouges;1615;11;1626
27;Bourgogne-Franche-Comté;21;1;04;474;Pagny-la-Ville;413;11;424
27;Bourgogne-Franche-Comté;21;1;04;475;Pagny-le-Château;509;10;519
27;Bourgogne-Franche-Comté;21;1;01;476;Painblanc;163;5;168
27;Bourgogne-Franche-Comté;21;2;14;477;Panges;86;2;88
27;Bourgogne-Franche-Comté;21;2;23;478;Pasques;285;5;290
27;Bourgogne-Franche-Comté;21;2;16;479;Pellerey;98;1;99
27;Bourgogne-Franche-Comté;21;1;17;480;Pernand-Vergelesses;240;9;249
27;Bourgogne-Franche-Comté;21;2;18;481;Perrigny-lès-Dijon;2139;33;2172
27;Bourgogne-Franche-Comté;21;2;02;482;Perrigny-sur-l'Ognon;639;15;654
27;Bourgogne-Franche-Comté;21;2;16;483;Pichanges;295;5;300
27;Bourgogne-Franche-Comté;21;3;19;484;Planay;66;5;71
27;Bourgogne-Franche-Comté;21;2;23;485;Plombières-lès-Dijon;2547;46;2593
27;Bourgogne-Franche-Comté;21;2;15;487;Pluvet;406;3;409
27;Bourgogne-Franche-Comté;21;3;05;488;Poinçon-lès-Larrey;193;2;195
27;Bourgogne-Franche-Comté;21;2;16;489;Poiseul-la-Grange;56;4;60
27;Bourgogne-Franche-Comté;21;3;05;490;Poiseul-la-Ville-et-Laperrière;159;7;166
27;Bourgogne-Franche-Comté;21;2;16;491;Poiseul-lès-Saulx;69;1;70
27;Bourgogne-Franche-Comté;21;1;17;492;Pommard;477;13;490
27;Bourgogne-Franche-Comté;21;2;02;493;Poncey-lès-Athée;575;7;582
27;Bourgogne-Franche-Comté;21;2;16;494;Poncey-sur-l'Ignon;83;0;83
27;Bourgogne-Franche-Comté;21;2;02;495;Pont;145;1;146
27;Bourgogne-Franche-Comté;21;3;22;497;Pont-et-Massène;172;15;187
27;Bourgogne-Franche-Comté;21;2;02;496;Pontailler-sur-Saône;1302;20;1322
27;Bourgogne-Franche-Comté;21;3;22;498;Posanges;53;2;55
27;Bourgogne-Franche-Comté;21;3;05;499;Pothières;205;4;209
27;Bourgogne-Franche-Comté;21;3;19;500;Pouillenay;554;9;563
27;Bourgogne-Franche-Comté;21;1;01;501;Pouilly-en-Auxois;1509;119;1628
27;Bourgogne-Franche-Comté;21;1;04;502;Pouilly-sur-Saône;607;7;614
27;Bourgogne-Franche-Comté;21;2;21;503;Pouilly-sur-Vingeanne;127;4;131
27;Bourgogne-Franche-Comté;21;2;23;504;Prâlon;90;3;93
27;Bourgogne-Franche-Comté;21;3;22;505;Précy-sous-Thil;712;10;722
27;Bourgogne-Franche-Comté;21;1;20;506;Premeaux-Prissey;384;5;389
27;Bourgogne-Franche-Comté;21;2;14;508;Prenois;432;8;440
27;Bourgogne-Franche-Comté;21;3;05;510;Prusly-sur-Ource;157;1;158
27;Bourgogne-Franche-Comté;21;3;05;511;Puits;125;4;129
27;Bourgogne-Franche-Comté;21;1;17;512;Puligny-Montrachet;387;10;397
27;Bourgogne-Franche-Comté;21;3;05;514;Quemigny-sur-Seine;103;3;106
27;Bourgogne-Franche-Comté;21;2;07;515;Quetigny;9261;410;9671
27;Bourgogne-Franche-Comté;21;3;19;516;Quincerot;76;4;80
27;Bourgogne-Franche-Comté;21;1;20;517;Quincey;510;12;522
27;Bourgogne-Franche-Comté;21;3;19;518;Quincy-le-Vicomte;207;2;209
27;Bourgogne-Franche-Comté;21;3;05;519;Recey-sur-Ource;355;8;363
27;Bourgogne-Franche-Comté;21;2;23;520;Remilly-en-Montagne;150;0;150
27;Bourgogne-Franche-Comté;21;2;21;521;Remilly-sur-Tille;885;11;896
27;Bourgogne-Franche-Comté;21;2;21;522;Renève;443;5;448
27;Bourgogne-Franche-Comté;21;1;18;523;Reulle-Vergy;142;2;144
27;Bourgogne-Franche-Comté;21;3;05;524;Riel-les-Eaux;93;0;93
27;Bourgogne-Franche-Comté;21;3;22;525;La Roche-en-Brenil;879;14;893
27;Bourgogne-Franche-Comté;21;3;19;528;La Roche-Vanneau;143;2;145
27;Bourgogne-Franche-Comté;21;3;05;526;Rochefort-sur-Brévon;40;0;40
27;Bourgogne-Franche-Comté;21;1;01;527;La Rochepot;289;9;298
27;Bourgogne-Franche-Comté;21;3;22;529;Roilly;49;1;50
27;Bourgogne-Franche-Comté;21;3;19;530;Rougemont;152;1;153
27;Bourgogne-Franche-Comté;21;3;22;531;Rouvray;485;5;490
27;Bourgogne-Franche-Comté;21;2;15;532;Rouvres-en-Plaine;1131;11;1142
27;Bourgogne-Franche-Comté;21;1;01;533;Rouvres-sous-Meilly;87;3;90
27;Bourgogne-Franche-Comté;21;1;17;534;Ruffey-lès-Beaune;732;42;774
27;Bourgogne-Franche-Comté;21;2;14;535;Ruffey-lès-Echirey;1318;10;1328
27;Bourgogne-Franche-Comté;21;2;16;536;Sacquenay;286;11;297
27;Bourgogne-Franche-Comté;21;3;22;537;Saffres;114;2;116
27;Bourgogne-Franche-Comté;21;3;22;538;Saint-Andeux;125;4;129
27;Bourgogne-Franche-Comté;21;2;23;539;Saint-Anthot;57;1;58
27;Bourgogne-Franche-Comté;21;2;21;540;Saint-Apollinaire;7587;101;7688
27;Bourgogne-Franche-Comté;21;1;17;541;Saint-Aubin;222;8;230
27;Bourgogne-Franche-Comté;21;1;20;542;Saint-Bernard;449;0;449
27;Bourgogne-Franche-Comté;21;3;05;543;Saint-Broing-les-Moines;195;8;203
27;Bourgogne-Franche-Comté;21;3;22;546;Saint-Didier;208;4;212
27;Bourgogne-Franche-Comté;21;3;22;547;Saint-Euphrône;188;3;191
27;Bourgogne-Franche-Comté;21;3;22;548;Saint-Germain-de-Modéon;175;3;178
27;Bourgogne-Franche-Comté;21;3;05;549;Saint-Germain-le-Rocheux;81;4;85
27;Bourgogne-Franche-Comté;21;3;19;550;Saint-Germain-lès-Senailly;130;5;135
27;Bourgogne-Franche-Comté;21;3;22;552;Saint-Hélier;35;1;36
27;Bourgogne-Franche-Comté;21;2;23;553;Saint-Jean-de-Bœuf;111;3;114
27;Bourgogne-Franche-Comté;21;1;04;554;Saint-Jean-de-Losne;1080;7;1087
27;Bourgogne-Franche-Comté;21;2;14;555;Saint-Julien;1472;20;1492
27;Bourgogne-Franche-Comté;21;2;02;556;Saint-Léger-Triey;244;3;247
27;Bourgogne-Franche-Comté;21;3;05;557;Saint-Marc-sur-Seine;108;3;111
27;Bourgogne-Franche-Comté;21;1;01;560;Saint-Martin-de-la-Mer;298;2;300
27;Bourgogne-Franche-Comté;21;2;14;561;Saint-Martin-du-Mont;444;1;445
27;Bourgogne-Franche-Comté;21;2;21;562;Saint-Maurice-sur-Vingeanne;206;6;212
27;Bourgogne-Franche-Comté;21;3;22;563;Saint-Mesmin;125;2;127
27;Bourgogne-Franche-Comté;21;1;20;564;Saint-Nicolas-lès-Cîteaux;416;9;425
27;Bourgogne-Franche-Comté;21;1;20;565;Saint-Philibert;498;8;506
27;Bourgogne-Franche-Comté;21;1;01;566;Saint-Pierre-en-Vaux;145;3;148
27;Bourgogne-Franche-Comté;21;1;01;567;Saint-Prix-lès-Arnay;221;5;226
27;Bourgogne-Franche-Comté;21;3;19;568;Saint-Rémy;697;11;708
27;Bourgogne-Franche-Comté;21;1;17;569;Saint-Romain;222;6;228
27;Bourgogne-Franche-Comté;21;2;02;571;Saint-Sauveur;244;2;246
27;Bourgogne-Franche-Comté;21;1;04;572;Saint-Seine-en-Bâche;403;5;408
27;Bourgogne-Franche-Comté;21;2;14;573;Saint-Seine-l'Abbaye;374;3;377
27;Bourgogne-Franche-Comté;21;2;21;574;Saint-Seine-sur-Vingeanne;390;9;399
27;Bourgogne-Franche-Comté;21;1;04;575;Saint-Symphorien-sur-Saône;347;4;351
27;Bourgogne-Franche-Comté;21;3;22;576;Saint-Thibault;162;4;166
27;Bourgogne-Franche-Comté;21;1;04;577;Saint-Usage;1344;25;1369
27;Bourgogne-Franche-Comté;21;2;23;578;Saint-Victor-sur-Ouche;313;4;317
27;Bourgogne-Franche-Comté;21;3;22;544;Sainte-Colombe-en-Auxois;58;6;64
27;Bourgogne-Franche-Comté;21;3;05;545;Sainte-Colombe-sur-Seine;939;15;954
27;Bourgogne-Franche-Comté;21;1;17;558;Sainte-Marie-la-Blanche;890;31;921
27;Bourgogne-Franche-Comté;21;2;23;559;Sainte-Marie-sur-Ouche;696;11;707
27;Bourgogne-Franche-Comté;21;1;01;570;Sainte-Sabine;170;16;186
27;Bourgogne-Franche-Comté;21;2;16;579;Salives;200;6;206
27;Bourgogne-Franche-Comté;21;3;19;580;Salmaise;135;2;137
27;Bourgogne-Franche-Comté;21;1;04;581;Samerey;150;2;152
27;Bourgogne-Franche-Comté;21;1;17;582;Santenay;893;12;905
27;Bourgogne-Franche-Comté;21;1;01;583;Santosse;53;2;55
27;Bourgogne-Franche-Comté;21;3;22;584;Saulieu;2385;108;2493
27;Bourgogne-Franche-Comté;21;1;20;585;Saulon-la-Chapelle;963;14;977
27;Bourgogne-Franche-Comté;21;1;20;586;Saulon-la-Rue;709;10;719
27;Bourgogne-Franche-Comté;21;2;16;587;Saulx-le-Duc;243;4;247
27;Bourgogne-Franche-Comté;21;1;01;588;Saussey;71;1;72
27;Bourgogne-Franche-Comté;21;2;14;589;Saussy;102;1;103
27;Bourgogne-Franche-Comté;21;2;14;591;Savigny-le-Sec;855;14;869
27;Bourgogne-Franche-Comté;21;1;17;590;Savigny-lès-Beaune;1297;42;1339
27;Bourgogne-Franche-Comté;21;2;23;592;Savigny-sous-Mâlain;225;11;236
27;Bourgogne-Franche-Comté;21;1;01;593;Savilly;80;1;81
27;Bourgogne-Franche-Comté;21;3;05;594;Savoisy;197;3;200
27;Bourgogne-Franche-Comté;21;2;21;595;Savolles;159;4;163
27;Bourgogne-Franche-Comté;21;1;20;596;Savouges;381;6;387
27;Bourgogne-Franche-Comté;21;1;18;597;Segrois;50;1;51
27;Bourgogne-Franche-Comté;21;3;19;598;Seigny;171;2;173
27;Bourgogne-Franche-Comté;21;2;16;599;Selongey;2413;33;2446
27;Bourgogne-Franche-Comté;21;1;01;600;Semarey;123;4;127
27;Bourgogne-Franche-Comté;21;1;18;601;Semezanges;94;4;98
27;Bourgogne-Franche-Comté;21;3;05;602;Semond;25;0;25
27;Bourgogne-Franche-Comté;21;3;22;603;Semur-en-Auxois;4131;353;4484
27;Bourgogne-Franche-Comté;21;3;19;604;Senailly;139;4;143
27;Bourgogne-Franche-Comté;21;2;07;605;Sennecey-lès-Dijon;2003;53;2056
27;Bourgogne-Franche-Comté;21;1;04;607;Seurre;2326;22;2348
27;Bourgogne-Franche-Comté;21;3;22;608;Sincey-lès-Rouvray;99;4;103
27;Bourgogne-Franche-Comté;21;2;02;609;Soirans;492;7;499
27;Bourgogne-Franche-Comté;21;2;02;610;Soissons-sur-Nacey;361;7;368
27;Bourgogne-Franche-Comté;21;2;23;611;Sombernon;917;13;930
27;Bourgogne-Franche-Comté;21;3;22;612;Souhey;89;1;90
27;Bourgogne-Franche-Comté;21;3;19;084;Source-Seine;62;4;66
27;Bourgogne-Franche-Comté;21;3;22;613;Soussey-sur-Brionne;155;8;163
27;Bourgogne-Franche-Comté;21;2;16;614;Spoy;399;4;403
27;Bourgogne-Franche-Comté;21;1;01;615;Sussey;243;8;251
27;Bourgogne-Franche-Comté;21;1;17;616;Tailly;184;7;191
27;Bourgogne-Franche-Comté;21;2;23;617;Talant;11630;225;11855
27;Bourgogne-Franche-Comté;21;2;02;618;Talmay;577;8;585
27;Bourgogne-Franche-Comté;21;2;21;619;Tanay;223;6;229
27;Bourgogne-Franche-Comté;21;2;16;620;Tarsul;154;5;159
27;Bourgogne-Franche-Comté;21;2;15;623;Tart ;1579;33;1612
27;Bourgogne-Franche-Comté;21;2;15;622;Tart-le-Bas;250;4;254
27;Bourgogne-Franche-Comté;21;2;02;624;Tellecey;141;1;142
27;Bourgogne-Franche-Comté;21;1;18;625;Ternant;83;3;86
27;Bourgogne-Franche-Comté;21;3;05;626;Terrefondrée;61;2;63
27;Bourgogne-Franche-Comté;21;3;19;627;Thenissey;97;9;106
27;Bourgogne-Franche-Comté;21;3;05;628;Thoires;65;0;65
27;Bourgogne-Franche-Comté;21;3;22;629;Thoisy-la-Berchère;301;5;306
27;Bourgogne-Franche-Comté;21;1;01;630;Thoisy-le-Désert;210;8;218
27;Bourgogne-Franche-Comté;21;1;01;631;Thomirey;53;0;53
27;Bourgogne-Franche-Comté;21;2;15;632;Thorey-en-Plaine;1042;31;1073
27;Bourgogne-Franche-Comté;21;3;22;633;Thorey-sous-Charny;187;1;188
27;Bourgogne-Franche-Comté;21;1;01;634;Thorey-sur-Ouche;138;0;138
27;Bourgogne-Franche-Comté;21;3;22;635;Thoste;106;6;112
27;Bourgogne-Franche-Comté;21;1;01;636;Thury;265;8;273
27;Bourgogne-Franche-Comté;21;1;04;637;Tichey;213;3;216
27;Bourgogne-Franche-Comté;21;2;16;638;Til-Châtel;1132;7;1139
27;Bourgogne-Franche-Comté;21;2;02;639;Tillenay;754;14;768
27;Bourgogne-Franche-Comté;21;3;22;640;Torcy-et-Pouligny;209;5;214
27;Bourgogne-Franche-Comté;21;3;19;641;Touillon;465;12;477
27;Bourgogne-Franche-Comté;21;3;22;642;Toutry;432;8;440
27;Bourgogne-Franche-Comté;21;2;02;643;Tréclun;457;8;465
27;Bourgogne-Franche-Comté;21;2;21;644;Trochères;168;4;172
27;Bourgogne-Franche-Comté;21;1;04;645;Trouhans;601;16;617
27;Bourgogne-Franche-Comté;21;2;14;646;Trouhaut;120;3;123
27;Bourgogne-Franche-Comté;21;1;04;647;Trugny;120;1;121
27;Bourgogne-Franche-Comté;21;2;14;648;Turcey;177;1;178
27;Bourgogne-Franche-Comté;21;3;22;649;Uncey-le-Franc;54;0;54
27;Bourgogne-Franche-Comté;21;1;18;650;Urcy;151;4;155
27;Bourgogne-Franche-Comté;21;3;22;272;Val-Larrey ;266;4;270
27;Bourgogne-Franche-Comté;21;1;01;327;Val-Mont;259;4;263
27;Bourgogne-Franche-Comté;21;2;14;651;Val-Suzon;204;4;208
27;Bourgogne-Franche-Comté;21;1;18;178;Valforêt ;313;10;323
27;Bourgogne-Franche-Comté;21;1;01;652;Vandenesse-en-Auxois;300;7;307
27;Bourgogne-Franche-Comté;21;3;05;653;Vannaire;52;2;54
27;Bourgogne-Franche-Comté;21;3;05;655;Vanvey;232;10;242
27;Bourgogne-Franche-Comté;21;2;15;656;Varanges;706;11;717
27;Bourgogne-Franche-Comté;21;2;21;657;Varois-et-Chaignot;1917;48;1965
27;Bourgogne-Franche-Comté;21;2;16;659;Vaux-Saules;168;10;178
27;Bourgogne-Franche-Comté;21;1;01;660;Veilly;45;1;46
27;Bourgogne-Franche-Comté;21;2;23;661;Velars-sur-Ouche;1721;27;1748
27;Bourgogne-Franche-Comté;21;3;22;662;Velogny;35;0;35
27;Bourgogne-Franche-Comté;21;3;19;663;Venarey-les-Laumes;2859;37;2896
27;Bourgogne-Franche-Comté;21;3;19;664;Verdonnet;83;4;87
27;Bourgogne-Franche-Comté;21;2;16;665;Vernois-lès-Vesvres;172;0;172
27;Bourgogne-Franche-Comté;21;2;16;666;Vernot;89;3;92
27;Bourgogne-Franche-Comté;21;2;16;667;Véronnes;398;7;405
27;Bourgogne-Franche-Comté;21;2;23;669;Verrey-sous-Drée;77;0;77
27;Bourgogne-Franche-Comté;21;3;19;670;Verrey-sous-Salmaise;287;4;291
27;Bourgogne-Franche-Comté;21;3;05;671;Vertault;54;1;55
27;Bourgogne-Franche-Comté;21;3;22;672;Vesvres;28;1;29
27;Bourgogne-Franche-Comté;21;1;01;673;Veuvey-sur-Ouche;212;2;214
27;Bourgogne-Franche-Comté;21;3;05;674;Veuxhaulles-sur-Aube;204;3;207
27;Bourgogne-Franche-Comté;21;1;01;675;Vianges;39;1;40
27;Bourgogne-Franche-Comté;21;3;22;676;Vic-de-Chassenay;218;5;223
27;Bourgogne-Franche-Comté;21;1;01;677;Vic-des-Prés;118;1;119
27;Bourgogne-Franche-Comté;21;3;22;678;Vic-sous-Thil;186;3;189
27;Bourgogne-Franche-Comté;21;2;23;679;Vieilmoulin;127;2;129
27;Bourgogne-Franche-Comté;21;2;02;680;Vielverge;502;7;509
27;Bourgogne-Franche-Comté;21;3;22;681;Vieux-Château;85;1;86
27;Bourgogne-Franche-Comté;21;2;21;682;Viévigne;264;1;265
27;Bourgogne-Franche-Comté;21;1;01;683;Viévy;356;3;359
27;Bourgogne-Franche-Comté;21;1;17;684;Vignoles;964;49;1013
27;Bourgogne-Franche-Comté;21;3;05;685;Villaines-en-Duesmois;252;6;258
27;Bourgogne-Franche-Comté;21;3;19;686;Villaines-les-Prévôtes;143;2;145
27;Bourgogne-Franche-Comté;21;3;22;687;Villargoix;141;5;146
27;Bourgogne-Franche-Comté;21;3;22;689;Villars-et-Villenotte;171;7;178
27;Bourgogne-Franche-Comté;21;1;20;688;Villars-Fontaine;116;4;120
27;Bourgogne-Franche-Comté;21;3;22;690;Villeberny;92;2;94
27;Bourgogne-Franche-Comté;21;1;20;691;Villebichot;396;7;403
27;Bourgogne-Franche-Comté;21;2;16;692;Villecomte;251;4;255
27;Bourgogne-Franche-Comté;21;3;05;693;Villedieu;69;1;70
27;Bourgogne-Franche-Comté;21;3;22;694;Villeferry;28;0;28
27;Bourgogne-Franche-Comté;21;3;19;695;La Villeneuve-les-Convers;58;1;59
27;Bourgogne-Franche-Comté;21;3;22;696;Villeneuve-sous-Charigny;95;2;97
27;Bourgogne-Franche-Comté;21;1;20;698;Villers-la-Faye;385;8;393
27;Bourgogne-Franche-Comté;21;2;02;699;Villers-les-Pots;1158;13;1171
27;Bourgogne-Franche-Comté;21;3;05;700;Villers-Patras;90;3;93
27;Bourgogne-Franche-Comté;21;2;02;701;Villers-Rotin;127;5;132
27;Bourgogne-Franche-Comté;21;2;16;702;Villey-sur-Tille;269;7;276
27;Bourgogne-Franche-Comté;21;1;01;703;Villiers-en-Morvan;48;0;48
27;Bourgogne-Franche-Comté;21;3;05;704;Villiers-le-Duc;94;0;94
27;Bourgogne-Franche-Comté;21;2;14;705;Villotte-Saint-Seine;76;1;77
27;Bourgogne-Franche-Comté;21;3;05;706;Villotte-sur-Ource;107;1;108
27;Bourgogne-Franche-Comté;21;3;22;707;Villy-en-Auxois;219;4;223
27;Bourgogne-Franche-Comté;21;1;20;708;Villy-le-Moutier;334;12;346
27;Bourgogne-Franche-Comté;21;3;19;709;Viserny;177;2;179
27;Bourgogne-Franche-Comté;21;3;22;710;Vitteaux;1073;18;1091
27;Bourgogne-Franche-Comté;21;3;05;711;Vix;105;4;109
27;Bourgogne-Franche-Comté;21;1;17;712;Volnay;237;15;252
27;Bourgogne-Franche-Comté;21;2;02;713;Vonges;338;5;343
27;Bourgogne-Franche-Comté;21;1;20;714;Vosne-Romanée;343;9;352
27;Bourgogne-Franche-Comté;21;1;01;715;Voudenay;191;1;192
27;Bourgogne-Franche-Comté;21;1;20;716;Vougeot;174;5;179
27;Bourgogne-Franche-Comté;21;3;05;717;Voulaines-les-Templiers;282;11;293
53;Bretagne;22;4;10;001;Allineuc;601;18;619
53;Bretagne;22;4;06;002;Andel;1134;36;1170
53;Bretagne;22;1;04;003;Aucaleuc;936;79;1015
53;Bretagne;22;1;19;209;Beaussais-sur-Mer ;3611;61;3672
53;Bretagne;22;2;01;004;Bégard;4808;92;4900
53;Bretagne;22;2;03;005;Belle-Isle-en-Terre;1029;16;1045
53;Bretagne;22;3;01;006;Berhet;262;9;271
53;Bretagne;22;4;22;055;Binic-Étables-sur-Mer;7006;217;7223
53;Bretagne;22;1;08;008;Bobital;1112;39;1151
53;Bretagne;22;4;13;009;Le Bodéo;160;1;161
53;Bretagne;22;2;23;107;Bon Repos sur Blavet;1263;39;1302
53;Bretagne;22;2;15;011;Boqueho;1070;27;1097
53;Bretagne;22;4;17;012;La Bouillie;863;17;880
53;Bretagne;22;2;03;013;Bourbriac;2196;46;2242
53;Bretagne;22;1;14;014;Bourseul;1155;29;1184
53;Bretagne;22;4;16;015;Bréhand;1671;30;1701
53;Bretagne;22;2;01;018;Brélidy;294;5;299
53;Bretagne;22;2;15;019;Bringolo;478;13;491
53;Bretagne;22;1;02;020;Broons;2894;68;2962
53;Bretagne;22;1;08;021;Brusvily;1186;25;1211
53;Bretagne;22;2;03;023;Bulat-Pestivien;426;1;427
53;Bretagne;22;2;03;024;Calanhel;224;1;225
53;Bretagne;22;2;03;025;Callac;2215;33;2248
53;Bretagne;22;1;08;026;Calorguen;735;8;743
53;Bretagne;22;4;09;027;Le Cambout;425;12;437
53;Bretagne;22;3;27;028;Camlez;864;26;890
53;Bretagne;22;2;23;029;Canihuel;351;13;364
53;Bretagne;22;3;01;030;Caouënnec-Lanvézéac;877;21;898
53;Bretagne;22;2;03;031;Carnoët;651;9;660
53;Bretagne;22;1;02;032;Caulnes;2486;155;2641
53;Bretagne;22;4;10;033;Caurel;358;11;369
53;Bretagne;22;3;01;034;Cavan;1548;58;1606
53;Bretagne;22;1;08;035;Les Champs-Géraux;1032;15;1047
53;Bretagne;22;1;02;036;La Chapelle-Blanche;208;4;212
53;Bretagne;22;2;03;037;La Chapelle-Neuve;386;4;390
53;Bretagne;22;2;15;206;Châtelaudren-Plouagat ;3888;55;3943
53;Bretagne;22;4;09;039;La Chèze;560;27;587
53;Bretagne;22;2;03;040;Coadout;581;9;590
53;Bretagne;22;3;01;041;Coatascorn;262;3;265
53;Bretagne;22;3;27;042;Coatréven;497;15;512
53;Bretagne;22;4;09;043;Coëtlogon;213;5;218
53;Bretagne;22;4;06;044;Coëtmieux;1768;49;1817
53;Bretagne;22;2;15;045;Cohiniac;353;7;360
53;Bretagne;22;4;10;047;Corlay;945;18;963
53;Bretagne;22;1;14;048;Corseul;2191;47;2238
53;Bretagne;22;1;14;049;Créhen;1635;45;1680
53;Bretagne;22;1;04;050;Dinan ;14281;586;14867
53;Bretagne;22;2;03;052;Duault;367;7;374
53;Bretagne;22;4;02;053;Éréac;682;13;695
53;Bretagne;22;4;17;054;Erquy;3916;92;4008
53;Bretagne;22;1;08;056;Évran;1731;25;1756
53;Bretagne;22;2;22;057;Le Faouët;397;12;409
53;Bretagne;22;1;17;179;Fréhel;1584;27;1611
53;Bretagne;22;4;15;059;Le Fœil;1420;40;1460
53;Bretagne;22;4;10;060;Gausson;611;19;630
53;Bretagne;22;2;23;061;Glomel;1370;41;1411
53;Bretagne;22;4;02;062;Gomené;546;10;556
53;Bretagne;22;2;22;063;Gommenec'h;557;9;566
53;Bretagne;22;2;23;064;Gouarec;942;30;972
53;Bretagne;22;2;05;065;Goudelin;1737;36;1773
53;Bretagne;22;4;10;068;Grâce-Uzel;431;8;439
53;Bretagne;22;2;05;067;Grâces;2539;59;2598
53;Bretagne;22;1;02;069;Guenroc;219;5;224
53;Bretagne;22;4;10;158;Guerlédan ;2444;64;2508
53;Bretagne;22;2;05;070;Guingamp;7022;539;7561
53;Bretagne;22;1;02;071;Guitté;711;9;720
53;Bretagne;22;2;03;072;Gurunhuel;408;9;417
53;Bretagne;22;4;15;073;La Harmoye;376;17;393
53;Bretagne;22;4;10;074;Le Haut-Corlay;646;17;663
53;Bretagne;22;4;10;075;Hémonstoir;713;7;720
53;Bretagne;22;4;17;076;Hénanbihen;1329;36;1365
53;Bretagne;22;4;06;077;Hénansal;1185;15;1200
53;Bretagne;22;4;13;079;Hénon;2246;36;2282
53;Bretagne;22;4;26;081;Hillion;4160;97;4257
53;Bretagne;22;1;08;082;Le Hinglé;904;32;936
53;Bretagne;22;4;11;016;Île-de-Bréhat;356;6;362
53;Bretagne;22;4;02;083;Illifaut;680;12;692
53;Bretagne;22;4;16;084;Jugon-les-Lacs - Commune nouvelle;2506;50;2556
53;Bretagne;22;3;27;085;Kerbors;297;8;305
53;Bretagne;22;2;11;086;Kerfot;676;13;689
53;Bretagne;22;2;23;087;Kergrist-Moëlou;655;25;680
53;Bretagne;22;2;03;088;Kerien;252;3;255
53;Bretagne;22;3;12;090;Kermaria-Sulard;1053;20;1073
53;Bretagne;22;2;01;091;Kermoroc'h;449;9;458
53;Bretagne;22;2;03;092;Kerpert;270;3;273
53;Bretagne;22;4;  ;093;Lamballe-Armor ;16742;474;17216
53;Bretagne;22;1;19;094;Lancieux;1534;62;1596
53;Bretagne;22;2;01;095;Landebaëron;185;11;196
53;Bretagne;22;1;14;096;Landébia;470;3;473
53;Bretagne;22;1;14;097;La Landec;723;18;741
53;Bretagne;22;4;06;098;Landéhen;1419;34;1453
53;Bretagne;22;4;15;099;Lanfains;1097;18;1115
53;Bretagne;22;3;27;101;Langoat;1144;25;1169
53;Bretagne;22;1;19;103;Langrolay-sur-Rance;941;39;980
53;Bretagne;22;1;14;104;Languédias;524;28;552
53;Bretagne;22;1;14;105;Languenan;1146;23;1169
53;Bretagne;22;4;26;106;Langueux;7776;261;8037
53;Bretagne;22;2;11;108;Lanleff;122;2;124
53;Bretagne;22;2;11;109;Lanloup;215;5;220
53;Bretagne;22;3;27;110;Lanmérin;595;12;607
53;Bretagne;22;3;27;111;Lanmodez;410;7;417
53;Bretagne;22;2;22;112;Lannebert;438;5;443
53;Bretagne;22;3;07;113;Lannion;20040;935;20975
53;Bretagne;22;4;02;114;Lanrelas;845;17;862
53;Bretagne;22;2;23;115;Lanrivain;449;17;466
53;Bretagne;22;2;15;116;Lanrodec;1339;23;1362
53;Bretagne;22;4;22;117;Lantic;1690;32;1722
53;Bretagne;22;1;08;118;Lanvallay;4191;96;4287
53;Bretagne;22;3;20;119;Lanvellec;593;11;604
53;Bretagne;22;2;22;121;Lanvollon;1782;30;1812
53;Bretagne;22;4;02;122;Laurenan;737;12;749
53;Bretagne;22;2;23;124;Lescouët-Gouarec;221;8;229
53;Bretagne;22;4;15;126;Le Leslay;160;1;161
53;Bretagne;22;3;27;127;Lézardrieux;1478;38;1516
53;Bretagne;22;2;03;129;Loc-Envel;68;3;71
53;Bretagne;22;2;23;128;Locarn;409;15;424
53;Bretagne;22;3;20;131;Loguivy-Plougras;852;14;866
53;Bretagne;22;2;03;132;Lohuec;255;4;259
53;Bretagne;22;4;02;133;Loscouët-sur-Meu;621;15;636
53;Bretagne;22;3;12;134;Louannec;3063;116;3179
53;Bretagne;22;2;03;135;Louargat;2331;45;2376
53;Bretagne;22;4;09;136;Loudéac;9600;385;9985
53;Bretagne;22;2;23;137;Maël-Carhaix;1484;30;1514
53;Bretagne;22;2;03;138;Maël-Pestivien;366;5;371
53;Bretagne;22;2;03;139;Magoar;88;1;89
53;Bretagne;22;4;06;140;La Malhoure;596;16;612
53;Bretagne;22;3;01;141;Mantallot;234;6;240
53;Bretagne;22;1;17;143;Matignon;1671;23;1694
53;Bretagne;22;4;21;144;La Méaugon;1299;33;1332
53;Bretagne;22;1;02;145;Mégrit;823;11;834
53;Bretagne;22;2;23;146;Mellionnec;389;17;406
53;Bretagne;22;4;16;046;Le Mené;6406;116;6522
53;Bretagne;22;4;02;147;Merdrignac;2921;230;3151
53;Bretagne;22;4;02;148;Mérillac;231;4;235
53;Bretagne;22;4;10;149;Merléac;431;17;448
53;Bretagne;22;2;05;150;Le Merzer;955;27;982
53;Bretagne;22;3;27;152;Minihy-Tréguier;1260;41;1301
53;Bretagne;22;4;13;153;Moncontour;829;18;847
53;Bretagne;22;4;10;155;La Motte;2131;32;2163
53;Bretagne;22;2;03;156;Moustéru;650;15;665
53;Bretagne;22;2;23;157;Le Moustoir;665;17;682
53;Bretagne;22;4;06;160;Noyal;927;18;945
53;Bretagne;22;2;05;161;Pabu;2754;109;2863
53;Bretagne;22;2;11;162;Paimpol;7178;335;7513
53;Bretagne;22;2;23;163;Paule;699;20;719
53;Bretagne;22;2;01;164;Pédernec;1846;26;1872
53;Bretagne;22;4;16;165;Penguily;608;19;627
53;Bretagne;22;3;27;166;Penvénan;2517;64;2581
53;Bretagne;22;3;12;168;Perros-Guirec;7065;196;7261
53;Bretagne;22;2;23;169;Peumerit-Quintin;171;4;175
53;Bretagne;22;4;15;170;Plaine-Haute;1618;33;1651
53;Bretagne;22;4;13;171;Plaintel;4394;90;4484
53;Bretagne;22;1;14;172;Plancoët;2996;54;3050
53;Bretagne;22;1;17;174;Pléboulle;864;5;869
53;Bretagne;22;4;16;175;Plédéliac;1457;20;1477
53;Bretagne;22;4;21;176;Plédran;6753;110;6863
53;Bretagne;22;2;22;177;Pléguien;1320;28;1348
53;Bretagne;22;2;11;178;Pléhédel;1321;34;1355
53;Bretagne;22;1;14;180;Plélan-le-Petit;1905;31;1936
53;Bretagne;22;2;23;181;Plélauff;631;27;658
53;Bretagne;22;2;15;182;Plélo;3246;75;3321
53;Bretagne;22;4;09;183;Plémet ;3671;125;3796
53;Bretagne;22;4;13;184;Plémy;1581;30;1611
53;Bretagne;22;4;16;185;Plénée-Jugon;2425;73;2498
53;Bretagne;22;4;17;186;Pléneuf-Val-André;4078;129;4207
53;Bretagne;22;4;18;187;Plérin;14158;484;14642
53;Bretagne;22;2;15;188;Plerneuf;1068;11;1079
53;Bretagne;22;2;03;189;Plésidy;597;11;608
53;Bretagne;22;1;19;190;Pleslin-Trigavou;3699;75;3774
53;Bretagne;22;4;16;193;Plestan;1610;25;1635
53;Bretagne;22;3;20;194;Plestin-les-Grèves;3605;98;3703
53;Bretagne;22;3;27;195;Pleubian;2313;42;2355
53;Bretagne;22;3;27;196;Pleudaniel;932;21;953
53;Bretagne;22;1;08;197;Pleudihen-sur-Rance;2938;80;3018
53;Bretagne;22;3;12;198;Pleumeur-Bodou;3881;165;4046
53;Bretagne;22;3;27;199;Pleumeur-Gautier;1202;19;1221
53;Bretagne;22;1;14;200;Pléven;588;11;599
53;Bretagne;22;1;17;201;Plévenon;768;13;781
53;Bretagne;22;2;23;202;Plévin;751;15;766
53;Bretagne;22;2;01;204;Ploëzal;1240;20;1260
53;Bretagne;22;1;14;205;Plorec-sur-Arguenon;417;3;420
53;Bretagne;22;3;20;207;Plouaret;2158;45;2203
53;Bretagne;22;1;08;208;Plouasne;1712;33;1745
53;Bretagne;22;2;11;210;Ploubazlanec;3029;125;3154
53;Bretagne;22;3;20;211;Ploubezre;3638;115;3753
53;Bretagne;22;2;01;212;Plouëc-du-Trieux;1137;32;1169
53;Bretagne;22;1;19;213;Plouër-sur-Rance;3539;107;3646
53;Bretagne;22;2;11;214;Plouézec;3153;56;3209
53;Bretagne;22;4;21;215;Ploufragan;11489;361;11850
53;Bretagne;22;2;03;216;Plougonver;732;12;744
53;Bretagne;22;3;20;217;Plougras;411;14;425
53;Bretagne;22;3;27;218;Plougrescant;1166;36;1202
53;Bretagne;22;4;10;219;Plouguenast-Langast;2468;60;2528
53;Bretagne;22;2;23;220;Plouguernével;1676;53;1729
53;Bretagne;22;3;27;221;Plouguiel;1747;37;1784
53;Bretagne;22;2;22;222;Plouha;4522;88;4610
53;Bretagne;22;2;05;223;Plouisy;1975;258;2233
53;Bretagne;22;3;07;224;Ploulec'h;1607;58;1665
53;Bretagne;22;2;05;225;Ploumagoar;5397;113;5510
53;Bretagne;22;3;20;226;Ploumilliau;2470;57;2527
53;Bretagne;22;3;20;227;Plounérin;762;11;773
53;Bretagne;22;3;20;228;Plounévez-Moëdec;1461;29;1490
53;Bretagne;22;2;23;229;Plounévez-Quintin;1081;25;1106
53;Bretagne;22;2;03;231;Plourac'h;317;4;321
53;Bretagne;22;4;22;232;Plourhan;1990;39;2029
53;Bretagne;22;2;11;233;Plourivo;2269;55;2324
53;Bretagne;22;2;15;234;Plouvara;1150;22;1172
53;Bretagne;22;3;20;235;Plouzélambre;235;4;239
53;Bretagne;22;2;22;236;Pludual;722;7;729
53;Bretagne;22;1;14;237;Pluduno;2190;65;2255
53;Bretagne;22;3;20;238;Plufur;533;12;545
53;Bretagne;22;1;02;239;Plumaudan;1311;36;1347
53;Bretagne;22;1;02;240;Plumaugat;1078;15;1093
53;Bretagne;22;4;09;241;Plumieux;1019;30;1049
53;Bretagne;22;4;17;242;Plurien;1532;22;1554
53;Bretagne;22;2;03;243;Plusquellec;533;17;550
53;Bretagne;22;4;10;244;Plussulien;487;18;505
53;Bretagne;22;3;01;245;Pluzunet;969;14;983
53;Bretagne;22;4;13;203;Plœuc-L'Hermitage ;4088;77;4165
53;Bretagne;22;4;06;246;Pommeret;2073;32;2105
53;Bretagne;22;2;05;248;Pommerit-le-Vicomte;1783;36;1819
53;Bretagne;22;2;03;249;Pont-Melvez;606;10;616
53;Bretagne;22;2;01;250;Pontrieux;1017;25;1042
53;Bretagne;22;4;18;251;Pordic;7228;205;7433
53;Bretagne;22;3;01;254;Prat;1118;22;1140
53;Bretagne;22;4;09;255;La Prénessaye;883;21;904
53;Bretagne;22;2;01;256;Quemper-Guézennec;1075;26;1101
53;Bretagne;22;3;01;257;Quemperven;379;8;387
53;Bretagne;22;4;13;258;Quessoy;3809;224;4033
53;Bretagne;22;1;04;259;Quévert;3824;110;3934
53;Bretagne;22;4;10;260;Le Quillio;556;7;563
53;Bretagne;22;4;06;261;Quintenic;365;11;376
53;Bretagne;22;4;15;262;Quintin;2851;200;3051
53;Bretagne;22;1;08;263;Le Quiou;319;3;322
53;Bretagne;22;3;27;264;Roche-Jaudy ;2700;573;3273
53;Bretagne;22;3;07;265;Rospez;1757;55;1812
53;Bretagne;22;2;23;266;Rostrenen;3059;339;3398
53;Bretagne;22;4;02;267;Rouillac;394;3;397
53;Bretagne;22;1;17;268;Ruca;605;10;615
53;Bretagne;22;2;01;269;Runan;246;6;252
53;Bretagne;22;2;03;271;Saint-Adrien;356;7;363
53;Bretagne;22;2;05;272;Saint-Agathon;2281;52;2333
53;Bretagne;22;4;17;273;Saint-Alban;2160;31;2191
53;Bretagne;22;1;08;274;Saint-André-des-Eaux;358;6;364
53;Bretagne;22;4;09;275;Saint-Barnabé;1247;25;1272
53;Bretagne;22;4;15;276;Saint-Bihy;268;0;268
53;Bretagne;22;4;15;277;Saint-Brandan;2338;50;2388
53;Bretagne;22;4;99;278;Saint-Brieuc;44170;1551;45721
53;Bretagne;22;4;10;279;Saint-Caradec;1117;37;1154
53;Bretagne;22;1;08;280;Saint-Carné;1024;35;1059
53;Bretagne;22;4;13;281;Saint-Carreuc;1508;25;1533
53;Bretagne;22;1;17;282;Saint-Cast-le-Guildo;3311;77;3388
53;Bretagne;22;2;01;283;Saint-Clet;876;26;902
53;Bretagne;22;2;23;284;Saint-Connan;293;9;302
53;Bretagne;22;4;10;285;Saint-Connec;257;8;265
53;Bretagne;22;4;17;286;Saint-Denoual;473;14;487
53;Bretagne;22;4;21;287;Saint-Donan;1456;35;1491
53;Bretagne;22;4;09;288;Saint-Étienne-du-Gué-de-l'Isle;353;6;359
53;Bretagne;22;2;15;289;Saint-Fiacre;213;1;214
53;Bretagne;22;4;15;291;Saint-Gildas;260;8;268
53;Bretagne;22;2;22;293;Saint-Gilles-les-Bois;420;14;434
53;Bretagne;22;2;23;294;Saint-Gilles-Pligeaux;300;6;306
53;Bretagne;22;4;10;295;Saint-Gilles-Vieux-Marché;356;8;364
53;Bretagne;22;4;16;296;Saint-Glen;634;11;645
53;Bretagne;22;1;08;299;Saint-Hélen;1497;43;1540
53;Bretagne;22;4;10;300;Saint-Hervé;402;9;411
53;Bretagne;22;2;23;334;Saint-Igeaux;131;7;138
53;Bretagne;22;1;14;302;Saint-Jacut-de-la-Mer;905;19;924
53;Bretagne;22;2;15;304;Saint-Jean-Kerdaniel;641;9;650
53;Bretagne;22;1;02;305;Saint-Jouan-de-l'Isle;498;5;503
53;Bretagne;22;1;08;306;Saint-Judoce;559;14;573
53;Bretagne;22;4;21;307;Saint-Julien;2040;50;2090
53;Bretagne;22;1;08;308;Saint-Juvat;650;18;668
53;Bretagne;22;4;02;309;Saint-Launeuc;198;4;202
53;Bretagne;22;2;01;310;Saint-Laurent;477;16;493
53;Bretagne;22;1;14;311;Saint-Lormel;867;34;901
53;Bretagne;22;1;02;312;Saint-Maden;228;8;236
53;Bretagne;22;4;10;313;Saint-Martin-des-Prés;308;11;319
53;Bretagne;22;4;09;314;Saint-Maudan;402;7;409
53;Bretagne;22;1;14;315;Saint-Maudez;282;11;293
53;Bretagne;22;4;10;316;Saint-Mayeux;470;11;481
53;Bretagne;22;1;14;317;Saint-Méloir-des-Bois;258;2;260
53;Bretagne;22;1;14;318;Saint-Michel-de-Plélan;311;8;319
53;Bretagne;22;3;20;319;Saint-Michel-en-Grève;459;13;472
53;Bretagne;22;2;03;320;Saint-Nicodème;169;3;172
53;Bretagne;22;2;23;321;Saint-Nicolas-du-Pélem;1632;46;1678
53;Bretagne;22;2;15;322;Saint-Péver;389;8;397
53;Bretagne;22;1;17;323;Saint-Pôtan;810;13;823
53;Bretagne;22;3;12;324;Saint-Quay-Perros;1296;55;1351
53;Bretagne;22;4;22;325;Saint-Quay-Portrieux;3059;221;3280
53;Bretagne;22;4;06;326;Saint-Rieul;548;5;553
53;Bretagne;22;1;19;327;Saint-Samson-sur-Rance;1614;26;1640
53;Bretagne;22;2;03;328;Saint-Servais;408;6;414
53;Bretagne;22;4;10;330;Saint-Thélo;408;13;421
53;Bretagne;22;4;16;332;Saint-Trimoël;533;9;542
53;Bretagne;22;4;02;333;Saint-Vran;760;29;789
53;Bretagne;22;2;23;331;Sainte-Tréphine;185;2;187
53;Bretagne;22;2;03;335;Senven-Léhart;235;0;235
53;Bretagne;22;4;02;337;Sévignac;1097;25;1122
53;Bretagne;22;2;01;338;Squiffiec;763;26;789
53;Bretagne;22;1;19;339;Taden;2504;76;2580
53;Bretagne;22;3;01;340;Tonquédec;1188;27;1215
53;Bretagne;22;4;16;341;Tramain;693;10;703
53;Bretagne;22;1;14;342;Trébédan;426;9;435
53;Bretagne;22;3;12;343;Trébeurden;3618;126;3744
53;Bretagne;22;2;23;344;Trébrivan;746;16;762
53;Bretagne;22;4;16;345;Trébry;789;15;804
53;Bretagne;22;4;13;346;Trédaniel;909;24;933
53;Bretagne;22;3;27;347;Trédarzec;1067;19;1086
53;Bretagne;22;4;02;348;Trédias;491;9;500
53;Bretagne;22;3;20;349;Trédrez-Locquémeau;1443;39;1482
53;Bretagne;22;3;20;350;Tréduder;195;3;198
53;Bretagne;22;2;23;351;Treffrin;542;13;555
53;Bretagne;22;1;08;352;Tréfumel;272;2;274
53;Bretagne;22;3;12;353;Trégastel;2501;73;2574
53;Bretagne;22;2;03;354;Tréglamus;1055;23;1078
53;Bretagne;22;2;15;356;Trégomeur;936;24;960
53;Bretagne;22;2;01;358;Trégonneau;578;7;585
53;Bretagne;22;3;20;359;Trégrom;423;6;429
53;Bretagne;22;4;26;360;Trégueux;8447;166;8613
53;Bretagne;22;2;22;361;Tréguidel;621;12;633
53;Bretagne;22;3;27;362;Tréguier;2401;267;2668
53;Bretagne;22;3;12;363;Trélévern;1244;32;1276
53;Bretagne;22;1;04;364;Trélivan;2824;81;2905
53;Bretagne;22;2;23;365;Trémargat;190;14;204
53;Bretagne;22;3;20;366;Trémel;409;5;414
53;Bretagne;22;1;19;368;Tréméreuc;728;28;756
53;Bretagne;22;4;02;369;Trémeur;778;17;795
53;Bretagne;22;2;22;370;Tréméven;345;8;353
53;Bretagne;22;4;02;371;Trémorel;1148;20;1168
53;Bretagne;22;4;18;372;Trémuson;2108;36;2144
53;Bretagne;22;2;23;373;Tréogan;101;4;105
53;Bretagne;22;2;22;375;Tressignaux;691;11;702
53;Bretagne;22;4;10;376;Trévé;1680;31;1711
53;Bretagne;22;4;22;377;Tréveneuc;795;21;816
53;Bretagne;22;2;22;378;Trévérec;216;7;223
53;Bretagne;22;3;12;379;Trévou-Tréguignec;1435;40;1475
53;Bretagne;22;1;08;380;Trévron;686;14;700
53;Bretagne;22;3;27;381;Trézény;354;8;362
53;Bretagne;22;3;27;383;Troguéry;232;6;238
53;Bretagne;22;4;10;384;Uzel;1046;25;1071
53;Bretagne;22;1;19;385;La Vicomté-sur-Rance;1072;23;1095
53;Bretagne;22;4;15;386;Le Vieux-Bourg;775;20;795
53;Bretagne;22;3;20;387;Le Vieux-Marché;1300;30;1330
53;Bretagne;22;1;04;388;Vildé-Guingalan;1244;21;1265
53;Bretagne;22;4;26;389;Yffiniac;5000;104;5104
53;Bretagne;22;2;11;390;Yvias;771;18;789
53;Bretagne;22;1;02;391;Yvignac-la-Tour;1147;16;1163
75;Nouvelle-Aquitaine;23;2;01;001;Ahun;1421;202;1623
75;Nouvelle-Aquitaine;23;2;14;002;Ajain;1106;16;1122
75;Nouvelle-Aquitaine;23;1;02;003;Alleyrat;142;0;142
75;Nouvelle-Aquitaine;23;2;14;004;Anzême;566;9;575
75;Nouvelle-Aquitaine;23;1;08;005;Arfeuille-Châtain;197;4;201
75;Nouvelle-Aquitaine;23;2;11;006;Arrènes;215;2;217
75;Nouvelle-Aquitaine;23;2;01;007;Ars;238;10;248
75;Nouvelle-Aquitaine;23;1;02;008;Aubusson;3328;185;3513
75;Nouvelle-Aquitaine;23;1;08;009;Auge;96;0;96
75;Nouvelle-Aquitaine;23;2;11;010;Augères;117;2;119
75;Nouvelle-Aquitaine;23;2;11;011;Aulon;157;4;161
75;Nouvelle-Aquitaine;23;2;05;012;Auriat;111;2;113
75;Nouvelle-Aquitaine;23;1;03;013;Auzances;1211;25;1236
75;Nouvelle-Aquitaine;23;2;11;014;Azat-Châtenet;119;3;122
75;Nouvelle-Aquitaine;23;2;07;015;Azerables;814;16;830
75;Nouvelle-Aquitaine;23;2;01;016;Banize;184;2;186
75;Nouvelle-Aquitaine;23;1;03;017;Basville;162;2;164
75;Nouvelle-Aquitaine;23;2;07;018;Bazelat;252;11;263
75;Nouvelle-Aquitaine;23;1;03;019;Beissat;25;0;25
75;Nouvelle-Aquitaine;23;1;02;020;Bellegarde-en-Marche;409;7;416
75;Nouvelle-Aquitaine;23;2;11;021;Bénévent-l'Abbaye;765;11;776
75;Nouvelle-Aquitaine;23;1;06;022;Bétête;369;7;376
75;Nouvelle-Aquitaine;23;1;10;023;Blaudeix;102;1;103
75;Nouvelle-Aquitaine;23;1;02;024;Blessac;533;12;545
75;Nouvelle-Aquitaine;23;2;04;025;Bonnat;1329;23;1352
75;Nouvelle-Aquitaine;23;1;06;026;Bord-Saint-Georges;351;10;361
75;Nouvelle-Aquitaine;23;2;05;027;Bosmoreau-les-Mines;240;7;247
75;Nouvelle-Aquitaine;23;1;02;028;Bosroger;108;2;110
75;Nouvelle-Aquitaine;23;2;04;029;Le Bourg-d'Hem;216;2;218
75;Nouvelle-Aquitaine;23;2;05;030;Bourganeuf;2487;213;2700
75;Nouvelle-Aquitaine;23;1;06;031;Boussac;1255;18;1273
75;Nouvelle-Aquitaine;23;1;06;032;Boussac-Bourg;701;11;712
75;Nouvelle-Aquitaine;23;2;14;033;La Brionne;443;8;451
75;Nouvelle-Aquitaine;23;1;03;034;Brousse;28;0;28
75;Nouvelle-Aquitaine;23;1;08;035;Budelière;713;10;723
75;Nouvelle-Aquitaine;23;2;14;036;Bussière-Dunoise;1034;14;1048
75;Nouvelle-Aquitaine;23;1;03;037;Bussière-Nouvelle;80;3;83
75;Nouvelle-Aquitaine;23;1;06;038;Bussière-Saint-Georges;255;3;258
75;Nouvelle-Aquitaine;23;2;07;039;La Celle-Dunoise;542;24;566
75;Nouvelle-Aquitaine;23;1;10;040;La Celle-sous-Gouzon;153;1;154
75;Nouvelle-Aquitaine;23;2;04;041;La Cellette;246;4;250
75;Nouvelle-Aquitaine;23;2;11;042;Ceyroux;126;1;127
75;Nouvelle-Aquitaine;23;2;01;043;Chamberaud;100;0;100
75;Nouvelle-Aquitaine;23;2;04;044;Chambon-Sainte-Croix;77;1;78
75;Nouvelle-Aquitaine;23;1;08;045;Chambon-sur-Voueize;874;11;885
75;Nouvelle-Aquitaine;23;1;08;046;Chambonchard;81;4;85
75;Nouvelle-Aquitaine;23;2;11;047;Chamborand;240;3;243
75;Nouvelle-Aquitaine;23;1;02;048;Champagnat;469;10;479
75;Nouvelle-Aquitaine;23;2;04;049;Champsanglard;248;6;254
75;Nouvelle-Aquitaine;23;2;07;050;La Chapelle-Baloue;132;1;133
75;Nouvelle-Aquitaine;23;2;01;051;La Chapelle-Saint-Martial;84;1;85
75;Nouvelle-Aquitaine;23;2;13;052;La Chapelle-Taillefert;428;10;438
75;Nouvelle-Aquitaine;23;1;03;053;Chard;208;2;210
75;Nouvelle-Aquitaine;23;1;03;054;Charron;231;9;240
75;Nouvelle-Aquitaine;23;1;03;055;Châtelard;31;0;31
75;Nouvelle-Aquitaine;23;2;11;056;Châtelus-le-Marcheix;299;6;305
75;Nouvelle-Aquitaine;23;2;04;057;Châtelus-Malvaleix;557;12;569
75;Nouvelle-Aquitaine;23;1;10;058;Le Chauchet;107;2;109
75;Nouvelle-Aquitaine;23;1;02;059;La Chaussade;104;6;110
75;Nouvelle-Aquitaine;23;2;01;060;Chavanat;144;3;147
75;Nouvelle-Aquitaine;23;1;10;061;Chénérailles;757;12;769
75;Nouvelle-Aquitaine;23;2;04;062;Chéniers;565;9;574
75;Nouvelle-Aquitaine;23;1;03;063;Clairavaux;155;1;156
75;Nouvelle-Aquitaine;23;1;06;064;Clugnat;648;3;651
75;Nouvelle-Aquitaine;23;2;07;065;Colondannes;272;9;281
75;Nouvelle-Aquitaine;23;1;03;066;Le Compas;203;12;215
75;Nouvelle-Aquitaine;23;1;03;067;La Courtine;779;9;788
75;Nouvelle-Aquitaine;23;1;10;068;Cressat;541;7;548
75;Nouvelle-Aquitaine;23;1;03;069;Crocq;412;6;418
75;Nouvelle-Aquitaine;23;2;07;070;Crozant;442;14;456
75;Nouvelle-Aquitaine;23;1;09;071;Croze;193;6;199
75;Nouvelle-Aquitaine;23;1;10;072;Domeyrot;229;3;232
75;Nouvelle-Aquitaine;23;1;03;073;Dontreix;421;5;426
75;Nouvelle-Aquitaine;23;2;01;074;Le Donzeil;187;5;192
75;Nouvelle-Aquitaine;23;2;07;075;Dun-le-Palestel;1105;24;1129
75;Nouvelle-Aquitaine;23;1;08;076;Évaux-les-Bains;1359;38;1397
75;Nouvelle-Aquitaine;23;1;09;077;Faux-la-Montagne;429;10;439
75;Nouvelle-Aquitaine;23;2;05;078;Faux-Mazuras;185;4;189
75;Nouvelle-Aquitaine;23;1;09;079;Felletin;1554;186;1740
75;Nouvelle-Aquitaine;23;1;09;080;Féniers;94;0;94
75;Nouvelle-Aquitaine;23;1;03;081;Flayat;305;4;309
75;Nouvelle-Aquitaine;23;2;11;082;Fleurat;314;6;320
75;Nouvelle-Aquitaine;23;1;08;083;Fontanières;248;1;249
75;Nouvelle-Aquitaine;23;2;04;084;La Forêt-du-Temple;145;1;146
75;Nouvelle-Aquitaine;23;2;01;086;Fransèches;243;3;246
75;Nouvelle-Aquitaine;23;2;07;087;Fresselines;493;11;504
75;Nouvelle-Aquitaine;23;2;11;192;Fursac;1488;22;1510
75;Nouvelle-Aquitaine;23;2;14;088;Gartempe;122;0;122
75;Nouvelle-Aquitaine;23;2;04;089;Genouillac;726;11;737
75;Nouvelle-Aquitaine;23;1;09;090;Gentioux-Pigerolles;391;6;397
75;Nouvelle-Aquitaine;23;1;09;091;Gioux;163;3;166
75;Nouvelle-Aquitaine;23;2;14;092;Glénic;673;12;685
75;Nouvelle-Aquitaine;23;1;10;093;Gouzon;1574;22;1596
75;Nouvelle-Aquitaine;23;2;11;095;Le Grand-Bourg;1221;43;1264
75;Nouvelle-Aquitaine;23;2;99;096;Guéret;12889;625;13514
75;Nouvelle-Aquitaine;23;1;10;097;Issoudun-Létrieix;299;3;302
75;Nouvelle-Aquitaine;23;2;06;098;Jalesches;90;3;93
75;Nouvelle-Aquitaine;23;2;01;099;Janaillat;324;5;329
75;Nouvelle-Aquitaine;23;1;10;100;Jarnages;445;10;455
75;Nouvelle-Aquitaine;23;2;14;101;Jouillat;391;13;404
75;Nouvelle-Aquitaine;23;1;10;102;Ladapeyre;346;3;349
75;Nouvelle-Aquitaine;23;2;07;103;Lafat;336;14;350
75;Nouvelle-Aquitaine;23;1;06;104;Lavaufranche;242;1;243
75;Nouvelle-Aquitaine;23;1;10;105;Lavaveix-les-Mines;651;2;653
75;Nouvelle-Aquitaine;23;1;08;106;Lépaud;365;4;369
75;Nouvelle-Aquitaine;23;2;01;107;Lépinas;131;5;136
75;Nouvelle-Aquitaine;23;1;06;108;Leyrat;143;1;144
75;Nouvelle-Aquitaine;23;2;04;109;Linard-Malval ;212;5;217
75;Nouvelle-Aquitaine;23;1;03;110;Lioux-les-Monges;59;1;60
75;Nouvelle-Aquitaine;23;2;11;111;Lizières;262;1;263
75;Nouvelle-Aquitaine;23;2;04;112;Lourdoueix-Saint-Pierre;760;12;772
75;Nouvelle-Aquitaine;23;1;02;113;Lupersat;300;6;306
75;Nouvelle-Aquitaine;23;1;08;114;Lussat;415;7;422
75;Nouvelle-Aquitaine;23;1;03;115;Magnat-l'Étrange;245;2;247
75;Nouvelle-Aquitaine;23;1;02;116;Mainsat;553;11;564
75;Nouvelle-Aquitaine;23;2;07;117;Maison-Feyne;304;7;311
75;Nouvelle-Aquitaine;23;2;01;118;Maisonnisses;183;6;189
75;Nouvelle-Aquitaine;23;1;03;119;Malleret;44;0;44
75;Nouvelle-Aquitaine;23;1;06;120;Malleret-Boussac;191;3;194
75;Nouvelle-Aquitaine;23;2;05;122;Mansat-la-Courrière;73;4;77
75;Nouvelle-Aquitaine;23;1;03;123;Les Mars;191;2;193
75;Nouvelle-Aquitaine;23;2;11;124;Marsac;664;18;682
75;Nouvelle-Aquitaine;23;1;03;125;Le Mas-d'Artige;98;1;99
75;Nouvelle-Aquitaine;23;1;02;127;Mautes;204;6;210
75;Nouvelle-Aquitaine;23;2;01;128;Mazeirat;126;6;132
75;Nouvelle-Aquitaine;23;1;03;129;La Mazière-aux-Bons-Hommes;65;1;66
75;Nouvelle-Aquitaine;23;2;04;130;Méasnes;537;6;543
75;Nouvelle-Aquitaine;23;1;03;131;Mérinchal;703;13;716
75;Nouvelle-Aquitaine;23;2;13;132;Montaigut-le-Blanc;412;6;418
75;Nouvelle-Aquitaine;23;2;05;133;Montboucher;349;12;361
75;Nouvelle-Aquitaine;23;2;09;134;Le Monteil-au-Vicomte;199;47;246
75;Nouvelle-Aquitaine;23;2;04;136;Mortroux;281;9;290
75;Nouvelle-Aquitaine;23;2;11;137;Mourioux-Vieilleville;515;12;527
75;Nouvelle-Aquitaine;23;2;01;138;Moutier-d'Ahun;176;1;177
75;Nouvelle-Aquitaine;23;2;04;139;Moutier-Malcard;544;6;550
75;Nouvelle-Aquitaine;23;1;09;140;Moutier-Rozeille;422;9;431
75;Nouvelle-Aquitaine;23;2;07;141;Naillat;634;16;650
75;Nouvelle-Aquitaine;23;1;02;142;Néoux;286;3;289
75;Nouvelle-Aquitaine;23;2;15;143;Noth;495;13;508
75;Nouvelle-Aquitaine;23;1;09;144;La Nouaille;244;3;247
75;Nouvelle-Aquitaine;23;1;08;145;Nouhant;281;7;288
75;Nouvelle-Aquitaine;23;1;06;146;Nouzerines;244;7;251
75;Nouvelle-Aquitaine;23;2;07;147;Nouzerolles;97;2;99
75;Nouvelle-Aquitaine;23;2;04;148;Nouziers;240;2;242
75;Nouvelle-Aquitaine;23;1;10;149;Parsac-Rimondeix;704;14;718
75;Nouvelle-Aquitaine;23;2;01;150;Peyrabout;155;2;157
75;Nouvelle-Aquitaine;23;1;10;151;Peyrat-la-Nonière;429;8;437
75;Nouvelle-Aquitaine;23;1;10;152;Pierrefitte;71;0;71
75;Nouvelle-Aquitaine;23;1;10;154;Pionnat;748;11;759
75;Nouvelle-Aquitaine;23;2;01;155;Pontarion;365;6;371
75;Nouvelle-Aquitaine;23;1;03;156;Pontcharraud;81;1;82
75;Nouvelle-Aquitaine;23;2;01;157;La Pouge;93;0;93
75;Nouvelle-Aquitaine;23;1;09;158;Poussanges;157;0;157
75;Nouvelle-Aquitaine;23;1;10;159;Puy-Malsignat;152;3;155
75;Nouvelle-Aquitaine;23;1;08;160;Reterre;284;1;285
75;Nouvelle-Aquitaine;23;2;04;162;Roches;366;3;369
75;Nouvelle-Aquitaine;23;1;03;164;Rougnat;489;11;500
75;Nouvelle-Aquitaine;23;2;09;165;Royère-de-Vassivière;576;5;581
75;Nouvelle-Aquitaine;23;2;07;166;Sagnat;192;7;199
75;Nouvelle-Aquitaine;23;2;15;177;Saint-Agnant-de-Versillat;1089;29;1118
75;Nouvelle-Aquitaine;23;1;03;178;Saint-Agnant-près-Crocq;179;0;179
75;Nouvelle-Aquitaine;23;1;02;179;Saint-Alpinien;276;4;280
75;Nouvelle-Aquitaine;23;1;02;180;Saint-Amand;493;3;496
75;Nouvelle-Aquitaine;23;2;05;181;Saint-Amand-Jartoudeix;163;2;165
75;Nouvelle-Aquitaine;23;1;02;182;Saint-Avit-de-Tardes;173;2;175
75;Nouvelle-Aquitaine;23;2;01;183;Saint-Avit-le-Pauvre;78;2;80
75;Nouvelle-Aquitaine;23;1;03;184;Saint-Bard;100;3;103
75;Nouvelle-Aquitaine;23;1;10;185;Saint-Chabrais;289;3;292
75;Nouvelle-Aquitaine;23;2;13;186;Saint-Christophe;155;6;161
75;Nouvelle-Aquitaine;23;1;10;187;Saint-Dizier-la-Tour;203;2;205
75;Nouvelle-Aquitaine;23;2;04;188;Saint-Dizier-les-Domaines;196;2;198
75;Nouvelle-Aquitaine;23;2;05;189;Saint-Dizier-Masbaraud ;1132;25;1157
75;Nouvelle-Aquitaine;23;1;02;190;Saint-Domet;172;1;173
75;Nouvelle-Aquitaine;23;2;13;191;Saint-Éloi;210;8;218
75;Nouvelle-Aquitaine;23;2;14;195;Saint-Fiel;1036;26;1062
75;Nouvelle-Aquitaine;23;1;09;196;Saint-Frion;255;5;260
75;Nouvelle-Aquitaine;23;2;01;197;Saint-Georges-la-Pouge;369;2;371
75;Nouvelle-Aquitaine;23;1;03;198;Saint-Georges-Nigremont;136;1;137
75;Nouvelle-Aquitaine;23;2;07;199;Saint-Germain-Beaupré;411;9;420
75;Nouvelle-Aquitaine;23;2;11;200;Saint-Goussaud;164;8;172
75;Nouvelle-Aquitaine;23;2;01;201;Saint-Hilaire-la-Plaine;211;5;216
75;Nouvelle-Aquitaine;23;2;01;202;Saint-Hilaire-le-Château;231;7;238
75;Nouvelle-Aquitaine;23;1;08;203;Saint-Julien-la-Genête;218;7;225
75;Nouvelle-Aquitaine;23;1;10;204;Saint-Julien-le-Châtel;141;3;144
75;Nouvelle-Aquitaine;23;2;05;205;Saint-Junien-la-Bregère;141;1;142
75;Nouvelle-Aquitaine;23;2;12;206;Saint-Laurent;694;13;707
75;Nouvelle-Aquitaine;23;2;15;207;Saint-Léger-Bridereix;197;3;200
75;Nouvelle-Aquitaine;23;2;14;208;Saint-Léger-le-Guérétois;422;9;431
75;Nouvelle-Aquitaine;23;1;10;209;Saint-Loup;183;1;184
75;Nouvelle-Aquitaine;23;1;02;210;Saint-Maixant;249;2;251
75;Nouvelle-Aquitaine;23;1;02;211;Saint-Marc-à-Frongier;425;9;434
75;Nouvelle-Aquitaine;23;1;09;212;Saint-Marc-à-Loubaud;132;1;133
75;Nouvelle-Aquitaine;23;1;06;213;Saint-Marien;184;2;186
75;Nouvelle-Aquitaine;23;2;01;214;Saint-Martial-le-Mont;267;5;272
75;Nouvelle-Aquitaine;23;1;03;215;Saint-Martial-le-Vieux;139;4;143
75;Nouvelle-Aquitaine;23;2;09;216;Saint-Martin-Château;145;5;150
75;Nouvelle-Aquitaine;23;2;05;217;Saint-Martin-Sainte-Catherine;343;5;348
75;Nouvelle-Aquitaine;23;2;15;219;Saint-Maurice-la-Souterraine;1221;28;1249
75;Nouvelle-Aquitaine;23;1;03;218;Saint-Maurice-près-Crocq;100;1;101
75;Nouvelle-Aquitaine;23;1;10;220;Saint-Médard-la-Rochette;575;12;587
75;Nouvelle-Aquitaine;23;1;03;221;Saint-Merd-la-Breuille;193;5;198
75;Nouvelle-Aquitaine;23;2;01;222;Saint-Michel-de-Veisse;162;3;165
75;Nouvelle-Aquitaine;23;2;05;223;Saint-Moreil;217;0;217
75;Nouvelle-Aquitaine;23;1;03;224;Saint-Oradoux-de-Chirouze;70;0;70
75;Nouvelle-Aquitaine;23;1;03;225;Saint-Oradoux-près-Crocq;100;1;101
75;Nouvelle-Aquitaine;23;1;03;226;Saint-Pardoux-d'Arnet;171;6;177
75;Nouvelle-Aquitaine;23;1;02;228;Saint-Pardoux-le-Neuf;196;5;201
75;Nouvelle-Aquitaine;23;1;10;229;Saint-Pardoux-les-Cards;283;2;285
75;Nouvelle-Aquitaine;23;2;05;227;Saint-Pardoux-Morterolles;203;8;211
75;Nouvelle-Aquitaine;23;2;05;232;Saint-Pierre-Bellevue;210;1;211
75;Nouvelle-Aquitaine;23;2;05;230;Saint-Pierre-Chérignat;167;5;172
75;Nouvelle-Aquitaine;23;1;06;233;Saint-Pierre-le-Bost;128;7;135
75;Nouvelle-Aquitaine;23;1;08;234;Saint-Priest;160;1;161
75;Nouvelle-Aquitaine;23;2;15;235;Saint-Priest-la-Feuille;774;13;787
75;Nouvelle-Aquitaine;23;2;11;236;Saint-Priest-la-Plaine;258;8;266
75;Nouvelle-Aquitaine;23;2;05;237;Saint-Priest-Palus;55;0;55
75;Nouvelle-Aquitaine;23;1;09;238;Saint-Quentin-la-Chabanne;395;7;402
75;Nouvelle-Aquitaine;23;2;07;239;Saint-Sébastien;640;11;651
75;Nouvelle-Aquitaine;23;1;06;240;Saint-Silvain-Bas-le-Roc;401;5;406
75;Nouvelle-Aquitaine;23;1;02;241;Saint-Silvain-Bellegarde;214;3;217
75;Nouvelle-Aquitaine;23;2;13;242;Saint-Silvain-Montaigut;220;3;223
75;Nouvelle-Aquitaine;23;1;10;243;Saint-Silvain-sous-Toulx;160;3;163
75;Nouvelle-Aquitaine;23;2;07;244;Saint-Sulpice-le-Dunois;597;14;611
75;Nouvelle-Aquitaine;23;2;14;245;Saint-Sulpice-le-Guérétois;1947;57;2004
75;Nouvelle-Aquitaine;23;1;02;246;Saint-Sulpice-les-Champs;353;9;362
75;Nouvelle-Aquitaine;23;2;14;247;Saint-Vaury;1744;114;1858
75;Nouvelle-Aquitaine;23;2;13;248;Saint-Victor-en-Marche;368;8;376
75;Nouvelle-Aquitaine;23;1;09;249;Saint-Yrieix-la-Montagne;222;7;229
75;Nouvelle-Aquitaine;23;2;01;250;Saint-Yrieix-les-Bois;288;3;291
75;Nouvelle-Aquitaine;23;2;12;193;Sainte-Feyre;2472;59;2531
75;Nouvelle-Aquitaine;23;1;09;194;Sainte-Feyre-la-Montagne;126;3;129
75;Nouvelle-Aquitaine;23;1;08;167;Sannat;337;8;345
75;Nouvelle-Aquitaine;23;2;01;168;Sardent;779;18;797
75;Nouvelle-Aquitaine;23;2;12;169;La Saunière;620;13;633
75;Nouvelle-Aquitaine;23;2;12;170;Savennes;213;11;224
75;Nouvelle-Aquitaine;23;1;03;171;Sermur;125;1;126
75;Nouvelle-Aquitaine;23;1;02;172;La Serre-Bussière-Vieille;122;1;123
75;Nouvelle-Aquitaine;23;2;05;173;Soubrebost;139;3;142
75;Nouvelle-Aquitaine;23;1;06;174;Soumans;590;7;597
75;Nouvelle-Aquitaine;23;2;01;175;Sous-Parsat;115;1;116
75;Nouvelle-Aquitaine;23;2;15;176;La Souterraine;5094;235;5329
75;Nouvelle-Aquitaine;23;1;08;251;Tardes;132;2;134
75;Nouvelle-Aquitaine;23;2;06;252;Tercillat;158;3;161
75;Nouvelle-Aquitaine;23;2;01;253;Thauron;175;6;181
75;Nouvelle-Aquitaine;23;1;06;254;Toulx-Sainte-Croix;259;2;261
75;Nouvelle-Aquitaine;23;1;10;255;Trois-Fonds;120;0;120
75;Nouvelle-Aquitaine;23;1;09;257;Vallière;718;18;736
75;Nouvelle-Aquitaine;23;2;15;258;Vareilles;307;9;316
75;Nouvelle-Aquitaine;23;1;08;259;Verneiges;117;1;118
75;Nouvelle-Aquitaine;23;2;01;260;Vidaillat;168;0;168
75;Nouvelle-Aquitaine;23;1;08;261;Viersat;296;5;301
75;Nouvelle-Aquitaine;23;1;10;262;Vigeville;164;2;166
75;Nouvelle-Aquitaine;23;2;07;263;Villard;370;5;375
75;Nouvelle-Aquitaine;23;1;09;264;La Villedieu;48;1;49
75;Nouvelle-Aquitaine;23;1;03;265;La Villeneuve;59;0;59
75;Nouvelle-Aquitaine;23;1;03;266;La Villetelle;169;1;170
75;Nouvelle-Aquitaine;24;2;13;001;Abjat-sur-Bandiat;619;7;626
75;Nouvelle-Aquitaine;24;3;22;002;Agonac;1766;23;1789
75;Nouvelle-Aquitaine;24;4;05;004;Ajat;307;3;310
75;Nouvelle-Aquitaine;24;4;23;006;Allas-les-Mines;200;10;210
75;Nouvelle-Aquitaine;24;3;16;007;Allemans;507;13;520
75;Nouvelle-Aquitaine;24;1;08;005;Alles-sur-Dordogne;386;9;395
75;Nouvelle-Aquitaine;24;2;06;008;Angoisse;592;10;602
75;Nouvelle-Aquitaine;24;2;06;009;Anlhiac;272;8;280
75;Nouvelle-Aquitaine;24;3;17;010;Annesse-et-Beaulieu;1425;49;1474
75;Nouvelle-Aquitaine;24;3;22;011;Antonne-et-Trigonant;1293;19;1312
75;Nouvelle-Aquitaine;24;4;20;012;Archignac;369;9;378
75;Nouvelle-Aquitaine;24;4;25;014;Aubas;621;20;641
75;Nouvelle-Aquitaine;24;4;23;015;Audrix;274;4;278
75;Nouvelle-Aquitaine;24;2;13;016;Augignac;819;20;839
75;Nouvelle-Aquitaine;24;4;05;018;Auriac-du-Périgord;391;10;401
75;Nouvelle-Aquitaine;24;4;05;019;Azerat;438;7;445
75;Nouvelle-Aquitaine;24;4;05;020;La Bachellerie;899;20;919
75;Nouvelle-Aquitaine;24;4;05;021;Badefols-d'Ans;398;8;406
75;Nouvelle-Aquitaine;24;1;08;022;Badefols-sur-Dordogne;211;5;216
75;Nouvelle-Aquitaine;24;1;08;023;Baneuil;337;11;348
75;Nouvelle-Aquitaine;24;1;19;024;Bardou;47;0;47
75;Nouvelle-Aquitaine;24;4;05;025;Bars;242;7;249
75;Nouvelle-Aquitaine;24;3;89;026;Bassillac et Auberoche;4456;82;4538
75;Nouvelle-Aquitaine;24;1;08;027;Bayac;356;1;357
75;Nouvelle-Aquitaine;24;1;08;028;Beaumontois en Périgord ;1853;43;1896
75;Nouvelle-Aquitaine;24;3;24;029;Beaupouyet;509;7;516
75;Nouvelle-Aquitaine;24;4;05;030;Beauregard-de-Terrasson;690;16;706
75;Nouvelle-Aquitaine;24;3;12;031;Beauregard-et-Bassac;259;5;264
75;Nouvelle-Aquitaine;24;3;24;032;Beauronne;372;10;382
75;Nouvelle-Aquitaine;24;3;12;034;Beleymas;272;7;279
75;Nouvelle-Aquitaine;24;4;23;036;Berbiguières;176;3;179
75;Nouvelle-Aquitaine;24;1;98;037;Bergerac;26823;718;27541
75;Nouvelle-Aquitaine;24;3;16;038;Bertric-Burée;430;12;442
75;Nouvelle-Aquitaine;24;4;23;039;Besse;157;4;161
75;Nouvelle-Aquitaine;24;4;18;040;Beynac-et-Cazenac;546;9;555
75;Nouvelle-Aquitaine;24;2;03;042;Biras;664;7;671
75;Nouvelle-Aquitaine;24;1;08;043;Biron;147;10;157
75;Nouvelle-Aquitaine;24;1;19;045;Boisse;247;4;251
75;Nouvelle-Aquitaine;24;4;05;046;Boisseuilh;120;1;121
75;Nouvelle-Aquitaine;24;1;11;048;Bonneville-et-Saint-Avit-de-Fumadières;323;7;330
75;Nouvelle-Aquitaine;24;4;20;050;Borrèze;341;12;353
75;Nouvelle-Aquitaine;24;1;10;051;Bosset;213;6;219
75;Nouvelle-Aquitaine;24;1;08;052;Bouillac;124;0;124
75;Nouvelle-Aquitaine;24;3;07;053;Boulazac Isle Manoire ;10725;333;11058
75;Nouvelle-Aquitaine;24;1;19;054;Bouniagues;599;20;619
75;Nouvelle-Aquitaine;24;2;03;055;Bourdeilles;754;16;770
75;Nouvelle-Aquitaine;24;2;13;056;Le Bourdeix;227;4;231
75;Nouvelle-Aquitaine;24;3;16;057;Bourg-des-Maisons;68;0;68
75;Nouvelle-Aquitaine;24;3;16;058;Bourg-du-Bost;222;3;225
75;Nouvelle-Aquitaine;24;3;24;059;Bourgnac;343;6;349
75;Nouvelle-Aquitaine;24;1;08;060;Bourniquel;70;1;71
75;Nouvelle-Aquitaine;24;3;12;061;Bourrou;126;6;132
75;Nouvelle-Aquitaine;24;3;16;062;Bouteilles-Saint-Sébastien;174;3;177
75;Nouvelle-Aquitaine;24;4;23;063;Bouzic;151;3;154
75;Nouvelle-Aquitaine;24;2;03;064;Brantôme en Périgord ;3688;56;3744
75;Nouvelle-Aquitaine;24;2;06;066;Brouchaud;214;5;219
75;Nouvelle-Aquitaine;24;4;25;067;Le Bugue;2591;42;2633
75;Nouvelle-Aquitaine;24;1;08;068;Le Buisson-de-Cadouin;1943;61;2004
75;Nouvelle-Aquitaine;24;2;03;069;Bussac;398;2;400
75;Nouvelle-Aquitaine;24;2;13;070;Busserolles;504;9;513
75;Nouvelle-Aquitaine;24;2;13;071;Bussière-Badil;383;2;385
75;Nouvelle-Aquitaine;24;1;08;073;Calès;380;12;392
75;Nouvelle-Aquitaine;24;4;20;074;Calviac-en-Périgord;512;20;532
75;Nouvelle-Aquitaine;24;4;23;075;Campagnac-lès-Quercy;315;8;323
75;Nouvelle-Aquitaine;24;4;25;076;Campagne;389;13;402
75;Nouvelle-Aquitaine;24;3;12;077;Campsegret;391;8;399
75;Nouvelle-Aquitaine;24;1;08;080;Capdrot;489;13;502
75;Nouvelle-Aquitaine;24;4;20;081;Carlux;630;10;640
75;Nouvelle-Aquitaine;24;4;20;082;Carsac-Aillac;1554;28;1582
75;Nouvelle-Aquitaine;24;1;11;083;Carsac-de-Gurson;185;4;189
75;Nouvelle-Aquitaine;24;4;23;084;Carves;104;4;108
75;Nouvelle-Aquitaine;24;4;20;085;La Cassagne;152;1;153
75;Nouvelle-Aquitaine;24;4;23;086;Castelnaud-la-Chapelle;452;7;459
75;Nouvelle-Aquitaine;24;4;23;087;Castels et Bézenac ;819;19;838
75;Nouvelle-Aquitaine;24;1;08;088;Cause-de-Clérans;346;7;353
75;Nouvelle-Aquitaine;24;4;20;089;Cazoulès;454;13;467
75;Nouvelle-Aquitaine;24;3;16;090;Celles;587;11;598
75;Nouvelle-Aquitaine;24;4;23;091;Cénac-et-Saint-Julien;1203;32;1235
75;Nouvelle-Aquitaine;24;3;12;094;Chalagnac;439;9;448
75;Nouvelle-Aquitaine;24;2;21;095;Chalais;406;9;415
75;Nouvelle-Aquitaine;24;2;03;096;Champagnac-de-Belair;771;14;785
75;Nouvelle-Aquitaine;24;3;16;097;Champagne-et-Fontaine;371;10;381
75;Nouvelle-Aquitaine;24;3;22;098;Champcevinel;2915;88;3003
75;Nouvelle-Aquitaine;24;2;13;100;Champniers-et-Reilhac;453;3;456
75;Nouvelle-Aquitaine;24;2;13;101;Champs-Romain;285;8;293
75;Nouvelle-Aquitaine;24;3;04;102;Chancelade;4257;80;4337
75;Nouvelle-Aquitaine;24;3;24;104;Chantérac;617;7;624
75;Nouvelle-Aquitaine;24;3;03;105;Chapdeuil;133;1;134
75;Nouvelle-Aquitaine;24;4;25;106;La Chapelle-Aubareil;532;23;555
75;Nouvelle-Aquitaine;24;2;03;107;La Chapelle-Faucher;404;6;410
75;Nouvelle-Aquitaine;24;3;17;108;La Chapelle-Gonaguet;1064;16;1080
75;Nouvelle-Aquitaine;24;3;16;109;La Chapelle-Grésignac;106;2;108
75;Nouvelle-Aquitaine;24;3;16;110;La Chapelle-Montabourlet;62;4;66
75;Nouvelle-Aquitaine;24;2;03;111;La Chapelle-Montmoreau;70;1;71
75;Nouvelle-Aquitaine;24;4;05;113;La Chapelle-Saint-Jean;90;1;91
75;Nouvelle-Aquitaine;24;3;16;114;Chassaignes;67;2;69
75;Nouvelle-Aquitaine;24;3;22;115;Château-l'Évêque;2159;31;2190
75;Nouvelle-Aquitaine;24;4;05;116;Châtres;190;1;191
75;Nouvelle-Aquitaine;24;3;16;119;Cherval;263;4;267
75;Nouvelle-Aquitaine;24;2;06;120;Cherveix-Cubas;559;12;571
75;Nouvelle-Aquitaine;24;4;05;121;Chourgnac;60;2;62
75;Nouvelle-Aquitaine;24;4;23;122;Cladech;108;1;109
75;Nouvelle-Aquitaine;24;2;06;124;Clermont-d'Excideuil;234;5;239
75;Nouvelle-Aquitaine;24;3;12;123;Clermont-de-Beauregard;112;1;113
75;Nouvelle-Aquitaine;24;1;19;126;Colombier;263;12;275
75;Nouvelle-Aquitaine;24;4;  ;364;Coly-Saint-Amand ;579;20;599
75;Nouvelle-Aquitaine;24;3;16;128;Comberanche-et-Épeluche;167;3;170
75;Nouvelle-Aquitaine;24;2;03;129;Condat-sur-Trincou;480;8;488
75;Nouvelle-Aquitaine;24;4;20;130;Condat-sur-Vézère;881;16;897
75;Nouvelle-Aquitaine;24;1;19;132;Conne-de-Labarde;250;4;254
75;Nouvelle-Aquitaine;24;2;13;131;Connezac;73;0;73
75;Nouvelle-Aquitaine;24;2;21;133;La Coquille;1300;19;1319
75;Nouvelle-Aquitaine;24;2;21;134;Corgnac-sur-l'Isle;833;13;846
75;Nouvelle-Aquitaine;24;3;22;135;Cornille;680;12;692
75;Nouvelle-Aquitaine;24;4;20;117;Les Coteaux Périgourdins;581;19;600
75;Nouvelle-Aquitaine;24;4;05;136;Coubjours;123;6;129
75;Nouvelle-Aquitaine;24;2;06;137;Coulaures;722;77;799
75;Nouvelle-Aquitaine;24;3;04;138;Coulounieix-Chamiers;7458;297;7755
75;Nouvelle-Aquitaine;24;1;02;140;Cours-de-Pile;1556;34;1590
75;Nouvelle-Aquitaine;24;3;17;139;Coursac;2180;48;2228
75;Nouvelle-Aquitaine;24;3;16;141;Coutures;184;1;185
75;Nouvelle-Aquitaine;24;4;23;142;Coux et Bigaroque-Mouzens;1225;42;1267
75;Nouvelle-Aquitaine;24;1;08;143;Couze-et-Saint-Front;719;8;727
75;Nouvelle-Aquitaine;24;3;03;144;Creyssac;97;0;97
75;Nouvelle-Aquitaine;24;1;02;145;Creysse;1748;30;1778
75;Nouvelle-Aquitaine;24;3;12;146;Creyssensac-et-Pissot;259;9;268
75;Nouvelle-Aquitaine;24;2;06;147;Cubjac-Auvézère-Val d'Ans;1087;10;1097
75;Nouvelle-Aquitaine;24;1;19;148;Cunèges;289;5;294
75;Nouvelle-Aquitaine;24;4;23;150;Daglan;533;19;552
75;Nouvelle-Aquitaine;24;4;23;151;Doissat;104;2;106
75;Nouvelle-Aquitaine;24;4;23;152;Domme;910;22;932
75;Nouvelle-Aquitaine;24;4;20;153;La Dornac;399;11;410
75;Nouvelle-Aquitaine;24;3;03;154;Douchapt;356;10;366
75;Nouvelle-Aquitaine;24;3;12;155;Douville;459;10;469
75;Nouvelle-Aquitaine;24;3;07;156;La Douze;1157;16;1173
75;Nouvelle-Aquitaine;24;3;24;157;Douzillac;796;11;807
75;Nouvelle-Aquitaine;24;2;06;158;Dussac;399;4;403
75;Nouvelle-Aquitaine;24;3;09;159;Échourgnac;392;7;399
75;Nouvelle-Aquitaine;24;3;12;161;Église-Neuve-d'Issac;134;1;135
75;Nouvelle-Aquitaine;24;3;12;160;Église-Neuve-de-Vergt;557;2;559
75;Nouvelle-Aquitaine;24;3;22;162;Escoire;415;9;424
75;Nouvelle-Aquitaine;24;2;13;163;Étouars;158;1;159
75;Nouvelle-Aquitaine;24;2;06;164;Excideuil;1172;40;1212
75;Nouvelle-Aquitaine;24;3;09;165;Eygurande-et-Gardedeuil;410;7;417
75;Nouvelle-Aquitaine;24;1;19;167;Eymet;2614;41;2655
75;Nouvelle-Aquitaine;24;3;12;259;Eyraud-Crempse-Maurens ;1588;31;1619
75;Nouvelle-Aquitaine;24;2;21;171;Eyzerac;558;8;566
75;Nouvelle-Aquitaine;24;4;25;172;Eyzies ;1098;16;1114
75;Nouvelle-Aquitaine;24;4;25;174;Fanlac;139;1;140
75;Nouvelle-Aquitaine;24;4;25;175;Les Farges;320;17;337
75;Nouvelle-Aquitaine;24;1;19;176;Faurilles;37;0;37
75;Nouvelle-Aquitaine;24;1;19;177;Faux;639;10;649
75;Nouvelle-Aquitaine;24;4;20;179;La Feuillade;751;28;779
75;Nouvelle-Aquitaine;24;2;21;180;Firbeix;312;9;321
75;Nouvelle-Aquitaine;24;1;10;182;Le Fleix;1479;53;1532
75;Nouvelle-Aquitaine;24;4;25;183;Fleurac;263;3;266
75;Nouvelle-Aquitaine;24;4;23;184;Florimont-Gaumier;145;2;147
75;Nouvelle-Aquitaine;24;1;19;186;Fonroque;329;2;331
75;Nouvelle-Aquitaine;24;1;10;222;La Force;2665;106;2771
75;Nouvelle-Aquitaine;24;4;05;188;Fossemagne;539;13;552
75;Nouvelle-Aquitaine;24;1;11;189;Fougueyrolles;463;17;480
75;Nouvelle-Aquitaine;24;3;12;190;Fouleix;256;8;264
75;Nouvelle-Aquitaine;24;1;10;191;Fraisse;174;1;175
75;Nouvelle-Aquitaine;24;4;05;192;Gabillou;93;3;96
75;Nouvelle-Aquitaine;24;1;19;193;Gageac-et-Rouillac;469;9;478
75;Nouvelle-Aquitaine;24;1;10;194;Gardonne;1613;25;1638
75;Nouvelle-Aquitaine;24;1;08;195;Gaugeac;109;1;110
75;Nouvelle-Aquitaine;24;2;06;196;Génis;488;4;492
75;Nouvelle-Aquitaine;24;1;10;197;Ginestet;727;14;741
75;Nouvelle-Aquitaine;24;3;16;199;Gout-Rossignol;374;7;381
75;Nouvelle-Aquitaine;24;3;03;200;Grand-Brassac;539;11;550
75;Nouvelle-Aquitaine;24;4;05;202;Granges-d'Ans;149;4;153
75;Nouvelle-Aquitaine;24;3;17;205;Grignols;671;5;676
75;Nouvelle-Aquitaine;24;4;23;206;Grives;110;4;114
75;Nouvelle-Aquitaine;24;4;23;207;Groléjac;655;16;671
75;Nouvelle-Aquitaine;24;3;12;208;Grun-Bordas;235;4;239
75;Nouvelle-Aquitaine;24;2;13;209;Hautefaye;138;1;139
75;Nouvelle-Aquitaine;24;4;05;210;Hautefort;894;20;914
75;Nouvelle-Aquitaine;24;3;12;211;Issac;440;3;443
75;Nouvelle-Aquitaine;24;1;19;212;Issigeac;749;10;759
75;Nouvelle-Aquitaine;24;3;17;213;Jaure;170;2;172
75;Nouvelle-Aquitaine;24;2;13;214;Javerlhac-et-la-Chapelle-Saint-Robert;841;10;851
75;Nouvelle-Aquitaine;24;4;20;215;Jayac;176;3;179
75;Nouvelle-Aquitaine;24;3;16;216;La Jemaye-Ponteyraud;153;3;156
75;Nouvelle-Aquitaine;24;4;25;217;Journiac;443;8;451
75;Nouvelle-Aquitaine;24;2;21;218;Jumilhac-le-Grand;1207;44;1251
75;Nouvelle-Aquitaine;24;3;12;220;Lacropte;663;8;671
75;Nouvelle-Aquitaine;24;1;08;223;Lalinde;2781;37;2818
75;Nouvelle-Aquitaine;24;1;02;224;Lamonzie-Montastruc;702;12;714
75;Nouvelle-Aquitaine;24;1;10;225;Lamonzie-Saint-Martin;2565;35;2600
75;Nouvelle-Aquitaine;24;1;11;226;Lamothe-Montravel;1353;21;1374
75;Nouvelle-Aquitaine;24;2;06;227;Lanouaille;1000;25;1025
75;Nouvelle-Aquitaine;24;1;08;228;Lanquais;494;13;507
75;Nouvelle-Aquitaine;24;4;05;229;Le Lardin-Saint-Lazare;1720;39;1759
75;Nouvelle-Aquitaine;24;4;23;230;Larzac;149;1;150
75;Nouvelle-Aquitaine;24;1;08;231;Lavalade;87;1;88
75;Nouvelle-Aquitaine;24;4;23;232;Lavaur;70;2;72
75;Nouvelle-Aquitaine;24;3;24;234;Les Lèches;371;2;373
75;Nouvelle-Aquitaine;24;3;17;236;Léguillac-de-l'Auche;990;14;1004
75;Nouvelle-Aquitaine;24;1;02;237;Lembras;1175;24;1199
75;Nouvelle-Aquitaine;24;2;21;238;Lempzours;136;5;141
75;Nouvelle-Aquitaine;24;4;12;240;Limeuil;334;7;341
75;Nouvelle-Aquitaine;24;4;05;241;Limeyrat;444;10;454
75;Nouvelle-Aquitaine;24;1;08;242;Liorac-sur-Louyre;250;1;251
75;Nouvelle-Aquitaine;24;3;03;243;Lisle;836;11;847
75;Nouvelle-Aquitaine;24;1;08;244;Lolme;195;2;197
75;Nouvelle-Aquitaine;24;4;23;245;Loubejac;263;3;266
75;Nouvelle-Aquitaine;24;1;10;246;Lunas;403;5;408
75;Nouvelle-Aquitaine;24;3;16;247;Lusignac;173;3;176
75;Nouvelle-Aquitaine;24;2;13;248;Lussas-et-Nontronneau;291;7;298
75;Nouvelle-Aquitaine;24;3;17;251;Manzac-sur-Vern;582;9;591
75;Nouvelle-Aquitaine;24;4;18;252;Marcillac-Saint-Quentin;804;20;824
75;Nouvelle-Aquitaine;24;2;03;253;Mareuil en Périgord ;2315;48;2363
75;Nouvelle-Aquitaine;24;4;23;254;Marnac;187;1;188
75;Nouvelle-Aquitaine;24;4;18;255;Marquay;579;9;588
75;Nouvelle-Aquitaine;24;3;04;256;Marsac-sur-l'Isle;3105;73;3178
75;Nouvelle-Aquitaine;24;1;08;257;Marsalès;232;5;237
75;Nouvelle-Aquitaine;24;1;08;260;Mauzac-et-Grand-Castang;865;9;874
75;Nouvelle-Aquitaine;24;4;25;261;Mauzens-et-Miremont;294;10;304
75;Nouvelle-Aquitaine;24;2;06;262;Mayac;344;7;351
75;Nouvelle-Aquitaine;24;4;23;263;Mazeyrolles;306;13;319
75;Nouvelle-Aquitaine;24;3;09;264;Ménesplet;1827;15;1842
75;Nouvelle-Aquitaine;24;3;17;266;Mensignac;1523;27;1550
75;Nouvelle-Aquitaine;24;1;19;267;Mescoules;179;1;180
75;Nouvelle-Aquitaine;24;4;23;268;Meyrals;646;13;659
75;Nouvelle-Aquitaine;24;2;21;269;Mialet;620;7;627
75;Nouvelle-Aquitaine;24;2;13;271;Milhac-de-Nontron;495;13;508
75;Nouvelle-Aquitaine;24;1;11;272;Minzac;465;5;470
75;Nouvelle-Aquitaine;24;1;08;273;Molières;332;10;342
75;Nouvelle-Aquitaine;24;1;19;274;Monbazillac;817;88;905
75;Nouvelle-Aquitaine;24;1;19;276;Monestier;395;4;399
75;Nouvelle-Aquitaine;24;1;10;277;Monfaucon;292;4;296
75;Nouvelle-Aquitaine;24;1;19;278;Monmadalès;82;1;83
75;Nouvelle-Aquitaine;24;1;19;279;Monmarvès;63;1;64
75;Nouvelle-Aquitaine;24;1;08;280;Monpazier;466;8;474
75;Nouvelle-Aquitaine;24;4;23;293;Monplaisant;299;4;303
75;Nouvelle-Aquitaine;24;1;08;281;Monsac;193;7;200
75;Nouvelle-Aquitaine;24;1;19;282;Monsaguel;149;7;156
75;Nouvelle-Aquitaine;24;4;05;284;Montagnac-d'Auberoche;141;5;146
75;Nouvelle-Aquitaine;24;3;12;285;Montagnac-la-Crempse;404;13;417
75;Nouvelle-Aquitaine;24;3;03;286;Montagrier;506;10;516
75;Nouvelle-Aquitaine;24;1;19;287;Montaut;127;2;129
75;Nouvelle-Aquitaine;24;1;11;288;Montazeau;290;4;294
75;Nouvelle-Aquitaine;24;1;11;289;Montcaret;1466;21;1487
75;Nouvelle-Aquitaine;24;1;08;290;Montferrand-du-Périgord;156;5;161
75;Nouvelle-Aquitaine;24;4;25;291;Montignac;2752;55;2807
75;Nouvelle-Aquitaine;24;1;11;292;Montpeyroux;451;7;458
75;Nouvelle-Aquitaine;24;3;09;294;Montpon-Ménestérol;5602;68;5670
75;Nouvelle-Aquitaine;24;3;17;295;Montrem;1231;20;1251
75;Nouvelle-Aquitaine;24;1;02;296;Mouleydier;1133;15;1148
75;Nouvelle-Aquitaine;24;3;09;297;Moulin-Neuf;935;13;948
75;Nouvelle-Aquitaine;24;3;24;299;Mussidan;2736;49;2785
75;Nouvelle-Aquitaine;24;4;23;300;Nabirat;369;10;379
75;Nouvelle-Aquitaine;24;4;20;301;Nadaillac;381;4;385
75;Nouvelle-Aquitaine;24;4;05;302;Nailhac;321;2;323
75;Nouvelle-Aquitaine;24;3;16;303;Nanteuil-Auriac-de-Bourzac;229;3;232
75;Nouvelle-Aquitaine;24;2;21;304;Nantheuil;974;23;997
75;Nouvelle-Aquitaine;24;2;21;305;Nanthiat;237;2;239
75;Nouvelle-Aquitaine;24;1;11;306;Nastringues;123;4;127
75;Nouvelle-Aquitaine;24;1;08;307;Naussannes;260;5;265
75;Nouvelle-Aquitaine;24;2;21;308;Négrondes;797;10;807
75;Nouvelle-Aquitaine;24;3;24;309;Neuvic;3600;67;3667
75;Nouvelle-Aquitaine;24;2;13;311;Nontron;3068;111;3179
75;Nouvelle-Aquitaine;24;4;23;313;Orliac;57;0;57
75;Nouvelle-Aquitaine;24;4;20;314;Orliaguet;108;9;117
75;Nouvelle-Aquitaine;24;3;09;316;Parcoul-Chenaud;782;16;798
75;Nouvelle-Aquitaine;24;4;20;317;Paulin;256;8;264
75;Nouvelle-Aquitaine;24;3;12;318;Paunat;310;8;318
75;Nouvelle-Aquitaine;24;3;03;319;Paussac-et-Saint-Vivien;472;7;479
75;Nouvelle-Aquitaine;24;4;23;035;Pays de Belvès;1384;35;1419
75;Nouvelle-Aquitaine;24;2;06;320;Payzac;978;17;995
75;Nouvelle-Aquitaine;24;4;20;321;Pazayac;891;13;904
75;Nouvelle-Aquitaine;24;3;99;322;Périgueux;30060;1582;31642
75;Nouvelle-Aquitaine;24;3;16;323;Petit-Bersac;182;5;187
75;Nouvelle-Aquitaine;24;4;05;324;Peyrignac;575;9;584
75;Nouvelle-Aquitaine;24;4;20;325;Peyrillac-et-Millac;211;4;215
75;Nouvelle-Aquitaine;24;4;25;326;Peyzac-le-Moustier;181;2;183
75;Nouvelle-Aquitaine;24;1;08;327;Pezuls;125;3;128
75;Nouvelle-Aquitaine;24;2;13;328;Piégut-Pluviers;1171;20;1191
75;Nouvelle-Aquitaine;24;3;09;329;Le Pizou;1348;20;1368
75;Nouvelle-Aquitaine;24;1;19;168;Plaisance;432;13;445
75;Nouvelle-Aquitaine;24;4;25;330;Plazac;689;27;716
75;Nouvelle-Aquitaine;24;1;19;331;Pomport;729;23;752
75;Nouvelle-Aquitaine;24;1;08;334;Pontours;190;5;195
75;Nouvelle-Aquitaine;24;1;11;335;Port-Sainte-Foy-et-Ponchapt;2488;46;2534
75;Nouvelle-Aquitaine;24;4;20;336;Prats-de-Carlux;538;19;557
75;Nouvelle-Aquitaine;24;4;23;337;Prats-du-Périgord;148;2;150
75;Nouvelle-Aquitaine;24;1;08;338;Pressignac-Vicq;431;11;442
75;Nouvelle-Aquitaine;24;2;06;339;Preyssac-d'Excideuil;152;0;152
75;Nouvelle-Aquitaine;24;1;10;340;Prigonrieux;4160;80;4240
75;Nouvelle-Aquitaine;24;4;18;341;Proissans;1027;20;1047
75;Nouvelle-Aquitaine;24;1;02;345;Queyssac;464;15;479
75;Nouvelle-Aquitaine;24;2;03;346;Quinsac;370;9;379
75;Nouvelle-Aquitaine;24;1;08;347;Rampieux;147;0;147
75;Nouvelle-Aquitaine;24;1;19;348;Razac-d'Eymet;297;1;298
75;Nouvelle-Aquitaine;24;1;19;349;Razac-de-Saussignac;335;10;345
75;Nouvelle-Aquitaine;24;3;04;350;Razac-sur-l'Isle;2395;41;2436
75;Nouvelle-Aquitaine;24;1;19;351;Ribagnac;311;6;317
75;Nouvelle-Aquitaine;24;3;16;352;Ribérac;3862;148;4010
75;Nouvelle-Aquitaine;24;3;09;354;La Roche-Chalais;3010;52;3062
75;Nouvelle-Aquitaine;24;2;03;353;La Rochebeaucourt-et-Argentine;329;9;338
75;Nouvelle-Aquitaine;24;4;18;355;La Roque-Gageac;426;4;430
75;Nouvelle-Aquitaine;24;1;19;357;Rouffignac-de-Sigoulès;303;6;309
75;Nouvelle-Aquitaine;24;4;25;356;Rouffignac-Saint-Cernin-de-Reilhac;1615;35;1650
75;Nouvelle-Aquitaine;24;2;03;221;Rudeau-Ladosse;159;3;162
75;Nouvelle-Aquitaine;24;1;19;359;Sadillac;121;0;121
75;Nouvelle-Aquitaine;24;4;23;360;Sagelat;321;5;326
75;Nouvelle-Aquitaine;24;1;08;361;Saint-Agne;444;7;451
75;Nouvelle-Aquitaine;24;3;12;365;Saint-Amand-de-Vergt;239;8;247
75;Nouvelle-Aquitaine;24;4;18;366;Saint-André-d'Allas;845;20;865
75;Nouvelle-Aquitaine;24;3;16;367;Saint-André-de-Double;177;2;179
75;Nouvelle-Aquitaine;24;1;11;370;Saint-Antoine-de-Breuilh;1871;39;1910
75;Nouvelle-Aquitaine;24;3;24;371;Saint-Aquilin;472;3;475
75;Nouvelle-Aquitaine;24;3;17;372;Saint-Astier;5422;95;5517
75;Nouvelle-Aquitaine;24;1;19;373;Saint-Aubin-de-Cadelech;338;8;346
75;Nouvelle-Aquitaine;24;1;19;374;Saint-Aubin-de-Lanquais;348;4;352
75;Nouvelle-Aquitaine;24;4;23;375;Saint-Aubin-de-Nabirat;146;3;149
75;Nouvelle-Aquitaine;24;3;09;376;Saint Aulaye-Puymangou;1427;19;1446
75;Nouvelle-Aquitaine;24;4;25;377;Saint-Avit-de-Vialard;160;7;167
75;Nouvelle-Aquitaine;24;1;08;378;Saint-Avit-Rivière;80;1;81
75;Nouvelle-Aquitaine;24;1;08;379;Saint-Avit-Sénieur;422;4;426
75;Nouvelle-Aquitaine;24;3;09;380;Saint-Barthélemy-de-Bellegarde;494;2;496
75;Nouvelle-Aquitaine;24;2;13;381;Saint-Barthélemy-de-Bussière;214;8;222
75;Nouvelle-Aquitaine;24;1;19;383;Saint-Capraise-d'Eymet;160;2;162
75;Nouvelle-Aquitaine;24;1;08;382;Saint-Capraise-de-Lalinde;528;9;537
75;Nouvelle-Aquitaine;24;1;08;384;Saint-Cassien;35;1;36
75;Nouvelle-Aquitaine;24;4;23;386;Saint-Cernin-de-l'Herm;224;11;235
75;Nouvelle-Aquitaine;24;1;19;385;Saint-Cernin-de-Labarde;218;2;220
75;Nouvelle-Aquitaine;24;4;25;388;Saint-Chamassy;504;15;519
75;Nouvelle-Aquitaine;24;3;07;390;Saint-Crépin-d'Auberoche;349;9;358
75;Nouvelle-Aquitaine;24;4;20;392;Saint-Crépin-et-Carlucet;521;10;531
75;Nouvelle-Aquitaine;24;4;23;395;Saint-Cybranet;371;6;377
75;Nouvelle-Aquitaine;24;4;23;396;Saint-Cyprien;1554;34;1588
75;Nouvelle-Aquitaine;24;2;06;397;Saint-Cyr-les-Champagnes;240;7;247
75;Nouvelle-Aquitaine;24;2;13;398;Saint-Estèphe;607;7;614
75;Nouvelle-Aquitaine;24;3;24;399;Saint-Étienne-de-Puycorbier;106;4;110
75;Nouvelle-Aquitaine;24;2;03;403;Saint-Félix-de-Bourdeilles;63;0;63
75;Nouvelle-Aquitaine;24;4;25;404;Saint-Félix-de-Reillac-et-Mortemart;182;5;187
75;Nouvelle-Aquitaine;24;1;08;405;Saint-Félix-de-Villadeix;327;9;336
75;Nouvelle-Aquitaine;24;2;21;408;Saint-Front-d'Alemps;260;4;264
75;Nouvelle-Aquitaine;24;3;24;409;Saint-Front-de-Pradoux;1178;16;1194
75;Nouvelle-Aquitaine;24;2;13;410;Saint-Front-la-Rivière;507;8;515
75;Nouvelle-Aquitaine;24;2;13;411;Saint-Front-sur-Nizonne;159;2;161
75;Nouvelle-Aquitaine;24;4;20;412;Saint-Geniès;926;26;952
75;Nouvelle-Aquitaine;24;1;10;413;Saint-Georges-Blancaneix;265;0;265
75;Nouvelle-Aquitaine;24;3;12;414;Saint-Georges-de-Montclard;289;5;294
75;Nouvelle-Aquitaine;24;1;11;415;Saint-Géraud-de-Corps;248;2;250
75;Nouvelle-Aquitaine;24;4;23;416;Saint-Germain-de-Belvès;175;9;184
75;Nouvelle-Aquitaine;24;2;06;417;Saint-Germain-des-Prés;478;8;486
75;Nouvelle-Aquitaine;24;3;24;418;Saint-Germain-du-Salembre;943;7;950
75;Nouvelle-Aquitaine;24;1;02;419;Saint-Germain-et-Mons;846;19;865
75;Nouvelle-Aquitaine;24;1;10;420;Saint-Géry;237;2;239
75;Nouvelle-Aquitaine;24;3;07;421;Saint-Geyrac;198;6;204
75;Nouvelle-Aquitaine;24;3;12;422;Saint-Hilaire-d'Estissac;114;2;116
75;Nouvelle-Aquitaine;24;3;24;424;Saint-Jean-d'Ataux;133;3;136
75;Nouvelle-Aquitaine;24;3;12;426;Saint-Jean-d'Estissac;172;6;178
75;Nouvelle-Aquitaine;24;2;21;425;Saint-Jean-de-Côle;365;6;371
75;Nouvelle-Aquitaine;24;2;21;428;Saint-Jory-de-Chalais;595;38;633
75;Nouvelle-Aquitaine;24;2;06;429;Saint-Jory-las-Bloux;236;8;244
75;Nouvelle-Aquitaine;24;4;20;432;Saint-Julien-de-Lampon;630;17;647
75;Nouvelle-Aquitaine;24;1;19;423;Saint-Julien-Innocence-Eulalie ;306;3;309
75;Nouvelle-Aquitaine;24;3;03;434;Saint-Just;141;2;143
75;Nouvelle-Aquitaine;24;3;24;436;Saint-Laurent-des-Hommes;1015;18;1033
75;Nouvelle-Aquitaine;24;1;10;437;Saint-Laurent-des-Vignes;896;13;909
75;Nouvelle-Aquitaine;24;4;23;438;Saint-Laurent-la-Vallée;238;9;247
75;Nouvelle-Aquitaine;24;1;19;441;Saint-Léon-d'Issigeac;135;3;138
75;Nouvelle-Aquitaine;24;3;17;442;Saint-Léon-sur-l'Isle;2030;23;2053
75;Nouvelle-Aquitaine;24;4;25;443;Saint-Léon-sur-Vézère;421;12;433
75;Nouvelle-Aquitaine;24;3;24;444;Saint-Louis-en-l'Isle;303;7;310
75;Nouvelle-Aquitaine;24;3;12;459;Saint-Maime-de-Péreyrol;284;9;293
75;Nouvelle-Aquitaine;24;1;08;445;Saint-Marcel-du-Périgord;147;5;152
75;Nouvelle-Aquitaine;24;1;08;446;Saint-Marcory;49;3;52
75;Nouvelle-Aquitaine;24;2;06;448;Saint-Martial-d'Albarède;469;9;478
75;Nouvelle-Aquitaine;24;3;09;449;Saint-Martial-d'Artenset;945;7;952
75;Nouvelle-Aquitaine;24;4;23;450;Saint-Martial-de-Nabirat;574;4;578
75;Nouvelle-Aquitaine;24;2;13;451;Saint-Martial-de-Valette;793;18;811
75;Nouvelle-Aquitaine;24;3;16;452;Saint-Martial-Viveyrol;192;2;194
75;Nouvelle-Aquitaine;24;2;21;453;Saint-Martin-de-Fressengeas;362;6;368
75;Nouvelle-Aquitaine;24;1;11;454;Saint-Martin-de-Gurson;661;7;668
75;Nouvelle-Aquitaine;24;3;16;455;Saint-Martin-de-Ribérac;731;10;741
75;Nouvelle-Aquitaine;24;3;12;456;Saint-Martin-des-Combes;193;8;201
75;Nouvelle-Aquitaine;24;3;24;457;Saint-Martin-l'Astier;138;1;139
75;Nouvelle-Aquitaine;24;2;13;458;Saint-Martin-le-Pin;269;7;276
75;Nouvelle-Aquitaine;24;3;16;460;Saint-Méard-de-Drône;498;6;504
75;Nouvelle-Aquitaine;24;1;11;461;Saint-Méard-de-Gurçon;815;17;832
75;Nouvelle-Aquitaine;24;2;06;463;Saint-Médard-d'Excideuil;545;16;561
75;Nouvelle-Aquitaine;24;3;24;462;Saint-Médard-de-Mussidan;1708;24;1732
75;Nouvelle-Aquitaine;24;2;06;464;Saint-Mesmin;322;6;328
75;Nouvelle-Aquitaine;24;3;24;465;Saint-Michel-de-Double;238;6;244
75;Nouvelle-Aquitaine;24;1;11;466;Saint-Michel-de-Montaigne;331;5;336
75;Nouvelle-Aquitaine;24;3;12;468;Saint-Michel-de-Villadeix;311;6;317
75;Nouvelle-Aquitaine;24;1;02;472;Saint-Nexans;975;18;993
75;Nouvelle-Aquitaine;24;2;03;474;Saint-Pancrace;177;1;178
75;Nouvelle-Aquitaine;24;2;06;476;Saint-Pantaly-d'Excideuil;154;3;157
75;Nouvelle-Aquitaine;24;3;16;477;Saint-Pardoux-de-Drône;195;5;200
75;Nouvelle-Aquitaine;24;4;23;478;Saint-Pardoux-et-Vielvic;201;0;201
75;Nouvelle-Aquitaine;24;2;13;479;Saint-Pardoux-la-Rivière;1171;13;1184
75;Nouvelle-Aquitaine;24;3;12;480;Saint-Paul-de-Serre;288;8;296
75;Nouvelle-Aquitaine;24;2;21;481;Saint-Paul-la-Roche;521;0;521
75;Nouvelle-Aquitaine;24;3;16;482;Saint-Paul-Lizonne;277;3;280
75;Nouvelle-Aquitaine;24;1;19;483;Saint-Perdoux;139;7;146
75;Nouvelle-Aquitaine;24;1;10;487;Saint-Pierre-d'Eyraud;1807;15;1822
75;Nouvelle-Aquitaine;24;3;07;484;Saint-Pierre-de-Chignac;876;17;893
75;Nouvelle-Aquitaine;24;2;21;485;Saint-Pierre-de-Côle;425;2;427
75;Nouvelle-Aquitaine;24;2;21;486;Saint-Pierre-de-Frugie;403;3;406
75;Nouvelle-Aquitaine;24;4;23;488;Saint-Pompont;361;6;367
75;Nouvelle-Aquitaine;24;2;21;489;Saint-Priest-les-Fougères;381;5;386
75;Nouvelle-Aquitaine;24;3;09;490;Saint Privat en Périgord;1114;14;1128
75;Nouvelle-Aquitaine;24;4;05;491;Saint-Rabier;580;9;589
75;Nouvelle-Aquitaine;24;2;06;493;Saint-Raphaël;94;2;96
75;Nouvelle-Aquitaine;24;1;11;494;Saint-Rémy;512;4;516
75;Nouvelle-Aquitaine;24;1;08;495;Saint-Romain-de-Monpazier;113;3;116
75;Nouvelle-Aquitaine;24;2;21;496;Saint-Romain-et-Saint-Clément;329;4;333
75;Nouvelle-Aquitaine;24;2;13;498;Saint-Saud-Lacoussière;830;22;852
75;Nouvelle-Aquitaine;24;1;02;499;Saint-Sauveur;851;21;872
75;Nouvelle-Aquitaine;24;3;09;500;Saint-Sauveur-Lalande;153;7;160
75;Nouvelle-Aquitaine;24;1;11;501;Saint-Seurin-de-Prats;493;8;501
75;Nouvelle-Aquitaine;24;3;24;502;Saint-Séverin-d'Estissac;95;0;95
75;Nouvelle-Aquitaine;24;2;06;505;Saint-Sulpice-d'Excideuil;349;3;352
75;Nouvelle-Aquitaine;24;3;16;504;Saint-Sulpice-de-Roumagnac;283;1;284
75;Nouvelle-Aquitaine;24;3;03;508;Saint-Victor;206;5;211
75;Nouvelle-Aquitaine;24;3;16;509;Saint-Vincent-de-Connezac;668;12;680
75;Nouvelle-Aquitaine;24;4;18;510;Saint-Vincent-de-Cosse;363;12;375
75;Nouvelle-Aquitaine;24;3;09;511;Saint-Vincent-Jalmoutiers;251;3;254
75;Nouvelle-Aquitaine;24;4;18;512;Saint-Vincent-le-Paluel;279;10;289
75;Nouvelle-Aquitaine;24;2;06;513;Saint-Vincent-sur-l'Isle;307;3;310
75;Nouvelle-Aquitaine;24;1;11;514;Saint-Vivien;248;2;250
75;Nouvelle-Aquitaine;24;1;08;393;Sainte-Croix;87;0;87
75;Nouvelle-Aquitaine;24;2;03;394;Sainte-Croix-de-Mareuil;153;7;160
75;Nouvelle-Aquitaine;24;4;05;401;Sainte-Eulalie-d'Ans;291;4;295
75;Nouvelle-Aquitaine;24;4;23;406;Sainte-Foy-de-Belvès;139;2;141
75;Nouvelle-Aquitaine;24;1;08;407;Sainte-Foy-de-Longas;238;7;245
75;Nouvelle-Aquitaine;24;4;20;470;Sainte-Mondane;257;5;262
75;Nouvelle-Aquitaine;24;4;18;471;Sainte-Nathalène;610;12;622
75;Nouvelle-Aquitaine;24;4;05;473;Sainte-Orse;355;6;361
75;Nouvelle-Aquitaine;24;1;19;492;Sainte-Radegonde;62;1;63
75;Nouvelle-Aquitaine;24;4;05;507;Sainte-Trie;110;2;112
75;Nouvelle-Aquitaine;24;2;06;515;Salagnac;749;4;753
75;Nouvelle-Aquitaine;24;4;20;516;Salignac-Eyvigues;1173;54;1227
75;Nouvelle-Aquitaine;24;4;23;517;Salles-de-Belvès;72;2;74
75;Nouvelle-Aquitaine;24;3;12;518;Salon;278;4;282
75;Nouvelle-Aquitaine;24;3;88;312;Sanilhac;4576;100;4676
75;Nouvelle-Aquitaine;24;2;06;519;Sarlande;435;0;435
75;Nouvelle-Aquitaine;24;4;18;520;Sarlat-la-Canéda;8793;408;9201
75;Nouvelle-Aquitaine;24;3;22;521;Sarliac-sur-l'Isle;1024;19;1043
75;Nouvelle-Aquitaine;24;2;06;522;Sarrazac;374;11;385
75;Nouvelle-Aquitaine;24;1;19;523;Saussignac;426;13;439
75;Nouvelle-Aquitaine;24;4;25;524;Savignac-de-Miremont;178;5;183
75;Nouvelle-Aquitaine;24;2;13;525;Savignac-de-Nontron;192;2;194
75;Nouvelle-Aquitaine;24;2;06;526;Savignac-Lédrier;715;9;724
75;Nouvelle-Aquitaine;24;3;06;527;Savignac-les-Églises;953;16;969
75;Nouvelle-Aquitaine;24;2;13;528;Sceau-Saint-Angel;125;2;127
75;Nouvelle-Aquitaine;24;3;03;529;Segonzac;202;2;204
75;Nouvelle-Aquitaine;24;4;25;531;Sergeac;214;3;217
75;Nouvelle-Aquitaine;24;1;19;532;Serres-et-Montguyard;244;3;247
75;Nouvelle-Aquitaine;24;3;09;533;Servanches;81;4;85
75;Nouvelle-Aquitaine;24;1;19;534;Sigoulès-et-Flaugeac ;1205;240;1445
75;Nouvelle-Aquitaine;24;4;20;535;Simeyrols;256;3;259
75;Nouvelle-Aquitaine;24;1;19;536;Singleyrac;283;5;288
75;Nouvelle-Aquitaine;24;3;16;537;Siorac-de-Ribérac;248;4;252
75;Nouvelle-Aquitaine;24;4;23;538;Siorac-en-Périgord;1057;11;1068
75;Nouvelle-Aquitaine;24;3;21;540;Sorges et Ligueux en Périgord;1577;28;1605
75;Nouvelle-Aquitaine;24;2;13;541;Soudat;90;0;90
75;Nouvelle-Aquitaine;24;1;08;542;Soulaures;86;3;89
75;Nouvelle-Aquitaine;24;3;24;543;Sourzac;1106;14;1120
75;Nouvelle-Aquitaine;24;4;18;544;Tamniès;386;10;396
75;Nouvelle-Aquitaine;24;4;05;545;Teillots;101;1;102
75;Nouvelle-Aquitaine;24;4;05;546;Temple-Laguyon;39;0;39
75;Nouvelle-Aquitaine;24;4;20;547;Terrasson-Lavilledieu;6234;106;6340
75;Nouvelle-Aquitaine;24;2;13;548;Teyjat;274;5;279
75;Nouvelle-Aquitaine;24;1;19;549;Thénac;492;10;502
75;Nouvelle-Aquitaine;24;4;05;550;Thenon;1260;16;1276
75;Nouvelle-Aquitaine;24;2;21;551;Thiviers;2871;181;3052
75;Nouvelle-Aquitaine;24;4;25;552;Thonac;252;4;256
75;Nouvelle-Aquitaine;24;3;03;553;Tocane-Saint-Apre;1716;36;1752
75;Nouvelle-Aquitaine;24;3;16;554;La Tour-Blanche-Cercles;585;13;598
75;Nouvelle-Aquitaine;24;4;05;555;Tourtoirac;642;10;652
75;Nouvelle-Aquitaine;24;3;22;557;Trélissac;6821;202;7023
75;Nouvelle-Aquitaine;24;1;12;558;Trémolat;645;5;650
75;Nouvelle-Aquitaine;24;4;25;559;Tursac;330;10;340
75;Nouvelle-Aquitaine;24;1;08;560;Urval;116;7;123
75;Nouvelle-Aquitaine;24;3;12;362;Val de Louyre et Caudeau ;1595;26;1621
75;Nouvelle-Aquitaine;24;3;24;562;Vallereuil;279;11;290
75;Nouvelle-Aquitaine;24;4;25;563;Valojoulx;274;7;281
75;Nouvelle-Aquitaine;24;3;16;564;Vanxains;695;97;792
75;Nouvelle-Aquitaine;24;2;13;565;Varaignes;387;8;395
75;Nouvelle-Aquitaine;24;1;08;566;Varennes;465;4;469
75;Nouvelle-Aquitaine;24;2;21;567;Vaunac;262;3;265
75;Nouvelle-Aquitaine;24;1;11;568;Vélines;1081;11;1092
75;Nouvelle-Aquitaine;24;3;16;569;Vendoire;130;2;132
75;Nouvelle-Aquitaine;24;1;08;570;Verdon;45;1;46
75;Nouvelle-Aquitaine;24;3;12;571;Vergt;1679;14;1693
75;Nouvelle-Aquitaine;24;1;08;572;Vergt-de-Biron;193;5;198
75;Nouvelle-Aquitaine;24;3;16;573;Verteillac;632;15;647
75;Nouvelle-Aquitaine;24;4;20;574;Veyrignac;337;8;345
75;Nouvelle-Aquitaine;24;4;23;575;Veyrines-de-Domme;231;22;253
75;Nouvelle-Aquitaine;24;3;12;576;Veyrines-de-Vergt;249;10;259
75;Nouvelle-Aquitaine;24;4;18;577;Vézac;556;10;566
75;Nouvelle-Aquitaine;24;4;05;580;Villac;266;2;268
75;Nouvelle-Aquitaine;24;3;12;581;Villamblard;894;19;913
75;Nouvelle-Aquitaine;24;2;03;582;Villars;458;9;467
75;Nouvelle-Aquitaine;24;1;11;584;Villefranche-de-Lonchat;972;18;990
75;Nouvelle-Aquitaine;24;4;23;585;Villefranche-du-Périgord;682;12;694
75;Nouvelle-Aquitaine;24;3;16;586;Villetoureix;911;22;933
75;Nouvelle-Aquitaine;24;4;18;587;Vitrac;809;21;830
27;Bourgogne-Franche-Comté;25;1;17;001;Abbans-Dessous;258;6;264
27;Bourgogne-Franche-Comté;25;1;17;002;Abbans-Dessus;305;5;310
27;Bourgogne-Franche-Comté;25;1;02;003;Abbenans;332;6;338
27;Bourgogne-Franche-Comté;25;2;12;004;Abbévillers;1050;20;1070
27;Bourgogne-Franche-Comté;25;2;03;005;Accolans;93;1;94
27;Bourgogne-Franche-Comté;25;1;02;006;Adam-lès-Passavant;90;2;92
27;Bourgogne-Franche-Comté;25;3;18;007;Adam-lès-Vercel;104;3;107
27;Bourgogne-Franche-Comté;25;2;03;008;Aibre;470;4;474
27;Bourgogne-Franche-Comté;25;1;02;009;Aïssey;163;3;166
27;Bourgogne-Franche-Comté;25;2;10;011;Allenjoie;738;16;754
27;Bourgogne-Franche-Comté;25;3;15;012;Les Alliés;161;5;166
27;Bourgogne-Franche-Comté;25;2;03;013;Allondans;258;3;261
27;Bourgogne-Franche-Comté;25;1;08;014;Amagney;904;11;915
27;Bourgogne-Franche-Comté;25;1;15;015;Amancey;703;20;723
27;Bourgogne-Franche-Comté;25;1;15;016;Amathay-Vésigneux;164;4;168
27;Bourgogne-Franche-Comté;25;1;15;017;Amondans;87;3;90
27;Bourgogne-Franche-Comté;25;2;03;018;Anteuil;638;23;661
27;Bourgogne-Franche-Comté;25;2;03;019;Appenans;379;11;390
27;Bourgogne-Franche-Comté;25;2;01;020;Arbouans;927;9;936
27;Bourgogne-Franche-Comté;25;1;17;021;Arc-et-Senans;1618;30;1648
27;Bourgogne-Franche-Comté;25;3;15;025;Arc-sous-Cicon;688;13;701
27;Bourgogne-Franche-Comté;25;3;11;026;Arc-sous-Montenot;204;5;209
27;Bourgogne-Franche-Comté;25;2;03;022;Arcey;1454;38;1492
27;Bourgogne-Franche-Comté;25;3;15;024;Arçon;871;29;900
27;Bourgogne-Franche-Comté;25;3;15;029;Aubonne;242;3;245
27;Bourgogne-Franche-Comté;25;1;05;030;Audeux;430;11;441
27;Bourgogne-Franche-Comté;25;2;01;031;Audincourt;13336;202;13538
27;Bourgogne-Franche-Comté;25;1;02;032;Autechaux;421;9;430
27;Bourgogne-Franche-Comté;25;2;12;033;Autechaux-Roide;511;10;521
27;Bourgogne-Franche-Comté;25;1;06;035;Les Auxons;2524;46;2570
27;Bourgogne-Franche-Comté;25;1;04;036;Avanne-Aveney;2244;31;2275
27;Bourgogne-Franche-Comté;25;1;02;038;Avilley;162;3;165
27;Bourgogne-Franche-Comté;25;3;18;039;Avoudrey;915;16;931
27;Bourgogne-Franche-Comté;25;2;01;040;Badevel;814;14;828
27;Bourgogne-Franche-Comté;25;3;11;041;Bannans;368;10;378
27;Bourgogne-Franche-Comté;25;3;14;042;Le Barboux;231;8;239
27;Bourgogne-Franche-Comté;25;2;13;043;Bart;1966;53;2019
27;Bourgogne-Franche-Comté;25;1;17;044;Bartherans;57;0;57
27;Bourgogne-Franche-Comté;25;1;02;045;Battenans-les-Mines;50;1;51
27;Bourgogne-Franche-Comté;25;2;18;046;Battenans-Varin;75;2;77
27;Bourgogne-Franche-Comté;25;1;02;047;Baume-les-Dames;4977;161;5138
27;Bourgogne-Franche-Comté;25;2;03;048;Bavans;3628;75;3703
27;Bourgogne-Franche-Comté;25;2;12;049;Belfays;135;5;140
27;Bourgogne-Franche-Comté;25;3;14;050;Le Bélieu;478;5;483
27;Bourgogne-Franche-Comté;25;2;18;051;Belleherbe;624;14;638
27;Bourgogne-Franche-Comté;25;3;18;052;Belmont;66;0;66
27;Bourgogne-Franche-Comté;25;2;03;053;Belvoir;100;6;106
27;Bourgogne-Franche-Comté;25;2;03;054;Berche;510;13;523
27;Bourgogne-Franche-Comté;25;1;17;055;Berthelange;340;8;348
27;Bourgogne-Franche-Comté;25;1;99;056;Besançon;116775;3257;120032
27;Bourgogne-Franche-Comté;25;2;10;057;Bethoncourt;5545;76;5621
27;Bourgogne-Franche-Comté;25;1;09;058;Beure;1335;11;1346
27;Bourgogne-Franche-Comté;25;2;03;059;Beutal;270;5;275
27;Bourgogne-Franche-Comté;25;3;15;060;Bians-les-Usiers;689;24;713
27;Bourgogne-Franche-Comté;25;2;12;061;Bief;113;1;114
27;Bourgogne-Franche-Comté;25;3;14;062;Le Bizot;305;11;316
27;Bourgogne-Franche-Comté;25;2;12;063;Blamont;1215;26;1241
27;Bourgogne-Franche-Comté;25;1;02;065;Blarians;56;4;60
27;Bourgogne-Franche-Comté;25;2;03;066;Blussangeaux;83;1;84
27;Bourgogne-Franche-Comté;25;2;03;067;Blussans;192;3;195
27;Bourgogne-Franche-Comté;25;1;15;070;Bolandoz;366;15;381
27;Bourgogne-Franche-Comté;25;2;12;071;Bondeval;478;11;489
27;Bourgogne-Franche-Comté;25;1;02;072;Bonnal;25;1;26
27;Bourgogne-Franche-Comté;25;1;02;073;Bonnay;834;6;840
27;Bourgogne-Franche-Comté;25;3;14;074;Bonnétage;948;21;969
27;Bourgogne-Franche-Comté;25;3;11;075;Bonnevaux;392;11;403
27;Bourgogne-Franche-Comté;25;3;14;077;La Bosse;73;0;73
27;Bourgogne-Franche-Comté;25;1;02;078;Bouclans ;1068;24;1092
27;Bourgogne-Franche-Comté;25;3;11;079;Boujailles;425;11;436
27;Bourgogne-Franche-Comté;25;2;19;082;Bourguignon;905;23;928
27;Bourgogne-Franche-Comté;25;2;03;083;Bournois;190;1;191
27;Bourgogne-Franche-Comté;25;1;09;084;Boussières;1145;16;1161
27;Bourgogne-Franche-Comté;25;3;11;085;Bouverans;371;7;378
27;Bourgogne-Franche-Comté;25;1;07;086;Braillans;209;2;211
27;Bourgogne-Franche-Comté;25;2;03;087;Branne;178;3;181
27;Bourgogne-Franche-Comté;25;1;02;088;Breconchaux;91;5;96
27;Bourgogne-Franche-Comté;25;3;18;089;Bremondans;90;2;92
27;Bourgogne-Franche-Comté;25;1;17;090;Brères;63;0;63
27;Bourgogne-Franche-Comté;25;2;12;091;Les Bréseux;471;8;479
27;Bourgogne-Franche-Comté;25;1;02;092;La Bretenière;71;2;73
27;Bourgogne-Franche-Comté;25;2;03;093;Bretigney;74;0;74
27;Bourgogne-Franche-Comté;25;1;02;094;Bretigney-Notre-Dame;113;0;113
27;Bourgogne-Franche-Comté;25;3;18;095;Bretonvillers;276;3;279
27;Bourgogne-Franche-Comté;25;3;11;096;Brey-et-Maison-du-Bois;123;2;125
27;Bourgogne-Franche-Comté;25;2;10;097;Brognard;479;12;491
27;Bourgogne-Franche-Comté;25;1;17;098;Buffard;179;4;183
27;Bourgogne-Franche-Comté;25;3;15;099;Bugny;217;6;223
27;Bourgogne-Franche-Comté;25;3;11;100;Bulle;439;7;446
27;Bourgogne-Franche-Comté;25;1;17;101;Burgille;568;12;580
27;Bourgogne-Franche-Comté;25;2;12;102;Burnevillers;46;2;48
27;Bourgogne-Franche-Comté;25;1;09;103;Busy;635;13;648
27;Bourgogne-Franche-Comté;25;1;17;104;By;84;1;85
27;Bourgogne-Franche-Comté;25;1;17;105;Byans-sur-Doubs;576;6;582
27;Bourgogne-Franche-Comté;25;1;15;106;Cademène;68;0;68
27;Bourgogne-Franche-Comté;25;1;02;107;Cendrey;190;0;190
27;Bourgogne-Franche-Comté;25;2;12;108;Cernay-l'Église;301;9;310
27;Bourgogne-Franche-Comté;25;1;17;109;Cessey;330;10;340
27;Bourgogne-Franche-Comté;25;3;16;110;Chaffois;1027;19;1046
27;Bourgogne-Franche-Comté;25;1;07;111;Chalèze;366;12;378
27;Bourgogne-Franche-Comté;25;1;07;112;Chalezeule;1302;26;1328
27;Bourgogne-Franche-Comté;25;3;18;113;Chamesey;140;3;143
27;Bourgogne-Franche-Comté;25;2;12;114;Chamesol;382;6;388
27;Bourgogne-Franche-Comté;25;1;05;115;Champagney;284;3;287
27;Bourgogne-Franche-Comté;25;1;02;116;Champlive;247;6;253
27;Bourgogne-Franche-Comté;25;1;07;117;Champoux;90;0;90
27;Bourgogne-Franche-Comté;25;1;05;119;Champvans-les-Moulins;333;10;343
27;Bourgogne-Franche-Comté;25;1;15;120;Chantrans;401;10;411
27;Bourgogne-Franche-Comté;25;3;11;122;Chapelle-d'Huin;523;7;530
27;Bourgogne-Franche-Comté;25;3;11;121;Chapelle-des-Bois;254;16;270
27;Bourgogne-Franche-Comté;25;2;12;124;Charmauvillers;259;7;266
27;Bourgogne-Franche-Comté;25;2;18;125;Charmoille;327;5;332
27;Bourgogne-Franche-Comté;25;1;17;126;Charnay;473;8;481
27;Bourgogne-Franche-Comté;25;2;12;127;Charquemont;2680;49;2729
27;Bourgogne-Franche-Comté;25;1;15;129;Chassagne-Saint-Denis;113;3;116
27;Bourgogne-Franche-Comté;25;1;15;130;Châteauvieux-les-Fossés;12;0;12
27;Bourgogne-Franche-Comté;25;3;11;131;Châtelblanc;115;5;120
27;Bourgogne-Franche-Comté;25;1;02;132;Châtillon-Guyotte;133;4;137
27;Bourgogne-Franche-Comté;25;1;06;133;Châtillon-le-Duc;2038;57;2095
27;Bourgogne-Franche-Comté;25;1;17;134;Châtillon-sur-Lison;8;0;8
27;Bourgogne-Franche-Comté;25;1;05;136;Chaucenne;507;13;520
27;Bourgogne-Franche-Comté;25;3;15;139;La Chaux;580;9;589
27;Bourgogne-Franche-Comté;25;3;18;141;Chaux-lès-Passavant;128;6;134
27;Bourgogne-Franche-Comté;25;3;11;142;Chaux-Neuve;324;3;327
27;Bourgogne-Franche-Comté;25;1;17;143;Chay;210;11;221
27;Bourgogne-Franche-Comté;25;2;03;145;Chazot;121;1;122
27;Bourgogne-Franche-Comté;25;1;04;147;Chemaudin et Vaux;1976;38;2014
27;Bourgogne-Franche-Comté;25;3;14;148;La Chenalotte;499;5;504
27;Bourgogne-Franche-Comté;25;1;17;149;Chenecey-Buillon;511;11;522
27;Bourgogne-Franche-Comté;25;3;18;151;Chevigney-lès-Vercel;129;5;134
27;Bourgogne-Franche-Comté;25;1;17;150;Chevigney-sur-l'Ognon;292;3;295
27;Bourgogne-Franche-Comté;25;1;08;152;La Chevillotte;154;0;154
27;Bourgogne-Franche-Comté;25;1;02;153;Chevroz;131;1;132
27;Bourgogne-Franche-Comté;25;1;17;154;Chouzelot;268;8;276
27;Bourgogne-Franche-Comté;25;1;15;155;Cléron;302;13;315
27;Bourgogne-Franche-Comté;25;3;16;157;La Cluse-et-Mijoux;1308;28;1336
27;Bourgogne-Franche-Comté;25;2;03;159;Colombier-Fontaine;1233;24;1257
27;Bourgogne-Franche-Comté;25;3;14;160;Les Combes;744;27;771
27;Bourgogne-Franche-Comté;25;3;18;161;Consolation-Maisonnettes;31;5;36
27;Bourgogne-Franche-Comté;25;1;02;163;Corcelle-Mieslot;105;1;106
27;Bourgogne-Franche-Comté;25;1;17;162;Corcelles-Ferrières;204;6;210
27;Bourgogne-Franche-Comté;25;1;17;164;Corcondray;142;2;144
27;Bourgogne-Franche-Comté;25;1;02;166;Côtebrune;83;6;89
27;Bourgogne-Franche-Comté;25;2;18;173;Cour-Saint-Maurice;154;1;155
27;Bourgogne-Franche-Comté;25;1;17;171;Courcelles;103;2;105
27;Bourgogne-Franche-Comté;25;2;13;170;Courcelles-lès-Montbéliard;1331;41;1372
27;Bourgogne-Franche-Comté;25;1;17;172;Courchapon;231;3;234
27;Bourgogne-Franche-Comté;25;2;12;174;Courtefontaine;245;3;248
27;Bourgogne-Franche-Comté;25;3;18;175;Courtetain-et-Salans;86;1;87
27;Bourgogne-Franche-Comté;25;3;11;176;Courvières;315;5;320
27;Bourgogne-Franche-Comté;25;2;03;177;Crosey-le-Grand;151;5;156
27;Bourgogne-Franche-Comté;25;2;03;178;Crosey-le-Petit;130;3;133
27;Bourgogne-Franche-Comté;25;3;11;179;Le Crouzet;60;1;61
27;Bourgogne-Franche-Comté;25;1;15;180;Crouzet-Migette;116;6;122
27;Bourgogne-Franche-Comté;25;1;02;181;Cubrial;141;6;147
27;Bourgogne-Franche-Comté;25;1;02;182;Cubry;90;0;90
27;Bourgogne-Franche-Comté;25;1;02;183;Cusance;71;2;73
27;Bourgogne-Franche-Comté;25;1;02;184;Cuse-et-Adrisans;285;12;297
27;Bourgogne-Franche-Comté;25;1;02;186;Cussey-sur-l'Ognon;1045;24;1069
27;Bourgogne-Franche-Comté;25;1;17;185;Cussey-sur-Lison;64;3;67
27;Bourgogne-Franche-Comté;25;2;19;187;Dambelin;501;6;507
27;Bourgogne-Franche-Comté;25;2;10;188;Dambenois;752;25;777
27;Bourgogne-Franche-Comté;25;1;02;189;Dammartin-les-Templiers;194;6;200
27;Bourgogne-Franche-Comté;25;2;01;190;Dampierre-les-Bois;1617;27;1644
27;Bourgogne-Franche-Comté;25;2;03;191;Dampierre-sur-le-Doubs;454;10;464
27;Bourgogne-Franche-Comté;25;2;12;192;Dampjoux;169;4;173
27;Bourgogne-Franche-Comté;25;2;12;193;Damprichard;1879;46;1925
27;Bourgogne-Franche-Comté;25;2;12;194;Dannemarie;113;0;113
27;Bourgogne-Franche-Comté;25;1;04;195;Dannemarie-sur-Crète;1497;291;1788
27;Bourgogne-Franche-Comté;25;2;01;196;Dasle;1405;26;1431
27;Bourgogne-Franche-Comté;25;1;08;197;Deluz;615;5;620
27;Bourgogne-Franche-Comté;25;2;03;198;Désandans;730;21;751
27;Bourgogne-Franche-Comté;25;1;15;199;Déservillers;344;12;356
27;Bourgogne-Franche-Comté;25;1;02;200;Devecey;1416;37;1453
27;Bourgogne-Franche-Comté;25;3;16;201;Dommartin;724;15;739
27;Bourgogne-Franche-Comté;25;3;11;202;Dompierre-les-Tilleuls;292;4;296
27;Bourgogne-Franche-Comté;25;3;18;203;Domprel;184;4;188
27;Bourgogne-Franche-Comté;25;3;16;204;Doubs;3126;92;3218
27;Bourgogne-Franche-Comté;25;2;03;207;Dung;625;17;642
27;Bourgogne-Franche-Comté;25;1;15;208;Durnes;176;4;180
27;Bourgogne-Franche-Comté;25;1;17;209;Échay;130;4;134
27;Bourgogne-Franche-Comté;25;2;03;210;Échenans;157;4;161
27;Bourgogne-Franche-Comté;25;1;15;211;Échevannes;88;1;89
27;Bourgogne-Franche-Comté;25;1;05;212;École-Valentin;2631;49;2680
27;Bourgogne-Franche-Comté;25;2;12;213;Les Écorces;727;22;749
27;Bourgogne-Franche-Comté;25;2;19;214;Écot;497;10;507
27;Bourgogne-Franche-Comté;25;1;02;215;L' Écouvotte;90;0;90
27;Bourgogne-Franche-Comté;25;2;12;216;Écurcey;265;10;275
27;Bourgogne-Franche-Comté;25;1;17;217;Émagny;596;10;606
27;Bourgogne-Franche-Comté;25;3;18;218;Épenouse;156;7;163
27;Bourgogne-Franche-Comté;25;3;18;219;Épenoy;632;14;646
27;Bourgogne-Franche-Comté;25;1;17;220;Épeugney;577;15;592
27;Bourgogne-Franche-Comté;25;1;02;221;Esnans;66;0;66
27;Bourgogne-Franche-Comté;25;3;18;222;Étalans;1573;36;1609
27;Bourgogne-Franche-Comté;25;1;15;223;Éternoz;333;8;341
27;Bourgogne-Franche-Comté;25;2;03;224;Étouvans;828;13;841
27;Bourgogne-Franche-Comté;25;1;17;225;Étrabonne;189;1;190
27;Bourgogne-Franche-Comté;25;2;03;226;Étrappe;216;4;220
27;Bourgogne-Franche-Comté;25;3;18;227;Étray;270;0;270
27;Bourgogne-Franche-Comté;25;2;10;228;Étupes;3726;64;3790
27;Bourgogne-Franche-Comté;25;3;15;229;Évillers;376;4;380
27;Bourgogne-Franche-Comté;25;2;10;230;Exincourt;3230;54;3284
27;Bourgogne-Franche-Comté;25;3;18;231;Eysson;117;2;119
27;Bourgogne-Franche-Comté;25;2;03;232;Faimbe;103;2;105
27;Bourgogne-Franche-Comté;25;3;18;233;Fallerans;287;8;295
27;Bourgogne-Franche-Comté;25;2;12;234;Ferrières-le-Lac;173;7;180
27;Bourgogne-Franche-Comté;25;1;17;235;Ferrières-les-Bois;320;3;323
27;Bourgogne-Franche-Comté;25;1;15;236;Fertans;272;3;275
27;Bourgogne-Franche-Comté;25;2;10;237;Fesches-le-Châtel;2180;33;2213
27;Bourgogne-Franche-Comté;25;2;12;238;Fessevillers;158;2;160
27;Bourgogne-Franche-Comté;25;2;19;239;Feule;177;1;178
27;Bourgogne-Franche-Comté;25;3;14;240;Les Fins;3171;149;3320
27;Bourgogne-Franche-Comté;25;1;15;241;Flagey;154;7;161
27;Bourgogne-Franche-Comté;25;1;02;242;Flagey-Rigney;116;0;116
27;Bourgogne-Franche-Comté;25;3;18;243;Flangebouche;783;19;802
27;Bourgogne-Franche-Comté;25;2;12;244;Fleurey;84;3;87
27;Bourgogne-Franche-Comté;25;1;08;245;Fontain;1276;22;1298
27;Bourgogne-Franche-Comté;25;2;03;246;Fontaine-lès-Clerval;289;10;299
27;Bourgogne-Franche-Comté;25;1;02;247;Fontenelle-Montby;89;3;92
27;Bourgogne-Franche-Comté;25;3;14;248;Les Fontenelles;571;112;683
27;Bourgogne-Franche-Comté;25;1;02;249;Fontenotte;61;2;63
27;Bourgogne-Franche-Comté;25;1;02;251;Fourbanne;173;8;181
27;Bourgogne-Franche-Comté;25;3;11;252;Fourcatier-et-Maison-Neuve;114;0;114
27;Bourgogne-Franche-Comté;25;1;17;253;Fourg;384;4;388
27;Bourgogne-Franche-Comté;25;3;11;254;Les Fourgs;1396;30;1426
27;Bourgogne-Franche-Comté;25;2;12;255;Fournet-Blancheroche;348;13;361
27;Bourgogne-Franche-Comté;25;3;18;288;Fournets-Luisans;713;19;732
27;Bourgogne-Franche-Comté;25;2;12;256;Frambouhans;911;14;925
27;Bourgogne-Franche-Comté;25;1;17;257;Franey;274;4;278
27;Bourgogne-Franche-Comté;25;1;04;258;Franois;2318;40;2358
27;Bourgogne-Franche-Comté;25;3;11;259;Frasne;1921;37;1958
27;Bourgogne-Franche-Comté;25;2;12;261;Froidevaux;77;1;78
27;Bourgogne-Franche-Comté;25;3;18;262;Fuans;475;24;499
27;Bourgogne-Franche-Comté;25;3;11;263;Gellin;246;2;248
27;Bourgogne-Franche-Comté;25;2;03;264;Gémonval;84;2;86
27;Bourgogne-Franche-Comté;25;1;02;265;Geneuille;1324;20;1344
27;Bourgogne-Franche-Comté;25;2;03;266;Geney;117;3;120
27;Bourgogne-Franche-Comté;25;1;08;267;Gennes;681;20;701
27;Bourgogne-Franche-Comté;25;3;18;268;Germéfontaine;116;2;118
27;Bourgogne-Franche-Comté;25;1;02;269;Germondans;61;1;62
27;Bourgogne-Franche-Comté;25;1;15;270;Gevresin;120;6;126
27;Bourgogne-Franche-Comté;25;3;15;271;Gilley;1680;37;1717
27;Bourgogne-Franche-Comté;25;1;02;273;Glamondans;212;4;216
27;Bourgogne-Franche-Comté;25;2;12;274;Glay;340;2;342
27;Bourgogne-Franche-Comté;25;2;12;275;Glère;213;5;218
27;Bourgogne-Franche-Comté;25;1;02;277;Gondenans-les-Moulins;73;0;73
27;Bourgogne-Franche-Comté;25;1;02;276;Gondenans-Montby;174;2;176
27;Bourgogne-Franche-Comté;25;1;02;278;Gonsans;562;13;575
27;Bourgogne-Franche-Comté;25;1;02;279;Gouhelans;118;1;119
27;Bourgogne-Franche-Comté;25;2;12;280;Goumois;159;4;163
27;Bourgogne-Franche-Comté;25;2;19;281;Goux-lès-Dambelin;282;0;282
27;Bourgogne-Franche-Comté;25;3;15;282;Goux-les-Usiers;745;13;758
27;Bourgogne-Franche-Comté;25;1;17;283;Goux-sous-Landet;65;1;66
27;Bourgogne-Franche-Comté;25;2;10;284;Grand-Charmont;5754;73;5827
27;Bourgogne-Franche-Comté;25;3;14;285;Grand'Combe-Châteleu;1487;26;1513
27;Bourgogne-Franche-Comté;25;3;14;286;Grand'Combe-des-Bois;129;5;134
27;Bourgogne-Franche-Comté;25;1;04;287;Grandfontaine;1709;40;1749
27;Bourgogne-Franche-Comté;25;3;18;289;Grandfontaine-sur-Creuse;72;3;75
27;Bourgogne-Franche-Comté;25;2;18;290;La Grange;95;3;98
27;Bourgogne-Franche-Comté;25;3;16;293;Granges-Narboz;1247;50;1297
27;Bourgogne-Franche-Comté;25;3;11;295;Les Grangettes;288;5;293
27;Bourgogne-Franche-Comté;25;3;14;296;Les Gras;783;28;811
27;Bourgogne-Franche-Comté;25;1;08;297;Le Gratteris;177;3;180
27;Bourgogne-Franche-Comté;25;1;02;298;Grosbois;240;8;248
27;Bourgogne-Franche-Comté;25;1;02;299;Guillon-les-Bains;110;1;111
27;Bourgogne-Franche-Comté;25;1;18;300;Guyans-Durnes;290;5;295
27;Bourgogne-Franche-Comté;25;3;18;301;Guyans-Vennes;843;25;868
27;Bourgogne-Franche-Comté;25;3;15;303;Hauterive-la-Fresse;227;6;233
27;Bourgogne-Franche-Comté;25;2;01;304;Hérimoncourt;3676;63;3739
27;Bourgogne-Franche-Comté;25;1;15;305;L' Hôpital-du-Grosbois;595;17;612
27;Bourgogne-Franche-Comté;25;2;03;306;L' Hôpital-Saint-Lieffroy;120;5;125
27;Bourgogne-Franche-Comté;25;3;11;307;Les Hôpitaux-Neufs;917;11;928
27;Bourgogne-Franche-Comté;25;3;11;308;Les Hôpitaux-Vieux;460;6;466
27;Bourgogne-Franche-Comté;25;3;16;309;Houtaud;1094;35;1129
27;Bourgogne-Franche-Comté;25;1;02;310;Huanne-Montmartin;93;1;94
27;Bourgogne-Franche-Comté;25;2;03;311;Hyémondans;205;4;209
27;Bourgogne-Franche-Comté;25;1;02;312;Hyèvre-Magny;69;1;70
27;Bourgogne-Franche-Comté;25;1;02;313;Hyèvre-Paroisse;194;3;197
27;Bourgogne-Franche-Comté;25;2;12;314;Indevillers;265;2;267
27;Bourgogne-Franche-Comté;25;2;03;315;L' Isle-sur-le-Doubs;2931;71;3002
27;Bourgogne-Franche-Comté;25;2;03;316;Issans;234;12;246
27;Bourgogne-Franche-Comté;25;1;17;317;Jallerange;262;5;267
27;Bourgogne-Franche-Comté;25;3;11;318;Jougne;1829;33;1862
27;Bourgogne-Franche-Comté;25;3;11;320;Labergement-Sainte-Marie;1220;34;1254
27;Bourgogne-Franche-Comté;25;2;03;322;Laire;403;10;413
27;Bourgogne-Franche-Comté;25;1;02;323;Laissey;442;6;448
27;Bourgogne-Franche-Comté;25;1;03;324;Lanans;164;8;172
27;Bourgogne-Franche-Comté;25;3;18;325;Landresse;232;8;240
27;Bourgogne-Franche-Comté;25;1;17;326;Lantenne-Vertière;533;13;546
27;Bourgogne-Franche-Comté;25;2;03;327;Lanthenans;69;0;69
27;Bourgogne-Franche-Comté;25;1;09;328;Larnod;773;11;784
27;Bourgogne-Franche-Comté;25;3;14;329;Laval-le-Prieuré;36;1;37
27;Bourgogne-Franche-Comté;25;1;17;330;Lavans-Quingey;183;3;186
27;Bourgogne-Franche-Comté;25;1;15;331;Lavans-Vuillafans;239;5;244
27;Bourgogne-Franche-Comté;25;1;17;332;Lavernay;578;11;589
27;Bourgogne-Franche-Comté;25;3;18;333;Laviron;338;15;353
27;Bourgogne-Franche-Comté;25;3;11;334;Levier;2202;244;2446
27;Bourgogne-Franche-Comté;25;2;12;335;Liebvillers;158;4;162
27;Bourgogne-Franche-Comté;25;1;17;336;Liesle;537;5;542
27;Bourgogne-Franche-Comté;25;1;15;338;Lizine;94;1;95
27;Bourgogne-Franche-Comté;25;1;15;339;Lods;221;2;223
27;Bourgogne-Franche-Comté;25;1;17;340;Lombard;188;4;192
27;Bourgogne-Franche-Comté;25;1;02;341;Lomont-sur-Crête;173;6;179
27;Bourgogne-Franche-Comté;25;3;18;342;Longechaux;79;3;82
27;Bourgogne-Franche-Comté;25;3;18;343;Longemaison;160;3;163
27;Bourgogne-Franche-Comté;25;3;18;344;Longevelle-lès-Russey;46;0;46
27;Bourgogne-Franche-Comté;25;2;03;345;Longevelle-sur-Doubs;675;14;689
27;Bourgogne-Franche-Comté;25;1;15;346;Longeville;176;3;179
27;Bourgogne-Franche-Comté;25;3;15;347;La Longeville ;806;20;826
27;Bourgogne-Franche-Comté;25;3;11;348;Longevilles-Mont-d'Or;597;15;612
27;Bourgogne-Franche-Comté;25;3;18;349;Loray;542;15;557
27;Bourgogne-Franche-Comté;25;2;03;350;Lougres;750;22;772
27;Bourgogne-Franche-Comté;25;3;14;351;Le Luhier;227;1;228
27;Bourgogne-Franche-Comté;25;1;02;354;Luxiol;162;0;162
27;Bourgogne-Franche-Comté;25;3;18;355;Magny-Châtelard;61;0;61
27;Bourgogne-Franche-Comté;25;2;12;356;Maîche;4276;107;4383
27;Bourgogne-Franche-Comté;25;3;15;357;Maisons-du-Bois-Lièvremont;825;8;833
27;Bourgogne-Franche-Comté;25;1;15;359;Malans;167;5;172
27;Bourgogne-Franche-Comté;25;1;15;360;Malbrans;168;4;172
27;Bourgogne-Franche-Comté;25;3;11;361;Malbuisson;849;25;874
27;Bourgogne-Franche-Comté;25;3;11;362;Malpas;282;12;294
27;Bourgogne-Franche-Comté;25;1;08;364;Mamirolle;1776;18;1794
27;Bourgogne-Franche-Comté;25;2;03;365;Mancenans;307;5;312
27;Bourgogne-Franche-Comté;25;2;12;366;Mancenans-Lizerne;193;6;199
27;Bourgogne-Franche-Comté;25;2;19;367;Mandeure;4807;150;4957
27;Bourgogne-Franche-Comté;25;1;07;368;Marchaux-Chaudefontaine ;1477;21;1498
27;Bourgogne-Franche-Comté;25;2;03;369;Marvelise;163;2;165
27;Bourgogne-Franche-Comté;25;2;19;370;Mathay;2149;37;2186
27;Bourgogne-Franche-Comté;25;1;05;371;Mazerolles-le-Salin;206;7;213
27;Bourgogne-Franche-Comté;25;2;03;372;Médière;280;12;292
27;Bourgogne-Franche-Comté;25;3;14;373;Le Mémont;46;2;48
27;Bourgogne-Franche-Comté;25;1;17;374;Mercey-le-Grand;547;16;563
27;Bourgogne-Franche-Comté;25;1;15;375;Mérey-sous-Montrond;436;10;446
27;Bourgogne-Franche-Comté;25;1;02;376;Mérey-Vieilley;150;5;155
27;Bourgogne-Franche-Comté;25;1;02;377;Mésandans;227;6;233
27;Bourgogne-Franche-Comté;25;2;12;378;Meslières;351;8;359
27;Bourgogne-Franche-Comté;25;1;17;379;Mesmay;71;4;75
27;Bourgogne-Franche-Comté;25;3;11;380;Métabief;1268;34;1302
27;Bourgogne-Franche-Comté;25;1;06;381;Miserey-Salines;2538;36;2574
27;Bourgogne-Franche-Comté;25;1;02;382;Moncey;594;6;600
27;Bourgogne-Franche-Comté;25;1;17;383;Moncley;278;6;284
27;Bourgogne-Franche-Comté;25;1;02;384;Mondon;96;1;97
27;Bourgogne-Franche-Comté;25;3;14;391;Mont-de-Laval;179;6;185
27;Bourgogne-Franche-Comté;25;2;12;392;Mont-de-Vougney;188;5;193
27;Bourgogne-Franche-Comté;25;1;02;385;Montagney-Servigney;130;3;133
27;Bourgogne-Franche-Comté;25;2;12;386;Montancy;133;3;136
27;Bourgogne-Franche-Comté;25;2;12;387;Montandon;395;9;404
27;Bourgogne-Franche-Comté;25;2;13;388;Montbéliard;25809;559;26368
27;Bourgogne-Franche-Comté;25;3;14;389;Montbéliardot;114;4;118
27;Bourgogne-Franche-Comté;25;3;15;390;Montbenoît;398;12;410
27;Bourgogne-Franche-Comté;25;2;12;393;Montécheroux;553;7;560
27;Bourgogne-Franche-Comté;25;2;03;394;Montenois;1490;43;1533
27;Bourgogne-Franche-Comté;25;1;08;395;Montfaucon;1574;49;1623
27;Bourgogne-Franche-Comté;25;1;09;397;Montferrand-le-Château;2171;42;2213
27;Bourgogne-Franche-Comté;25;3;15;398;Montflovin;110;4;114
27;Bourgogne-Franche-Comté;25;1;15;400;Montgesoye;471;9;480
27;Bourgogne-Franche-Comté;25;1;02;401;Montivernage;27;0;27
27;Bourgogne-Franche-Comté;25;2;12;402;Montjoie-le-Château;25;1;26
27;Bourgogne-Franche-Comté;25;3;14;403;Montlebon;2109;69;2178
27;Bourgogne-Franche-Comté;25;1;15;404;Montmahoux;92;2;94
27;Bourgogne-Franche-Comté;25;3;11;405;Montperreux;870;40;910
27;Bourgogne-Franche-Comté;25;1;17;406;Montrond-le-Château;563;14;577
27;Bourgogne-Franche-Comté;25;1;02;408;Montussaint;57;1;58
27;Bourgogne-Franche-Comté;25;1;08;410;Morre;1351;70;1421
27;Bourgogne-Franche-Comté;25;3;14;411;Morteau;6894;323;7217
27;Bourgogne-Franche-Comté;25;3;11;413;Mouthe;1072;36;1108
27;Bourgogne-Franche-Comté;25;1;17;414;Le Moutherot;125;2;127
27;Bourgogne-Franche-Comté;25;1;15;415;Mouthier-Haute-Pierre;337;5;342
27;Bourgogne-Franche-Comté;25;1;17;416;Myon;179;4;183
27;Bourgogne-Franche-Comté;25;1;02;417;Naisey-les-Granges;795;20;815
27;Bourgogne-Franche-Comté;25;1;08;418;Nancray;1258;28;1286
27;Bourgogne-Franche-Comté;25;1;02;419;Nans;97;4;101
27;Bourgogne-Franche-Comté;25;1;15;420;Nans-sous-Sainte-Anne;165;4;169
27;Bourgogne-Franche-Comté;25;3;14;421;Narbief;74;4;78
27;Bourgogne-Franche-Comté;25;2;19;422;Neuchâtel-Urtière;187;4;191
27;Bourgogne-Franche-Comté;25;3;14;425;Noël-Cerneux;443;16;459
27;Bourgogne-Franche-Comté;25;2;19;426;Noirefontaine;340;6;346
27;Bourgogne-Franche-Comté;25;1;05;427;Noironte;389;5;394
27;Bourgogne-Franche-Comté;25;2;10;428;Nommay;1630;38;1668
27;Bourgogne-Franche-Comté;25;1;08;429;Novillars;1497;41;1538
27;Bourgogne-Franche-Comté;25;1;02;430;Ollans;39;0;39
27;Bourgogne-Franche-Comté;25;2;03;431;Onans;344;13;357
27;Bourgogne-Franche-Comté;25;3;18;432;Orchamps-Vennes;2124;56;2180
27;Bourgogne-Franche-Comté;25;2;12;433;Orgeans-Blanchefontaine;42;1;43
27;Bourgogne-Franche-Comté;25;1;15;434;Ornans;4426;104;4530
27;Bourgogne-Franche-Comté;25;3;18;435;Orsans;162;4;166
27;Bourgogne-Franche-Comté;25;2;03;436;Orve;58;2;60
27;Bourgogne-Franche-Comté;25;1;02;437;Osse;320;3;323
27;Bourgogne-Franche-Comté;25;1;09;438;Osselle-Routelle;952;15;967
27;Bourgogne-Franche-Comté;25;1;02;439;Ougney-Douvot;255;2;257
27;Bourgogne-Franche-Comté;25;3;15;440;Ouhans;376;8;384
27;Bourgogne-Franche-Comté;25;3;18;441;Ouvans;63;1;64
27;Bourgogne-Franche-Comté;25;3;11;442;Oye-et-Pallet;735;12;747
27;Bourgogne-Franche-Comté;25;1;17;443;Palantine;75;1;76
27;Bourgogne-Franche-Comté;25;1;02;444;Palise;141;4;145
27;Bourgogne-Franche-Comté;25;1;17;445;Paroy;125;2;127
27;Bourgogne-Franche-Comté;25;1;02;446;Passavant;204;11;215
27;Bourgogne-Franche-Comté;25;3;18;447;Passonfontaine;328;5;333
27;Bourgogne-Franche-Comté;25;2;03;156;Pays-de-Clerval;1199;22;1221
27;Bourgogne-Franche-Comté;25;1;05;448;Pelousey;1524;28;1552
27;Bourgogne-Franche-Comté;25;2;18;449;Péseux;132;1;133
27;Bourgogne-Franche-Comté;25;1;17;450;Pessans;86;3;89
27;Bourgogne-Franche-Comté;25;3;11;451;Petite-Chaux;142;3;145
27;Bourgogne-Franche-Comté;25;2;12;452;Pierrefontaine-lès-Blamont;469;12;481
27;Bourgogne-Franche-Comté;25;3;18;453;Pierrefontaine-les-Varans;1408;40;1448
27;Bourgogne-Franche-Comté;25;1;05;454;Pirey;2093;41;2134
27;Bourgogne-Franche-Comté;25;1;17;455;Placey;198;4;202
27;Bourgogne-Franche-Comté;25;3;14;456;Plaimbois-du-Miroir;257;9;266
27;Bourgogne-Franche-Comté;25;3;18;457;Plaimbois-Vennes;102;0;102
27;Bourgogne-Franche-Comté;25;2;12;458;Les Plains-et-Grands-Essarts;217;5;222
27;Bourgogne-Franche-Comté;25;3;11;459;La Planée;314;10;324
27;Bourgogne-Franche-Comté;25;2;03;461;Pompierre-sur-Doubs;304;2;306
27;Bourgogne-Franche-Comté;25;2;19;463;Pont-de-Roide-Vermondans;4156;74;4230
27;Bourgogne-Franche-Comté;25;1;02;465;Pont-les-Moulins;201;2;203
27;Bourgogne-Franche-Comté;25;3;16;462;Pontarlier;17393;895;18288
27;Bourgogne-Franche-Comté;25;3;11;464;Les Pontets;132;4;136
27;Bourgogne-Franche-Comté;25;1;17;466;Pouilley-Français;831;18;849
27;Bourgogne-Franche-Comté;25;1;05;467;Pouilley-les-Vignes;1982;42;2024
27;Bourgogne-Franche-Comté;25;1;02;468;Pouligney-Lusans;848;19;867
27;Bourgogne-Franche-Comté;25;3;18;424;Les Premiers Sapins;1550;32;1582
27;Bourgogne-Franche-Comté;25;2;03;469;Présentevillers;456;12;468
27;Bourgogne-Franche-Comté;25;2;03;470;La Prétière;157;5;162
27;Bourgogne-Franche-Comté;25;2;18;471;Provenchère;137;3;140
27;Bourgogne-Franche-Comté;25;1;02;472;Puessans;31;3;34
27;Bourgogne-Franche-Comté;25;1;09;473;Pugey;739;21;760
27;Bourgogne-Franche-Comté;25;1;02;474;Le Puy;113;3;116
27;Bourgogne-Franche-Comté;25;1;17;475;Quingey;1434;14;1448
27;Bourgogne-Franche-Comté;25;2;03;476;Rahon;124;0;124
27;Bourgogne-Franche-Comté;25;1;04;477;Rancenay;382;6;388
27;Bourgogne-Franche-Comté;25;2;03;478;Randevillers;121;2;123
27;Bourgogne-Franche-Comté;25;2;03;479;Rang;409;4;413
27;Bourgogne-Franche-Comté;25;2;03;481;Raynans;336;5;341
27;Bourgogne-Franche-Comté;25;1;17;482;Recologne;667;3;670
27;Bourgogne-Franche-Comté;25;3;11;483;Reculfoz;41;3;44
27;Bourgogne-Franche-Comté;25;2;19;485;Rémondans-Vaivre;234;4;238
27;Bourgogne-Franche-Comté;25;3;11;486;Remoray-Boujeons;428;11;439
27;Bourgogne-Franche-Comté;25;3;15;487;Renédale;45;3;48
27;Bourgogne-Franche-Comté;25;1;17;488;Rennes-sur-Loue;107;5;112
27;Bourgogne-Franche-Comté;25;1;15;489;Reugney;295;28;323
27;Bourgogne-Franche-Comté;25;1;02;490;Rigney;383;20;403
27;Bourgogne-Franche-Comté;25;1;02;491;Rignosot;116;3;119
27;Bourgogne-Franche-Comté;25;1;02;492;Rillans;93;3;96
27;Bourgogne-Franche-Comté;25;3;11;493;La Rivière-Drugeon;911;26;937
27;Bourgogne-Franche-Comté;25;2;03;496;Roche-lès-Clerval;101;0;101
27;Bourgogne-Franche-Comté;25;1;08;495;Roche-lez-Beaupré;2140;26;2166
27;Bourgogne-Franche-Comté;25;3;11;494;Rochejean;692;24;716
27;Bourgogne-Franche-Comté;25;2;12;497;Roches-lès-Blamont;625;14;639
27;Bourgogne-Franche-Comté;25;1;02;498;Rognon;47;0;47
27;Bourgogne-Franche-Comté;25;1;02;499;Romain;126;2;128
27;Bourgogne-Franche-Comté;25;1;17;500;Ronchaux;87;1;88
27;Bourgogne-Franche-Comté;25;3;11;501;Rondefontaine;35;1;36
27;Bourgogne-Franche-Comté;25;1;17;502;Roset-Fluans;527;4;531
27;Bourgogne-Franche-Comté;25;2;18;503;Rosières-sur-Barbèche;119;4;123
27;Bourgogne-Franche-Comté;25;3;18;504;Rosureux;79;2;81
27;Bourgogne-Franche-Comté;25;1;02;505;Rougemont;1079;28;1107
27;Bourgogne-Franche-Comté;25;1;02;506;Rougemontot;94;0;94
27;Bourgogne-Franche-Comté;25;1;17;507;Rouhe;77;2;79
27;Bourgogne-Franche-Comté;25;1;02;508;Roulans;1130;24;1154
27;Bourgogne-Franche-Comté;25;1;17;510;Ruffey-le-Château;363;9;372
27;Bourgogne-Franche-Comté;25;1;17;511;Rurey;344;6;350
27;Bourgogne-Franche-Comté;25;3;14;512;Le Russey;2375;67;2442
27;Bourgogne-Franche-Comté;25;3;11;514;Saint-Antoine;339;17;356
27;Bourgogne-Franche-Comté;25;2;03;516;Saint-Georges-Armont;122;6;128
27;Bourgogne-Franche-Comté;25;3;15;517;Saint-Gorgon-Main;282;4;286
27;Bourgogne-Franche-Comté;25;1;02;518;Saint-Hilaire;159;9;168
27;Bourgogne-Franche-Comté;25;2;12;519;Saint-Hippolyte;894;13;907
27;Bourgogne-Franche-Comté;25;1;02;520;Saint-Juan;173;3;176
27;Bourgogne-Franche-Comté;25;2;03;521;Saint-Julien-lès-Montbéliard;165;5;170
27;Bourgogne-Franche-Comté;25;3;14;522;Saint-Julien-lès-Russey;181;3;184
27;Bourgogne-Franche-Comté;25;2;03;524;Saint-Maurice-Colombier;907;26;933
27;Bourgogne-Franche-Comté;25;3;11;525;Saint-Point-Lac;287;12;299
27;Bourgogne-Franche-Comté;25;1;17;527;Saint-Vit;4874;72;4946
27;Bourgogne-Franche-Comté;25;1;15;513;Sainte-Anne;44;0;44
27;Bourgogne-Franche-Comté;25;3;16;515;Sainte-Colombe;417;7;424
27;Bourgogne-Franche-Comté;25;2;03;523;Sainte-Marie;677;15;692
27;Bourgogne-Franche-Comté;25;2;13;526;Sainte-Suzanne;1486;42;1528
27;Bourgogne-Franche-Comté;25;1;17;528;Samson;80;0;80
27;Bourgogne-Franche-Comté;25;2;03;529;Sancey ;1343;27;1370
27;Bourgogne-Franche-Comté;25;1;08;532;Saône;3297;71;3368
27;Bourgogne-Franche-Comté;25;1;15;533;Saraz;13;0;13
27;Bourgogne-Franche-Comté;25;3;11;534;Sarrageois;196;4;200
27;Bourgogne-Franche-Comté;25;1;15;535;Saules;228;6;234
27;Bourgogne-Franche-Comté;25;1;17;536;Sauvagney;186;2;188
27;Bourgogne-Franche-Comté;25;1;15;537;Scey-Maisières;288;9;297
27;Bourgogne-Franche-Comté;25;1;02;538;Séchin;114;4;118
27;Bourgogne-Franche-Comté;25;2;01;539;Seloncourt;5742;143;5885
27;Bourgogne-Franche-Comté;25;2;03;540;Semondans;304;6;310
27;Bourgogne-Franche-Comté;25;3;15;541;Septfontaines;370;8;378
27;Bourgogne-Franche-Comté;25;1;05;542;Serre-les-Sapins;1702;29;1731
27;Bourgogne-Franche-Comté;25;1;03;544;Servin;201;9;210
27;Bourgogne-Franche-Comté;25;1;15;545;Silley-Amancey;141;2;143
27;Bourgogne-Franche-Comté;25;1;02;546;Silley-Bléfond;60;1;61
27;Bourgogne-Franche-Comté;25;2;10;547;Sochaux;3889;41;3930
27;Bourgogne-Franche-Comté;25;2;19;548;Solemont;142;7;149
27;Bourgogne-Franche-Comté;25;3;15;549;Sombacour;631;7;638
27;Bourgogne-Franche-Comté;25;3;18;550;La Sommette;239;7;246
27;Bourgogne-Franche-Comté;25;2;12;551;Soulce-Cernay;131;1;132
27;Bourgogne-Franche-Comté;25;2;03;552;Sourans;118;2;120
27;Bourgogne-Franche-Comté;25;2;03;553;Soye;396;9;405
27;Bourgogne-Franche-Comté;25;2;03;554;Surmont;118;3;121
27;Bourgogne-Franche-Comté;25;2;01;555;Taillecourt;1101;25;1126
27;Bourgogne-Franche-Comté;25;1;02;556;Tallans;47;3;50
27;Bourgogne-Franche-Comté;25;1;06;557;Tallenay;420;8;428
27;Bourgogne-Franche-Comté;25;1;15;558;Tarcenay-Foucherans ;1499;23;1522
27;Bourgogne-Franche-Comté;25;2;12;138;Les Terres-de-Chaux;127;5;132
27;Bourgogne-Franche-Comté;25;2;12;559;Thiébouhans;257;6;263
27;Bourgogne-Franche-Comté;25;1;07;560;Thise;3028;42;3070
27;Bourgogne-Franche-Comté;25;1;09;561;Thoraise;355;9;364
27;Bourgogne-Franche-Comté;25;2;12;562;Thulay;214;5;219
27;Bourgogne-Franche-Comté;25;1;02;563;Thurey-le-Mont;126;2;128
27;Bourgogne-Franche-Comté;25;1;09;564;Torpes;1022;15;1037
27;Bourgogne-Franche-Comté;25;3;11;565;Touillon-et-Loutelet;270;13;283
27;Bourgogne-Franche-Comté;25;1;02;566;La Tour-de-Sçay;299;4;303
27;Bourgogne-Franche-Comté;25;1;02;567;Tournans;122;3;125
27;Bourgogne-Franche-Comté;25;1;15;569;Trépot;537;11;548
27;Bourgogne-Franche-Comté;25;1;02;570;Tressandans;25;1;26
27;Bourgogne-Franche-Comté;25;2;12;571;Trévillers;489;11;500
27;Bourgogne-Franche-Comté;25;1;02;572;Trouvans;105;5;110
27;Bourgogne-Franche-Comté;25;2;12;573;Urtière;13;0;13
27;Bourgogne-Franche-Comté;25;1;02;574;Uzelle;172;1;173
27;Bourgogne-Franche-Comté;25;1;08;575;Vaire;813;10;823
27;Bourgogne-Franche-Comté;25;1;17;460;Le Val;241;29;270
27;Bourgogne-Franche-Comté;25;1;02;579;Val-de-Roulans;200;3;203
27;Bourgogne-Franche-Comté;25;3;18;578;Valdahon;5687;100;5787
27;Bourgogne-Franche-Comté;25;2;19;580;Valentigney;10912;162;11074
27;Bourgogne-Franche-Comté;25;1;02;582;Valleroy;149;2;151
27;Bourgogne-Franche-Comté;25;2;03;583;Valonne;247;5;252
27;Bourgogne-Franche-Comté;25;2;12;584;Valoreille;124;4;128
27;Bourgogne-Franche-Comté;25;2;01;586;Vandoncourt;822;31;853
27;Bourgogne-Franche-Comté;25;2;18;588;Vaucluse;120;30;150
27;Bourgogne-Franche-Comté;25;2;18;589;Vauclusotte;85;1;86
27;Bourgogne-Franche-Comté;25;1;03;590;Vaudrivillers;87;2;89
27;Bourgogne-Franche-Comté;25;2;12;591;Vaufrey;158;0;158
27;Bourgogne-Franche-Comté;25;3;11;592;Vaux-et-Chantegrue;606;14;620
27;Bourgogne-Franche-Comté;25;1;17;594;Velesmes-Essarts;353;4;357
27;Bourgogne-Franche-Comté;25;2;03;595;Vellerot-lès-Belvoir;95;0;95
27;Bourgogne-Franche-Comté;25;3;18;596;Vellerot-lès-Vercel;69;1;70
27;Bourgogne-Franche-Comté;25;2;03;597;Vellevans;235;3;238
27;Bourgogne-Franche-Comté;25;1;02;598;Venise;518;7;525
27;Bourgogne-Franche-Comté;25;1;02;599;Vennans;258;8;266
27;Bourgogne-Franche-Comté;25;3;18;600;Vennes;196;4;200
27;Bourgogne-Franche-Comté;25;3;18;601;Vercel-Villedieu-le-Camp;1616;82;1698
27;Bourgogne-Franche-Comté;25;1;02;602;Vergranne;111;5;116
27;Bourgogne-Franche-Comté;25;1;02;604;Verne;126;4;130
27;Bourgogne-Franche-Comté;25;3;18;605;Vernierfontaine;460;11;471
27;Bourgogne-Franche-Comté;25;2;03;607;Vernois-lès-Belvoir;60;1;61
27;Bourgogne-Franche-Comté;25;2;03;608;Le Vernoy;172;2;174
27;Bourgogne-Franche-Comté;25;3;16;609;Verrières-de-Joux;465;11;476
27;Bourgogne-Franche-Comté;25;1;08;611;La Vèze;466;7;473
27;Bourgogne-Franche-Comté;25;1;02;612;Vieilley;699;20;719
27;Bourgogne-Franche-Comté;25;1;02;613;Viéthorey;94;2;96
27;Bourgogne-Franche-Comté;25;2;10;614;Vieux-Charmont;2763;53;2816
27;Bourgogne-Franche-Comté;25;2;12;615;Villars-lès-Blamont;443;6;449
27;Bourgogne-Franche-Comté;25;1;17;616;Villars-Saint-Georges;277;3;280
27;Bourgogne-Franche-Comté;25;2;19;617;Villars-sous-Dampjoux;354;6;360
27;Bourgogne-Franche-Comté;25;2;03;618;Villars-sous-Écot;350;8;358
27;Bourgogne-Franche-Comté;25;3;15;620;Ville-du-Pont;325;7;332
27;Bourgogne-Franche-Comté;25;3;11;619;Les Villedieu;204;3;207
27;Bourgogne-Franche-Comté;25;3;11;621;Villeneuve-d'Amont;230;36;266
27;Bourgogne-Franche-Comté;25;1;17;622;Villers-Buzon;258;1;259
27;Bourgogne-Franche-Comté;25;3;18;623;Villers-Chief;126;1;127
27;Bourgogne-Franche-Comté;25;1;02;624;Villers-Grélot;150;3;153
27;Bourgogne-Franche-Comté;25;3;18;625;Villers-la-Combe;53;1;54
27;Bourgogne-Franche-Comté;25;3;14;321;Villers-le-Lac;5090;114;5204
27;Bourgogne-Franche-Comté;25;1;02;626;Villers-Saint-Martin;217;8;225
27;Bourgogne-Franche-Comté;25;3;11;627;Villers-sous-Chalamont;300;5;305
27;Bourgogne-Franche-Comté;25;1;15;628;Villers-sous-Montrond;210;3;213
27;Bourgogne-Franche-Comté;25;1;02;629;Voillans;208;6;214
27;Bourgogne-Franche-Comté;25;1;18;630;Voires;86;0;86
27;Bourgogne-Franche-Comté;25;1;09;631;Vorges-les-Pins;606;11;617
27;Bourgogne-Franche-Comté;25;2;19;632;Voujeaucourt;3186;86;3272
27;Bourgogne-Franche-Comté;25;1;15;633;Vuillafans;730;13;743
27;Bourgogne-Franche-Comté;25;3;16;634;Vuillecin;648;24;672
27;Bourgogne-Franche-Comté;25;2;03;635;Vyt-lès-Belvoir;187;3;190
84;Auvergne-Rhône-Alpes;26;3;12;002;Albon;1965;36;2001
84;Auvergne-Rhône-Alpes;26;2;03;003;Aleyrac;49;0;49
84;Auvergne-Rhône-Alpes;26;3;01;004;Alixan;2503;75;2578
84;Auvergne-Rhône-Alpes;26;2;09;005;Allan;1737;48;1785
84;Auvergne-Rhône-Alpes;26;1;07;006;Allex;2508;77;2585
84;Auvergne-Rhône-Alpes;26;1;07;007;Ambonil;106;7;113
84;Auvergne-Rhône-Alpes;26;2;08;008;Ancône;1356;28;1384
84;Auvergne-Rhône-Alpes;26;3;12;009;Andancette;1346;36;1382
84;Auvergne-Rhône-Alpes;26;3;12;010;Anneyron;4047;98;4145
84;Auvergne-Rhône-Alpes;26;1;02;011;Aouste-sur-Sye;2537;41;2578
84;Auvergne-Rhône-Alpes;26;1;04;012;Arnayon;23;3;26
84;Auvergne-Rhône-Alpes;26;2;10;013;Arpavon;78;3;81
84;Auvergne-Rhône-Alpes;26;3;05;014;Arthémonay;588;8;596
84;Auvergne-Rhône-Alpes;26;1;04;015;Aubenasson;77;4;81
84;Auvergne-Rhône-Alpes;26;2;10;016;Aubres;419;16;435
84;Auvergne-Rhône-Alpes;26;1;04;017;Aucelon;16;0;16
84;Auvergne-Rhône-Alpes;26;2;10;018;Aulan;11;1;12
84;Auvergne-Rhône-Alpes;26;1;04;019;Aurel;246;3;249
84;Auvergne-Rhône-Alpes;26;1;02;021;Autichamp;119;4;123
84;Auvergne-Rhône-Alpes;26;2;10;022;Ballons;86;3;89
84;Auvergne-Rhône-Alpes;26;3;19;023;Barbières;1090;18;1108
84;Auvergne-Rhône-Alpes;26;3;02;024;Barcelonne;356;10;366
84;Auvergne-Rhône-Alpes;26;1;04;025;Barnave;199;10;209
84;Auvergne-Rhône-Alpes;26;2;10;026;Barret-de-Lioure;68;0;68
84;Auvergne-Rhône-Alpes;26;1;04;027;Barsac;139;2;141
84;Auvergne-Rhône-Alpes;26;3;05;028;Bathernay;244;14;258
84;Auvergne-Rhône-Alpes;26;1;04;030;La Bâtie-des-Fonds;3;0;3
84;Auvergne-Rhône-Alpes;26;2;03;031;La Bâtie-Rolland;1026;27;1053
84;Auvergne-Rhône-Alpes;26;3;02;032;La Baume-Cornillane;447;9;456
84;Auvergne-Rhône-Alpes;26;3;19;034;La Baume-d'Hostun;576;9;585
84;Auvergne-Rhône-Alpes;26;2;06;033;La Baume-de-Transit;904;17;921
84;Auvergne-Rhône-Alpes;26;1;02;035;Beaufort-sur-Gervanne;473;8;481
84;Auvergne-Rhône-Alpes;26;1;04;036;Beaumont-en-Diois;106;4;110
84;Auvergne-Rhône-Alpes;26;3;17;037;Beaumont-lès-Valence;3815;81;3896
84;Auvergne-Rhône-Alpes;26;3;13;038;Beaumont-Monteux;1321;33;1354
84;Auvergne-Rhône-Alpes;26;3;19;039;Beauregard-Baret;863;13;876
84;Auvergne-Rhône-Alpes;26;1;04;040;Beaurières;68;2;70
84;Auvergne-Rhône-Alpes;26;3;12;041;Beausemblant;1429;26;1455
84;Auvergne-Rhône-Alpes;26;3;17;042;Beauvallon;1595;26;1621
84;Auvergne-Rhône-Alpes;26;2;10;043;Beauvoisin;148;5;153
84;Auvergne-Rhône-Alpes;26;2;03;045;La Bégude-de-Mazenc;1661;46;1707
84;Auvergne-Rhône-Alpes;26;2;10;046;Bellecombe-Tarendol;71;3;74
84;Auvergne-Rhône-Alpes;26;1;04;047;Bellegarde-en-Diois;87;0;87
84;Auvergne-Rhône-Alpes;26;2;10;048;Bénivay-Ollon;70;1;71
84;Auvergne-Rhône-Alpes;26;3;19;049;Bésayes;1238;36;1274
84;Auvergne-Rhône-Alpes;26;2;10;050;Bésignan;83;2;85
84;Auvergne-Rhône-Alpes;26;2;03;051;Bézaudun-sur-Bîne;68;2;70
84;Auvergne-Rhône-Alpes;26;2;03;052;Bonlieu-sur-Roubion;472;12;484
84;Auvergne-Rhône-Alpes;26;2;06;054;Bouchet;1530;22;1552
84;Auvergne-Rhône-Alpes;26;1;04;055;Boulc;144;2;146
84;Auvergne-Rhône-Alpes;26;2;03;056;Bourdeaux;666;15;681
84;Auvergne-Rhône-Alpes;26;3;01;057;Bourg-de-Péage;10007;154;10161
84;Auvergne-Rhône-Alpes;26;3;15;058;Bourg-lès-Valence;19889;570;20459
84;Auvergne-Rhône-Alpes;26;1;19;059;Bouvante;214;3;217
84;Auvergne-Rhône-Alpes;26;2;03;060;Bouvières;145;6;151
84;Auvergne-Rhône-Alpes;26;3;05;061;Bren;566;9;575
84;Auvergne-Rhône-Alpes;26;1;04;062;Brette;38;3;41
84;Auvergne-Rhône-Alpes;26;2;10;063;Buis-les-Baronnies;2305;95;2400
84;Auvergne-Rhône-Alpes;26;3;16;064;Chabeuil;6869;180;7049
84;Auvergne-Rhône-Alpes;26;1;02;065;Chabrillan;736;8;744
84;Auvergne-Rhône-Alpes;26;1;19;066;Le Chaffal;40;0;40
84;Auvergne-Rhône-Alpes;26;1;04;067;Chalancon;58;1;59
84;Auvergne-Rhône-Alpes;26;3;05;068;Le Chalon;211;6;217
84;Auvergne-Rhône-Alpes;26;1;04;069;Chamaloc;130;3;133
84;Auvergne-Rhône-Alpes;26;2;06;070;Chamaret;531;11;542
84;Auvergne-Rhône-Alpes;26;3;13;071;Chanos-Curson;1082;33;1115
84;Auvergne-Rhône-Alpes;26;3;13;072;Chantemerle-les-Blés;1287;22;1309
84;Auvergne-Rhône-Alpes;26;2;06;073;Chantemerle-lès-Grignan;242;3;245
84;Auvergne-Rhône-Alpes;26;1;19;074;La Chapelle-en-Vercors;713;132;845
84;Auvergne-Rhône-Alpes;26;2;10;075;La Charce;31;1;32
84;Auvergne-Rhône-Alpes;26;1;04;076;Charens;28;0;28
84;Auvergne-Rhône-Alpes;26;3;05;077;Charmes-sur-l'Herbasse;907;23;930
84;Auvergne-Rhône-Alpes;26;2;03;078;Charols;934;14;948
84;Auvergne-Rhône-Alpes;26;3;19;079;Charpey;1468;37;1505
84;Auvergne-Rhône-Alpes;26;1;04;080;Chastel-Arnaud;41;0;41
84;Auvergne-Rhône-Alpes;26;3;02;081;Châteaudouble;577;24;601
84;Auvergne-Rhône-Alpes;26;2;10;082;Châteauneuf-de-Bordette;100;1;101
84;Auvergne-Rhône-Alpes;26;3;05;083;Châteauneuf-de-Galaure;1820;580;2400
84;Auvergne-Rhône-Alpes;26;2;09;085;Châteauneuf-du-Rhône;2724;52;2776
84;Auvergne-Rhône-Alpes;26;3;13;084;Châteauneuf-sur-Isère;3909;147;4056
84;Auvergne-Rhône-Alpes;26;1;04;086;Châtillon-en-Diois ;666;12;678
84;Auvergne-Rhône-Alpes;26;3;11;087;Châtillon-Saint-Jean;1337;45;1382
84;Auvergne-Rhône-Alpes;26;3;19;088;Chatuzange-le-Goubet;5618;129;5747
84;Auvergne-Rhône-Alpes;26;2;10;089;Chaudebonne;58;1;59
84;Auvergne-Rhône-Alpes;26;1;04;090;La Chaudière;31;0;31
84;Auvergne-Rhône-Alpes;26;2;10;091;Chauvac-Laux-Montaux;41;0;41
84;Auvergne-Rhône-Alpes;26;3;05;092;Chavannes;722;11;733
84;Auvergne-Rhône-Alpes;26;2;14;093;Clansayes;536;13;549
84;Auvergne-Rhône-Alpes;26;3;12;094;Claveyson;868;23;891
84;Auvergne-Rhône-Alpes;26;2;03;095;Cléon-d'Andran;879;31;910
84;Auvergne-Rhône-Alpes;26;3;11;096;Clérieux;2047;37;2084
84;Auvergne-Rhône-Alpes;26;1;07;097;Cliousclat;627;16;643
84;Auvergne-Rhône-Alpes;26;1;02;098;Cobonne;164;5;169
84;Auvergne-Rhône-Alpes;26;2;06;099;Colonzelle;549;12;561
84;Auvergne-Rhône-Alpes;26;3;02;100;Combovin;435;15;450
84;Auvergne-Rhône-Alpes;26;2;03;101;Comps;149;10;159
84;Auvergne-Rhône-Alpes;26;2;03;102;Condillac;140;7;147
84;Auvergne-Rhône-Alpes;26;2;10;103;Condorcet;493;4;497
84;Auvergne-Rhône-Alpes;26;2;10;104;Cornillac;88;0;88
84;Auvergne-Rhône-Alpes;26;2;10;105;Cornillon-sur-l'Oule;71;1;72
84;Auvergne-Rhône-Alpes;26;2;08;106;La Coucourde;1144;21;1165
84;Auvergne-Rhône-Alpes;26;3;05;107;Crépol;553;16;569
84;Auvergne-Rhône-Alpes;26;1;02;108;Crest;8629;272;8901
84;Auvergne-Rhône-Alpes;26;3;13;110;Crozes-Hermitage;668;10;678
84;Auvergne-Rhône-Alpes;26;2;03;111;Crupies;100;1;101
84;Auvergne-Rhône-Alpes;26;2;10;112;Curnier;189;8;197
84;Auvergne-Rhône-Alpes;26;1;04;113;Die;4665;233;4898
84;Auvergne-Rhône-Alpes;26;2;03;114;Dieulefit;3199;137;3336
84;Auvergne-Rhône-Alpes;26;1;02;115;Divajeu;660;70;730
84;Auvergne-Rhône-Alpes;26;2;06;116;Donzère;5877;102;5979
84;Auvergne-Rhône-Alpes;26;1;19;117;Échevis;53;4;57
84;Auvergne-Rhône-Alpes;26;3;05;118;Épinouze;1525;22;1547
84;Auvergne-Rhône-Alpes;26;3;13;119;Érôme;813;7;820
84;Auvergne-Rhône-Alpes;26;2;09;121;Espeluche;1101;40;1141
84;Auvergne-Rhône-Alpes;26;1;04;122;Espenel;176;2;178
84;Auvergne-Rhône-Alpes;26;1;04;123;Establet;26;0;26
84;Auvergne-Rhône-Alpes;26;3;07;124;Étoile-sur-Rhône;5505;126;5631
84;Auvergne-Rhône-Alpes;26;1;02;125;Eurre;1360;32;1392
84;Auvergne-Rhône-Alpes;26;2;10;126;Eygalayes;88;0;88
84;Auvergne-Rhône-Alpes;26;2;10;127;Eygaliers;109;2;111
84;Auvergne-Rhône-Alpes;26;1;04;128;Eygluy-Escoulin;72;0;72
84;Auvergne-Rhône-Alpes;26;3;19;129;Eymeux;1034;22;1056
84;Auvergne-Rhône-Alpes;26;2;10;130;Eyroles;25;0;25
84;Auvergne-Rhône-Alpes;26;2;03;131;Eyzahut;148;1;149
84;Auvergne-Rhône-Alpes;26;3;12;133;Fay-le-Clos;160;4;164
84;Auvergne-Rhône-Alpes;26;1;03;134;Félines-sur-Rimandoule;82;1;83
84;Auvergne-Rhône-Alpes;26;2;10;135;Ferrassières;126;2;128
84;Auvergne-Rhône-Alpes;26;1;03;137;Francillon-sur-Roubion;191;2;193
84;Auvergne-Rhône-Alpes;26;2;14;138;La Garde-Adhémar;1112;34;1146
84;Auvergne-Rhône-Alpes;26;3;11;139;Génissieux;2393;57;2450
84;Auvergne-Rhône-Alpes;26;3;13;380;Gervans;552;10;562
84;Auvergne-Rhône-Alpes;26;3;05;140;Geyssans;715;28;743
84;Auvergne-Rhône-Alpes;26;1;02;141;Gigors-et-Lozeron;208;5;213
84;Auvergne-Rhône-Alpes;26;1;04;142;Glandage;118;0;118
84;Auvergne-Rhône-Alpes;26;3;05;143;Le Grand-Serre;914;51;965
84;Auvergne-Rhône-Alpes;26;1;02;144;Grane;1943;50;1993
84;Auvergne-Rhône-Alpes;26;2;06;145;Les Granges-Gontardes;653;20;673
84;Auvergne-Rhône-Alpes;26;3;13;379;Granges-les-Beaumont;918;10;928
84;Auvergne-Rhône-Alpes;26;2;06;146;Grignan;1564;43;1607
84;Auvergne-Rhône-Alpes;26;1;04;147;Gumiane;20;1;21
84;Auvergne-Rhône-Alpes;26;3;05;148;Hauterives;1891;57;1948
84;Auvergne-Rhône-Alpes;26;3;19;149;Hostun;992;8;1000
84;Auvergne-Rhône-Alpes;26;2;10;150;Izon-la-Bruisse;11;0;11
84;Auvergne-Rhône-Alpes;26;3;19;381;Jaillans;896;12;908
84;Auvergne-Rhône-Alpes;26;1;04;152;Jonchères;28;0;28
84;Auvergne-Rhône-Alpes;26;2;10;153;Laborel;100;1;101
84;Auvergne-Rhône-Alpes;26;2;10;154;Lachau;236;4;240
84;Auvergne-Rhône-Alpes;26;3;05;155;Lapeyrouse-Mornay;1219;18;1237
84;Auvergne-Rhône-Alpes;26;3;13;156;Larnage;1067;44;1111
84;Auvergne-Rhône-Alpes;26;2;03;157;La Laupie;754;17;771
84;Auvergne-Rhône-Alpes;26;1;04;159;Laval-d'Aix;117;2;119
84;Auvergne-Rhône-Alpes;26;3;12;160;Laveyron;1216;17;1233
84;Auvergne-Rhône-Alpes;26;2;10;161;Lemps;50;0;50
84;Auvergne-Rhône-Alpes;26;3;05;162;Lens-Lestang;888;29;917
84;Auvergne-Rhône-Alpes;26;1;19;163;Léoncel;51;0;51
84;Auvergne-Rhône-Alpes;26;1;04;164;Lesches-en-Diois;56;1;57
84;Auvergne-Rhône-Alpes;26;1;07;165;Livron-sur-Drôme;9149;152;9301
84;Auvergne-Rhône-Alpes;26;1;07;166;Loriol-sur-Drôme;6605;94;6699
84;Auvergne-Rhône-Alpes;26;1;04;167;Luc-en-Diois;534;1;535
84;Auvergne-Rhône-Alpes;26;1;04;168;Lus-la-Croix-Haute;542;14;556
84;Auvergne-Rhône-Alpes;26;2;06;169;Malataverne;2066;40;2106
84;Auvergne-Rhône-Alpes;26;3;16;170;Malissard;3217;97;3314
84;Auvergne-Rhône-Alpes;26;2;03;171;Manas;192;9;201
84;Auvergne-Rhône-Alpes;26;3;05;172;Manthes;664;10;674
84;Auvergne-Rhône-Alpes;26;3;19;173;Marches;859;20;879
84;Auvergne-Rhône-Alpes;26;3;05;174;Margès;1137;32;1169
84;Auvergne-Rhône-Alpes;26;1;04;175;Marignac-en-Diois;217;9;226
84;Auvergne-Rhône-Alpes;26;2;03;176;Marsanne;1322;42;1364
84;Auvergne-Rhône-Alpes;26;3;05;177;Marsaz;731;23;754
84;Auvergne-Rhône-Alpes;26;1;04;178;Menglon;533;7;540
84;Auvergne-Rhône-Alpes;26;3;13;179;Mercurol-Veaunes;2706;56;2762
84;Auvergne-Rhône-Alpes;26;2;10;180;Mérindol-les-Oliviers;226;6;232
84;Auvergne-Rhône-Alpes;26;2;10;181;Mévouillon;235;7;242
84;Auvergne-Rhône-Alpes;26;2;10;182;Mirabel-aux-Baronnies;1585;35;1620
84;Auvergne-Rhône-Alpes;26;1;02;183;Mirabel-et-Blacons;1133;29;1162
84;Auvergne-Rhône-Alpes;26;1;07;185;Mirmande;584;14;598
84;Auvergne-Rhône-Alpes;26;1;04;186;Miscon;54;1;55
84;Auvergne-Rhône-Alpes;26;2;10;188;Mollans-sur-Ouvèze;1063;24;1087
84;Auvergne-Rhône-Alpes;26;2;10;189;Montauban-sur-l'Ouvèze;119;2;121
84;Auvergne-Rhône-Alpes;26;2;10;190;Montaulieu;84;2;86
84;Auvergne-Rhône-Alpes;26;2;09;191;Montboucher-sur-Jabron;2385;60;2445
84;Auvergne-Rhône-Alpes;26;2;06;192;Montbrison-sur-Lez;277;11;288
84;Auvergne-Rhône-Alpes;26;2;10;193;Montbrun-les-Bains;439;9;448
84;Auvergne-Rhône-Alpes;26;3;05;194;Montchenu;582;16;598
84;Auvergne-Rhône-Alpes;26;1;02;195;Montclar-sur-Gervanne;189;3;192
84;Auvergne-Rhône-Alpes;26;3;17;196;Montéléger;1806;140;1946
84;Auvergne-Rhône-Alpes;26;3;16;197;Montélier;4206;116;4322
84;Auvergne-Rhône-Alpes;26;2;97;198;Montélimar;39415;1224;40639
84;Auvergne-Rhône-Alpes;26;2;10;199;Montferrand-la-Fare;29;0;29
84;Auvergne-Rhône-Alpes;26;2;10;200;Montfroc;76;1;77
84;Auvergne-Rhône-Alpes;26;2;10;201;Montguers;47;6;53
84;Auvergne-Rhône-Alpes;26;2;03;202;Montjoux;330;11;341
84;Auvergne-Rhône-Alpes;26;2;06;203;Montjoyer;283;6;289
84;Auvergne-Rhône-Alpes;26;1;04;204;Montlaur-en-Diois;144;5;149
84;Auvergne-Rhône-Alpes;26;1;04;205;Montmaur-en-Diois;85;0;85
84;Auvergne-Rhône-Alpes;26;3;02;206;Montmeyran;2929;100;3029
84;Auvergne-Rhône-Alpes;26;3;05;207;Montmiral;689;17;706
84;Auvergne-Rhône-Alpes;26;1;07;208;Montoison;1933;36;1969
84;Auvergne-Rhône-Alpes;26;2;10;209;Montréal-les-Sources;22;0;22
84;Auvergne-Rhône-Alpes;26;2;06;211;Montségur-sur-Lauzon;1330;27;1357
84;Auvergne-Rhône-Alpes;26;3;02;212;Montvendre;1195;29;1224
84;Auvergne-Rhône-Alpes;26;3;05;213;Moras-en-Valloire;678;15;693
84;Auvergne-Rhône-Alpes;26;1;03;214;Mornans;73;0;73
84;Auvergne-Rhône-Alpes;26;1;04;215;La Motte-Chalancon;421;22;443
84;Auvergne-Rhône-Alpes;26;3;12;216;La Motte-de-Galaure;794;15;809
84;Auvergne-Rhône-Alpes;26;1;19;217;La Motte-Fanjas;193;3;196
84;Auvergne-Rhône-Alpes;26;3;11;218;Mours-Saint-Eusèbe;3210;55;3265
84;Auvergne-Rhône-Alpes;26;3;12;219;Mureils;469;8;477
84;Auvergne-Rhône-Alpes;26;2;10;220;Nyons;6782;186;6968
84;Auvergne-Rhône-Alpes;26;1;02;221;Omblèze;72;2;74
84;Auvergne-Rhône-Alpes;26;2;03;222;Orcinas;40;0;40
84;Auvergne-Rhône-Alpes;26;1;19;223;Oriol-en-Royans;527;6;533
84;Auvergne-Rhône-Alpes;26;3;02;224;Ourches;260;8;268
84;Auvergne-Rhône-Alpes;26;3;05;225;Parnans;694;21;715
84;Auvergne-Rhône-Alpes;26;2;06;226;Le Pègue;366;6;372
84;Auvergne-Rhône-Alpes;26;2;10;227;Pelonne;26;0;26
84;Auvergne-Rhône-Alpes;26;2;10;229;La Penne-sur-l'Ouvèze;93;1;94
84;Auvergne-Rhône-Alpes;26;1;04;228;Pennes-le-Sec;38;0;38
84;Auvergne-Rhône-Alpes;26;3;11;231;Peyrins;2690;70;2760
84;Auvergne-Rhône-Alpes;26;3;02;232;Peyrus;606;8;614
84;Auvergne-Rhône-Alpes;26;2;10;233;Piégon;251;9;260
84;Auvergne-Rhône-Alpes;26;1;02;234;Piégros-la-Clastre;859;16;875
84;Auvergne-Rhône-Alpes;26;2;14;235;Pierrelatte;13452;261;13713
84;Auvergne-Rhône-Alpes;26;2;10;236;Pierrelongue;213;4;217
84;Auvergne-Rhône-Alpes;26;2;10;238;Les Pilles;242;2;244
84;Auvergne-Rhône-Alpes;26;2;10;239;Plaisians;203;4;207
84;Auvergne-Rhône-Alpes;26;1;02;240;Plan-de-Baix;148;3;151
84;Auvergne-Rhône-Alpes;26;1;03;241;Le Poët-Célard;128;2;130
84;Auvergne-Rhône-Alpes;26;2;10;242;Le Poët-en-Percip;16;0;16
84;Auvergne-Rhône-Alpes;26;2;03;243;Le Poët-Laval;942;38;980
84;Auvergne-Rhône-Alpes;26;2;10;244;Le Poët-Sigillat;127;1;128
84;Auvergne-Rhône-Alpes;26;2;10;245;Pommerol;6;0;6
84;Auvergne-Rhône-Alpes;26;1;04;246;Ponet-et-Saint-Auban;126;4;130
84;Auvergne-Rhône-Alpes;26;3;12;247;Ponsas;531;8;539
84;Auvergne-Rhône-Alpes;26;2;03;249;Pont-de-Barret;670;17;687
84;Auvergne-Rhône-Alpes;26;3;13;250;Pont-de-l'Isère;3538;48;3586
84;Auvergne-Rhône-Alpes;26;1;04;248;Pontaix;173;5;178
84;Auvergne-Rhône-Alpes;26;2;03;251;Portes-en-Valdaine;409;12;421
84;Auvergne-Rhône-Alpes;26;3;17;252;Portes-lès-Valence;10666;151;10817
84;Auvergne-Rhône-Alpes;26;1;04;253;Poyols;71;1;72
84;Auvergne-Rhône-Alpes;26;1;04;254;Pradelle;18;0;18
84;Auvergne-Rhône-Alpes;26;1;04;255;Les Prés;23;0;23
84;Auvergne-Rhône-Alpes;26;2;10;256;Propiac;133;2;135
84;Auvergne-Rhône-Alpes;26;1;03;258;Puy-Saint-Martin;886;29;915
84;Auvergne-Rhône-Alpes;26;2;03;257;Puygiron;446;21;467
84;Auvergne-Rhône-Alpes;26;3;05;259;Ratières;268;12;280
84;Auvergne-Rhône-Alpes;26;2;06;261;Réauville;393;11;404
84;Auvergne-Rhône-Alpes;26;1;04;262;Recoubeau-Jansac;265;7;272
84;Auvergne-Rhône-Alpes;26;2;10;263;Reilhanette;145;2;147
84;Auvergne-Rhône-Alpes;26;2;10;264;Rémuzat;334;7;341
84;Auvergne-Rhône-Alpes;26;1;02;020;La Répara-Auriples;239;6;245
84;Auvergne-Rhône-Alpes;26;1;04;266;Rimon-et-Savel;26;0;26
84;Auvergne-Rhône-Alpes;26;2;10;267;Rioms;25;1;26
84;Auvergne-Rhône-Alpes;26;3;13;271;La Roche-de-Glun;3333;63;3396
84;Auvergne-Rhône-Alpes;26;2;03;276;Roche-Saint-Secret-Béconne;458;14;472
84;Auvergne-Rhône-Alpes;26;1;02;277;La Roche-sur-Grane;168;4;172
84;Auvergne-Rhône-Alpes;26;2;10;278;La Roche-sur-le-Buis;285;10;295
84;Auvergne-Rhône-Alpes;26;2;03;268;Rochebaudin;121;0;121
84;Auvergne-Rhône-Alpes;26;2;10;269;Rochebrune;58;0;58
84;Auvergne-Rhône-Alpes;26;1;19;270;Rochechinard;125;2;127
84;Auvergne-Rhône-Alpes;26;2;03;272;Rochefort-en-Valdaine;359;9;368
84;Auvergne-Rhône-Alpes;26;3;19;273;Rochefort-Samson;1012;20;1032
84;Auvergne-Rhône-Alpes;26;1;04;274;Rochefourchat;1;0;1
84;Auvergne-Rhône-Alpes;26;2;14;275;Rochegude;1610;45;1655
84;Auvergne-Rhône-Alpes;26;2;10;279;La Rochette-du-Buis;66;2;68
84;Auvergne-Rhône-Alpes;26;3;98;281;Romans-sur-Isère;33160;679;33839
84;Auvergne-Rhône-Alpes;26;1;04;282;Romeyer;191;8;199
84;Auvergne-Rhône-Alpes;26;1;04;283;Rottier;22;0;22
84;Auvergne-Rhône-Alpes;26;2;06;284;Roussas;366;8;374
84;Auvergne-Rhône-Alpes;26;2;06;285;Rousset-les-Vignes;284;9;293
84;Auvergne-Rhône-Alpes;26;2;10;286;Roussieux;24;1;25
84;Auvergne-Rhône-Alpes;26;2;03;287;Roynac;486;15;501
84;Auvergne-Rhône-Alpes;26;2;10;288;Sahune;310;6;316
84;Auvergne-Rhône-Alpes;26;1;04;289;Saillans;1321;20;1341
84;Auvergne-Rhône-Alpes;26;1;19;290;Saint-Agnan-en-Vercors;366;10;376
84;Auvergne-Rhône-Alpes;26;1;04;291;Saint-Andéol;83;2;85
84;Auvergne-Rhône-Alpes;26;2;10;292;Saint-Auban-sur-l'Ouvèze;212;4;216
84;Auvergne-Rhône-Alpes;26;3;05;293;Saint-Avit;308;8;316
84;Auvergne-Rhône-Alpes;26;3;11;294;Saint-Bardoux;613;19;632
84;Auvergne-Rhône-Alpes;26;3;12;295;Saint-Barthélemy-de-Vals;1863;30;1893
84;Auvergne-Rhône-Alpes;26;1;04;296;Saint-Benoit-en-Diois;29;1;30
84;Auvergne-Rhône-Alpes;26;3;05;298;Saint-Christophe-et-le-Laris;418;5;423
84;Auvergne-Rhône-Alpes;26;1;04;300;Saint-Dizier-en-Diois;48;1;49
84;Auvergne-Rhône-Alpes;26;3;05;301;Saint-Donat-sur-l'Herbasse;4212;90;4302
84;Auvergne-Rhône-Alpes;26;2;10;304;Saint-Ferréol-Trente-Pas;266;3;269
84;Auvergne-Rhône-Alpes;26;2;03;305;Saint-Gervais-sur-Roubion;1059;21;1080
84;Auvergne-Rhône-Alpes;26;1;19;307;Saint-Jean-en-Royans;2819;66;2885
84;Auvergne-Rhône-Alpes;26;1;04;308;Saint-Julien-en-Quint;152;0;152
84;Auvergne-Rhône-Alpes;26;1;19;309;Saint-Julien-en-Vercors;233;5;238
84;Auvergne-Rhône-Alpes;26;3;05;310;Saint-Laurent-d'Onay;155;4;159
84;Auvergne-Rhône-Alpes;26;1;19;311;Saint-Laurent-en-Royans;1432;50;1482
84;Auvergne-Rhône-Alpes;26;2;03;312;Saint-Marcel-lès-Sauzet;1290;46;1336
84;Auvergne-Rhône-Alpes;26;3;15;313;Saint-Marcel-lès-Valence;6302;129;6431
84;Auvergne-Rhône-Alpes;26;3;05;314;Saint-Martin-d'Août;383;16;399
84;Auvergne-Rhône-Alpes;26;1;19;315;Saint-Martin-en-Vercors;362;14;376
84;Auvergne-Rhône-Alpes;26;1;19;316;Saint-Martin-le-Colonel;198;7;205
84;Auvergne-Rhône-Alpes;26;2;10;317;Saint-Maurice-sur-Eygues;792;13;805
84;Auvergne-Rhône-Alpes;26;2;10;318;Saint-May;37;1;38
84;Auvergne-Rhône-Alpes;26;3;05;319;Saint-Michel-sur-Savasse;575;11;586
84;Auvergne-Rhône-Alpes;26;1;19;320;Saint-Nazaire-en-Royans;808;10;818
84;Auvergne-Rhône-Alpes;26;1;04;321;Saint-Nazaire-le-Désert;199;8;207
84;Auvergne-Rhône-Alpes;26;2;06;322;Saint-Pantaléon-les-Vignes;431;22;453
84;Auvergne-Rhône-Alpes;26;3;11;323;Saint-Paul-lès-Romans;1827;48;1875
84;Auvergne-Rhône-Alpes;26;2;14;324;Saint-Paul-Trois-Châteaux;8836;447;9283
84;Auvergne-Rhône-Alpes;26;3;12;325;Saint-Rambert-d'Albon;6641;65;6706
84;Auvergne-Rhône-Alpes;26;2;14;326;Saint-Restitut;1401;46;1447
84;Auvergne-Rhône-Alpes;26;1;04;327;Saint-Roman;211;3;214
84;Auvergne-Rhône-Alpes;26;1;04;328;Saint-Sauveur-en-Diois;55;1;56
84;Auvergne-Rhône-Alpes;26;2;10;329;Saint-Sauveur-Gouvernet;182;6;188
84;Auvergne-Rhône-Alpes;26;3;05;330;Saint-Sorlin-en-Valloire;2261;44;2305
84;Auvergne-Rhône-Alpes;26;1;19;331;Saint-Thomas-en-Royans;600;14;614
84;Auvergne-Rhône-Alpes;26;3;12;332;Saint-Uze;2064;20;2084
84;Auvergne-Rhône-Alpes;26;3;12;333;Saint-Vallier;3937;152;4089
84;Auvergne-Rhône-Alpes;26;3;19;382;Saint-Vincent-la-Commanderie;556;7;563
84;Auvergne-Rhône-Alpes;26;1;04;299;Sainte-Croix;106;3;109
84;Auvergne-Rhône-Alpes;26;1;19;302;Sainte-Eulalie-en-Royans;546;11;557
84;Auvergne-Rhône-Alpes;26;2;10;303;Sainte-Euphémie-sur-Ouvèze;72;4;76
84;Auvergne-Rhône-Alpes;26;2;10;306;Sainte-Jalle;312;5;317
84;Auvergne-Rhône-Alpes;26;2;03;334;Salettes;141;2;143
84;Auvergne-Rhône-Alpes;26;2;06;335;Salles-sous-Bois;192;3;195
84;Auvergne-Rhône-Alpes;26;1;03;336;Saou;568;23;591
84;Auvergne-Rhône-Alpes;26;2;08;337;Saulce-sur-Rhône;1849;30;1879
84;Auvergne-Rhône-Alpes;26;2;03;338;Sauzet;1831;58;1889
84;Auvergne-Rhône-Alpes;26;2;08;339;Savasse;1462;41;1503
84;Auvergne-Rhône-Alpes;26;2;10;340;Séderon;261;4;265
84;Auvergne-Rhône-Alpes;26;3;13;341;Serves-sur-Rhône;727;12;739
84;Auvergne-Rhône-Alpes;26;1;04;001;Solaure en Diois;431;8;439
84;Auvergne-Rhône-Alpes;26;2;14;342;Solérieux;327;7;334
84;Auvergne-Rhône-Alpes;26;2;03;343;Souspierre;99;2;101
84;Auvergne-Rhône-Alpes;26;1;03;344;Soyans;390;7;397
84;Auvergne-Rhône-Alpes;26;1;02;346;Suze;234;5;239
84;Auvergne-Rhône-Alpes;26;2;14;345;Suze-la-Rousse;2135;54;2189
84;Auvergne-Rhône-Alpes;26;3;13;347;Tain-l'Hermitage;6131;206;6337
84;Auvergne-Rhône-Alpes;26;2;06;348;Taulignan;1656;28;1684
84;Auvergne-Rhône-Alpes;26;3;05;349;Tersanne;365;5;370
84;Auvergne-Rhône-Alpes;26;2;03;350;Teyssières;81;1;82
84;Auvergne-Rhône-Alpes;26;2;03;351;Les Tonils;27;0;27
84;Auvergne-Rhône-Alpes;26;2;03;352;La Touche;255;7;262
84;Auvergne-Rhône-Alpes;26;2;08;353;Les Tourrettes;1031;18;1049
84;Auvergne-Rhône-Alpes;26;3;11;355;Triors;585;8;593
84;Auvergne-Rhône-Alpes;26;2;03;356;Truinas;118;4;122
84;Auvergne-Rhône-Alpes;26;2;06;357;Tulette;2003;40;2043
84;Auvergne-Rhône-Alpes;26;3;02;358;Upie;1520;43;1563
84;Auvergne-Rhône-Alpes;26;1;04;359;Vachères-en-Quint;34;0;34
84;Auvergne-Rhône-Alpes;26;1;04;136;Val-Maravel;53;0;53
84;Auvergne-Rhône-Alpes;26;2;06;360;Valaurie;627;25;652
84;Auvergne-Rhône-Alpes;26;1;04;361;Valdrôme;145;3;148
84;Auvergne-Rhône-Alpes;26;3;99;362;Valence;64726;1395;66121
84;Auvergne-Rhône-Alpes;26;3;05;210;Valherbasse ;1017;23;1040
84;Auvergne-Rhône-Alpes;26;2;10;363;Valouse;37;0;37
84;Auvergne-Rhône-Alpes;26;1;19;364;Vassieux-en-Vercors;320;8;328
84;Auvergne-Rhône-Alpes;26;1;02;365;Vaunaveys-la-Rochette;584;11;595
84;Auvergne-Rhône-Alpes;26;2;10;367;Venterol;696;20;716
84;Auvergne-Rhône-Alpes;26;1;04;368;Vercheny;466;6;472
84;Auvergne-Rhône-Alpes;26;2;10;369;Verclause;60;1;61
84;Auvergne-Rhône-Alpes;26;2;10;370;Vercoiran;139;5;144
84;Auvergne-Rhône-Alpes;26;1;04;371;Véronne;47;2;49
84;Auvergne-Rhône-Alpes;26;2;10;372;Vers-sur-Méouge;40;1;41
84;Auvergne-Rhône-Alpes;26;2;03;373;Vesc;249;8;257
84;Auvergne-Rhône-Alpes;26;2;10;374;Villebois-les-Pins;15;0;15
84;Auvergne-Rhône-Alpes;26;2;10;375;Villefranche-le-Château;18;1;19
84;Auvergne-Rhône-Alpes;26;2;10;376;Villeperdrix;112;1;113
84;Auvergne-Rhône-Alpes;26;2;10;377;Vinsobres;1073;25;1098
84;Auvergne-Rhône-Alpes;26;1;04;378;Volvent;33;0;33
28;Normandie;27;2;07;001;Aclou;325;9;334
28;Normandie;27;3;22;002;Acon;466;8;474
28;Normandie;27;1;18;003;Acquigny;1598;33;1631
28;Normandie;27;1;16;004;Aigleville;423;8;431
28;Normandie;27;1;12;005;Ailly;1164;17;1181
28;Normandie;27;2;04;006;Aizier;143;3;146
28;Normandie;27;1;18;008;Alizay;1573;16;1589
28;Normandie;27;2;06;009;Ambenay;565;11;576
28;Normandie;27;1;13;010;Amécourt;166;7;173
28;Normandie;27;1;19;012;Amfreville-les-Champs;450;16;466
28;Normandie;27;2;05;011;Amfreville-Saint-Amand;1199;14;1213
28;Normandie;27;1;21;013;Amfreville-sous-les-Monts;489;11;500
28;Normandie;27;1;18;014;Amfreville-sur-Iton;848;23;871
28;Normandie;27;1;14;015;Andé;1302;31;1333
28;Normandie;27;1;01;016;Les Andelys;8092;141;8233
28;Normandie;27;3;11;017;Angerville-la-Campagne;1378;37;1415
28;Normandie;27;2;17;018;Appeville-Annebault;1003;11;1014
28;Normandie;27;2;22;019;Armentières-sur-Avre;166;7;173
28;Normandie;27;3;09;020;Arnières-sur-Iton;1677;43;1720
28;Normandie;27;2;03;021;Asnières;330;9;339
28;Normandie;27;3;08;023;Aulnay-sur-Iton;709;20;729
28;Normandie;27;1;12;025;Autheuil-Authouillet;958;19;977
28;Normandie;27;1;13;026;Authevernes;416;9;425
28;Normandie;27;3;20;027;Les Authieux;290;7;297
28;Normandie;27;2;17;028;Authou;335;4;339
28;Normandie;27;3;10;031;Aviron;1101;39;1140
28;Normandie;27;2;15;033;Bacquepuis;308;7;315
28;Normandie;27;1;19;034;Bacqueville;630;9;639
28;Normandie;27;2;03;035;Bailleul-la-Vallée;108;1;109
28;Normandie;27;2;22;036;Bâlines;558;22;580
28;Normandie;27;2;07;037;Barc;1202;23;1225
28;Normandie;27;2;22;038;Les Barils;272;6;278
28;Normandie;27;2;04;039;Barneville-sur-Seine;516;36;552
28;Normandie;27;3;20;277;La Baronnie;732;15;747
28;Normandie;27;2;07;040;Barquet;449;5;454
28;Normandie;27;2;03;042;Barville;77;0;77
28;Normandie;27;2;06;043;Les Baux-de-Breteuil;670;20;690
28;Normandie;27;3;11;044;Les Baux-Sainte-Croix;829;38;867
28;Normandie;27;1;13;045;Bazincourt-sur-Epte;768;12;780
28;Normandie;27;2;03;046;Bazoques;155;1;156
28;Normandie;27;3;08;047;Beaubray;324;8;332
28;Normandie;27;1;19;048;Beauficel-en-Lyons;188;3;191
28;Normandie;27;2;07;051;Beaumont-le-Roger;2813;38;2851
28;Normandie;27;2;07;050;Beaumontel;647;15;662
28;Normandie;27;2;07;052;Le Bec-Hellouin;397;3;400
28;Normandie;27;2;05;053;Le Bec-Thomas;218;5;223
28;Normandie;27;2;06;054;Bémécourt;580;8;588
28;Normandie;27;2;15;055;Bérengeville-la-Campagne;331;6;337
28;Normandie;27;2;02;056;Bernay;9951;339;10290
28;Normandie;27;2;15;057;Bernienville;286;6;292
28;Normandie;27;1;13;059;Bernouville;307;3;310
28;Normandie;27;2;07;061;Berthouville;319;5;324
28;Normandie;27;2;07;063;Berville-la-Campagne;248;1;249
28;Normandie;27;2;03;064;Berville-sur-Mer;693;9;702
28;Normandie;27;2;03;065;Beuzeville;4619;57;4676
28;Normandie;27;1;19;066;Bézu-la-Forêt;325;6;331
28;Normandie;27;1;13;067;Bézu-Saint-Éloi;1527;27;1554
28;Normandie;27;2;06;068;Bois-Anzeray;175;2;177
28;Normandie;27;2;06;069;Bois-Arnault;696;16;712
28;Normandie;27;2;03;071;Le Bois-Hellain;220;2;222
28;Normandie;27;1;01;072;Bois-Jérôme-Saint-Ouen;744;22;766
28;Normandie;27;3;20;073;Bois-le-Roi;1198;18;1216
28;Normandie;27;2;06;075;Bois-Normand-près-Lyre;342;4;346
28;Normandie;27;2;07;074;Boisney;280;8;288
28;Normandie;27;1;16;076;Boisset-les-Prévanches;476;9;485
28;Normandie;27;2;05;077;Boissey-le-Châtel;862;10;872
28;Normandie;27;1;16;078;La Boissière;270;11;281
28;Normandie;27;2;03;079;Boissy-Lamberville;357;5;362
28;Normandie;27;3;11;081;Boncourt;185;7;192
28;Normandie;27;2;17;083;Bonneville-Aptot;260;4;264
28;Normandie;27;3;08;082;La Bonneville-sur-Iton;2102;49;2151
28;Normandie;27;2;15;302;Le Bosc du Theil;1324;13;1337
28;Normandie;27;2;04;091;Bosgouet;729;5;734
28;Normandie;27;1;19;094;Bosquentin;122;1;123
28;Normandie;27;2;07;095;Bosrobert;662;11;673
28;Normandie;27;2;05;090;Bosroumois ;3613;64;3677
28;Normandie;27;2;06;096;Les Bottereaux;345;11;356
28;Normandie;27;1;01;097;Bouafles;658;12;670
28;Normandie;27;1;19;098;Bouchevilliers;81;3;84
28;Normandie;27;3;10;099;Le Boulay-Morin;784;10;794
28;Normandie;27;2;03;100;Boulleville;1167;23;1190
28;Normandie;27;2;04;101;Bouquelon;517;9;526
28;Normandie;27;2;04;102;Bouquetot;1041;22;1063
28;Normandie;27;2;04;103;Bourg-Achard;3945;72;4017
28;Normandie;27;1;19;104;Bourg-Beaudouin;701;10;711
28;Normandie;27;2;03;106;Bournainville-Faverolles;480;5;485
28;Normandie;27;2;04;107;Bourneville-Sainte-Croix;1313;25;1338
28;Normandie;27;2;22;108;Bourth;1230;34;1264
28;Normandie;27;2;07;109;Bray;398;7;405
28;Normandie;27;2;17;110;Brestot;609;9;618
28;Normandie;27;3;20;111;Bretagnolles;203;5;208
28;Normandie;27;2;06;112;Breteuil;4353;125;4478
28;Normandie;27;2;07;113;Brétigny;136;2;138
28;Normandie;27;1;16;114;Breuilpont;1222;23;1245
28;Normandie;27;2;22;115;Breux-sur-Avre;342;7;349
28;Normandie;27;2;07;116;Brionne;4238;148;4386
28;Normandie;27;2;06;117;Broglie;1038;20;1058
28;Normandie;27;2;15;118;Brosville;640;10;650
28;Normandie;27;1;16;119;Bueil;1618;29;1647
28;Normandie;27;3;08;120;Burey;402;5;407
28;Normandie;27;1;16;123;Caillouet-Orgeville;484;12;496
28;Normandie;27;1;12;124;Cailly-sur-Eure;216;1;217
28;Normandie;27;2;07;125;Calleville;664;10;674
28;Normandie;27;2;17;126;Campigny;1168;22;1190
28;Normandie;27;2;15;127;Canappeville;689;21;710
28;Normandie;27;2;02;129;Caorches-Saint-Nicolas;593;15;608
28;Normandie;27;2;06;130;Capelle-les-Grands;422;11;433
28;Normandie;27;3;08;132;Caugé;862;24;886
28;Normandie;27;2;04;133;Caumont;1061;10;1071
28;Normandie;27;2;04;134;Cauverville-en-Roumois;217;0;217
28;Normandie;27;2;15;135;Cesseville;474;12;486
28;Normandie;27;1;16;136;Chaignes;277;4;281
28;Normandie;27;2;06;137;Chaise-Dieu-du-Theil;205;5;210
28;Normandie;27;2;06;138;Chamblac;394;10;404
28;Normandie;27;2;22;032;Chambois;1389;31;1420
28;Normandie;27;2;06;139;Chambord;170;6;176
28;Normandie;27;1;16;140;Chambray;418;11;429
28;Normandie;27;3;08;141;Champ-Dolent;64;0;64
28;Normandie;27;1;12;142;Champenard;276;7;283
28;Normandie;27;3;20;144;Champigny-la-Futelaye;284;5;289
28;Normandie;27;2;03;146;La Chapelle-Bayvel;379;5;384
28;Normandie;27;3;10;147;La Chapelle-du-Bois-des-Faulx;682;10;692
28;Normandie;27;2;06;148;La Chapelle-Gauthier;406;10;416
28;Normandie;27;2;03;149;La Chapelle-Hareng;107;3;110
28;Normandie;27;1;16;554;La Chapelle-Longueville;3325;104;3429
28;Normandie;27;1;19;151;Charleval;1761;22;1783
28;Normandie;27;1;01;152;Château-sur-Epte;560;9;569
28;Normandie;27;1;13;153;Chauvincourt-Provemont;367;6;373
28;Normandie;27;3;20;154;Chavigny-Bailleul;593;16;609
28;Normandie;27;2;22;155;Chennebrun;108;2;110
28;Normandie;27;2;06;156;Chéronvilliers;488;18;506
28;Normandie;27;3;11;158;Cierrey;755;28;783
28;Normandie;27;3;08;161;Claville;1083;21;1104
28;Normandie;27;1;12;191;Clef Vallée d'Eure;2517;65;2582
28;Normandie;27;3;08;162;Collandres-Quincarnon;240;5;245
28;Normandie;27;2;17;163;Colletot;207;1;208
28;Normandie;27;2;07;164;Combon;818;8;826
28;Normandie;27;3;08;165;Conches-en-Ouche;5004;65;5069
28;Normandie;27;2;17;167;Condé-sur-Risle;642;6;648
28;Normandie;27;1;21;168;Connelles;185;7;192
28;Normandie;27;2;03;169;Conteville;1004;12;1016
28;Normandie;27;2;03;170;Cormeilles;1164;21;1185
28;Normandie;27;1;16;171;Le Cormier;396;11;407
28;Normandie;27;2;02;173;Corneville-la-Fouquetière;121;3;124
28;Normandie;27;2;17;174;Corneville-sur-Risle;1363;26;1389
28;Normandie;27;1;13;176;Coudray;217;5;222
28;Normandie;27;3;20;177;Coudres;547;13;560
28;Normandie;27;2;02;179;Courbépine;721;16;737
28;Normandie;27;1;12;180;Courcelles-sur-Seine;2068;37;2105
28;Normandie;27;3;22;181;Courdemanche;600;12;612
28;Normandie;27;2;22;182;Courteilles;153;3;156
28;Normandie;27;3;20;183;La Couture-Boussey;2305;43;2348
28;Normandie;27;1;18;184;Crasville;125;3;128
28;Normandie;27;2;15;185;Crestot;583;6;589
28;Normandie;27;2;15;187;Criquebeuf-la-Campagne;321;6;327
28;Normandie;27;1;18;188;Criquebeuf-sur-Seine;1470;14;1484
28;Normandie;27;3;08;189;La Croisille;435;7;442
28;Normandie;27;1;16;190;Croisy-sur-Eure;197;4;201
28;Normandie;27;2;15;192;Crosville-la-Vieille;601;11;612
28;Normandie;27;3;20;193;Croth;1362;16;1378
28;Normandie;27;1;01;194;Cuverville;248;2;250
28;Normandie;27;1;18;196;Les Damps;1380;8;1388
28;Normandie;27;1;13;199;Dangu;573;12;585
28;Normandie;27;3;10;200;Dardez;150;7;157
28;Normandie;27;2;15;201;Daubeuf-la-Campagne;234;6;240
28;Normandie;27;1;01;202;Daubeuf-près-Vatteville;462;8;470
28;Normandie;27;1;16;203;Douains;494;17;511
28;Normandie;27;1;13;204;Doudeauville-en-Vexin;293;7;300
28;Normandie;27;1;19;205;Douville-sur-Andelle;448;4;452
28;Normandie;27;3;22;206;Droisy;445;3;448
28;Normandie;27;2;03;207;Drucourt;599;7;606
28;Normandie;27;2;03;208;Duranville;152;2;154
28;Normandie;27;2;17;209;Écaquelon;607;11;618
28;Normandie;27;2;07;210;Écardenville-la-Campagne;473;12;485
28;Normandie;27;2;15;212;Écauville;110;2;112
28;Normandie;27;1;01;214;Écouis;817;14;831
28;Normandie;27;2;15;215;Ecquetot;379;9;388
28;Normandie;27;3;10;216;Émalleville;507;26;533
28;Normandie;27;2;15;217;Émanville;560;9;569
28;Normandie;27;2;03;218;Épaignes;1598;24;1622
28;Normandie;27;2;15;219;Épégard;561;7;568
28;Normandie;27;3;20;220;Épieds;352;8;360
28;Normandie;27;2;03;222;Épreville-en-Lieuvin;197;4;201
28;Normandie;27;2;15;224;Épreville-près-le-Neubourg;465;10;475
28;Normandie;27;1;13;226;Étrépagny;3753;82;3835
28;Normandie;27;2;04;227;Étréville;671;11;682
28;Normandie;27;2;04;228;Éturqueraye;298;3;301
28;Normandie;27;3;99;229;Évreux;46707;1229;47936
28;Normandie;27;3;20;230;Ézy-sur-Eure;3690;55;3745
28;Normandie;27;1;16;231;Fains;442;7;449
28;Normandie;27;1;13;232;Farceaux;345;7;352
28;Normandie;27;2;03;233;Fatouville-Grestain;730;11;741
28;Normandie;27;3;11;234;Fauville;354;6;360
28;Normandie;27;3;08;235;Faverolles-la-Campagne;167;3;170
28;Normandie;27;2;03;237;Le Favril;168;2;170
28;Normandie;27;3;08;240;La Ferrière-sur-Risle;221;4;225
28;Normandie;27;3;08;238;Ferrières-Haut-Clocher;1161;29;1190
28;Normandie;27;2;06;239;Ferrières-Saint-Hilaire;420;7;427
28;Normandie;27;2;15;241;Feuguerolles;176;5;181
28;Normandie;27;3;08;242;Le Fidelaire;1023;14;1037
28;Normandie;27;2;03;243;Fiquefleur-Équainville;737;10;747
28;Normandie;27;2;05;085;Flancourt-Crescy-en-Roumois;1486;22;1508
28;Normandie;27;1;19;245;Fleury-la-Forêt;261;8;269
28;Normandie;27;1;19;246;Fleury-sur-Andelle;1838;19;1857
28;Normandie;27;1;19;247;Flipou;323;3;326
28;Normandie;27;2;03;248;Folleville;197;3;200
28;Normandie;27;1;12;249;Fontaine-Bellenger;1151;21;1172
28;Normandie;27;2;02;251;Fontaine-l'Abbé;538;8;546
28;Normandie;27;2;03;252;Fontaine-la-Louvet;331;7;338
28;Normandie;27;1;16;254;Fontaine-sous-Jouy;860;23;883
28;Normandie;27;3;20;256;La Forêt-du-Parc;611;9;620
28;Normandie;27;2;03;258;Fort-Moville;510;7;517
28;Normandie;27;3;20;259;Foucrainville;84;4;88
28;Normandie;27;2;03;260;Foulbec;661;8;669
28;Normandie;27;2;05;261;Fouqueville;454;12;466
28;Normandie;27;2;07;266;Franqueville;325;2;327
28;Normandie;27;1;01;070;Frenelles-en-Vexin ;1706;35;1741
28;Normandie;27;2;17;267;Freneuse-sur-Risle;355;4;359
28;Normandie;27;2;03;269;Fresne-Cauverville;196;3;199
28;Normandie;27;3;20;271;Fresney;338;14;352
28;Normandie;27;1;16;273;Gadencourt;380;7;387
28;Normandie;27;1;12;275;Gaillon;6892;98;6990
28;Normandie;27;1;13;276;Gamaches-en-Vexin;289;8;297
28;Normandie;27;3;20;278;Garennes-sur-Eure;1926;38;1964
28;Normandie;27;1;23;279;Gasny;3065;52;3117
28;Normandie;27;3;11;280;Gauciel;831;7;838
28;Normandie;27;3;08;281;Gaudreville-la-Rivière;229;8;237
28;Normandie;27;3;08;282;Gauville-la-Campagne;591;13;604
28;Normandie;27;1;13;284;Gisors;11674;168;11842
28;Normandie;27;1;23;285;Giverny;496;13;509
28;Normandie;27;2;03;286;Giverville;405;5;410
28;Normandie;27;3;08;287;Glisolles;862;17;879
28;Normandie;27;2;17;288;Glos-sur-Risle;596;14;610
28;Normandie;27;2;06;289;La Goulafrière;166;3;169
28;Normandie;27;2;07;290;Goupil-Othon;1256;16;1272
28;Normandie;27;2;22;291;Gournay-le-Guérin;129;11;140
28;Normandie;27;2;05;105;Grand Bourgtheroulde;3876;77;3953
28;Normandie;27;2;06;295;Grand-Camp;485;15;500
28;Normandie;27;2;15;298;Graveron-Sémerville;308;6;314
28;Normandie;27;3;10;299;Gravigny;3967;80;4047
28;Normandie;27;2;07;300;Grosley-sur-Risle;524;4;528
28;Normandie;27;3;20;301;Grossœuvre;1239;26;1265
28;Normandie;27;1;13;304;Guerny;169;4;173
28;Normandie;27;3;11;306;Guichainville;2807;57;2864
28;Normandie;27;1;01;307;Guiseniers;469;7;476
28;Normandie;27;3;20;309;L' Habit;506;7;513
28;Normandie;27;1;13;310;Hacqueville;432;8;440
28;Normandie;27;2;07;311;Harcourt;1077;5;1082
28;Normandie;27;1;16;312;Hardencourt-Cocherel;264;13;277
28;Normandie;27;2;05;313;La Harengère;601;5;606
28;Normandie;27;1;01;315;Harquency;266;8;274
28;Normandie;27;2;04;316;Hauville;1273;27;1300
28;Normandie;27;2;04;317;La Haye-Aubrée;463;10;473
28;Normandie;27;2;07;318;La Haye-de-Calleville;261;3;264
28;Normandie;27;2;04;319;La Haye-de-Routot;307;5;312
28;Normandie;27;2;05;320;La Haye-du-Theil;301;0;301
28;Normandie;27;1;18;321;La Haye-le-Comte;135;5;140
28;Normandie;27;1;18;322;La Haye-Malherbe;1398;19;1417
28;Normandie;27;2;06;323;La Haye-Saint-Sylvestre;280;3;283
28;Normandie;27;1;13;324;Hébécourt;601;14;615
28;Normandie;27;2;07;325;Hecmanville;180;3;183
28;Normandie;27;1;16;326;Hécourt;322;13;335
28;Normandie;27;2;15;327;Hectomare;216;8;224
28;Normandie;27;1;01;329;Hennezis;780;23;803
28;Normandie;27;1;21;330;Herqueville;133;4;137
28;Normandie;27;1;01;331;Heubécourt-Haricourt;459;10;469
28;Normandie;27;1;14;332;Heudebouville;787;12;799
28;Normandie;27;1;13;333;Heudicourt;703;7;710
28;Normandie;27;2;03;334;Heudreville-en-Lieuvin;109;1;110
28;Normandie;27;1;12;335;Heudreville-sur-Eure;1062;32;1094
28;Normandie;27;1;16;336;La Heunière;407;4;411
28;Normandie;27;1;01;337;Heuqueville;360;6;366
28;Normandie;27;1;19;338;Les Hogues;658;8;666
28;Normandie;27;2;15;339;Hondouville;793;15;808
28;Normandie;27;2;04;340;Honguemare-Guenouville;703;8;711
28;Normandie;27;2;22;341;L' Hosmes;67;3;70
28;Normandie;27;2;15;342;Houetteville;205;6;211
28;Normandie;27;1;16;343;Houlbec-Cocherel;1293;55;1348
28;Normandie;27;2;07;345;La Houssaye;209;2;211
28;Normandie;27;1;19;346;Houville-en-Vexin;234;4;238
28;Normandie;27;3;11;347;Huest;792;26;818
28;Normandie;27;1;18;348;Igoville;1742;20;1762
28;Normandie;27;2;17;349;Illeville-sur-Montfort;874;13;887
28;Normandie;27;3;22;350;Illiers-l'Évêque;995;17;1012
28;Normandie;27;1;14;351;Incarville;1419;24;1443
28;Normandie;27;3;10;353;Irreville;469;8;477
28;Normandie;27;2;15;354;Iville;436;4;440
28;Normandie;27;3;20;355;Ivry-la-Bataille;2694;30;2724
28;Normandie;27;1;16;358;Jouy-sur-Eure;586;13;599
28;Normandie;27;2;06;359;Juignettes;228;1;229
28;Normandie;27;3;20;360;Jumelles;327;7;334
28;Normandie;27;2;03;361;La Lande-Saint-Léger;377;5;382
28;Normandie;27;2;04;363;Le Landin;215;7;222
28;Normandie;27;2;07;364;Launay;197;3;200
28;Normandie;27;1;21;365;Léry;2028;38;2066
28;Normandie;27;2;06;565;Le Lesme;675;9;684
28;Normandie;27;1;19;366;Letteguives;206;3;209
28;Normandie;27;2;03;367;Lieurey;1463;15;1478
28;Normandie;27;3;20;368;Lignerolles;333;9;342
28;Normandie;27;1;19;369;Lilly;82;2;84
28;Normandie;27;1;19;370;Lisors;340;10;350
28;Normandie;27;2;07;371;Livet-sur-Authou;155;1;156
28;Normandie;27;1;13;372;Longchamps;658;5;663
28;Normandie;27;1;19;373;Lorleau;131;2;133
28;Normandie;27;3;08;374;Louversey;536;14;550
28;Normandie;27;1;14;375;Louviers;18348;400;18748
28;Normandie;27;3;20;376;Louye;223;5;228
28;Normandie;27;1;19;377;Lyons-la-Forêt;717;6;723
28;Normandie;27;3;22;378;La Madeleine-de-Nonancourt;1145;24;1169
28;Normandie;27;1;19;379;Mainneville;434;8;442
28;Normandie;27;2;07;380;Malleville-sur-le-Bec;263;4;267
28;Normandie;27;2;02;381;Malouy;161;0;161
28;Normandie;27;2;15;382;Mandeville;316;9;325
28;Normandie;27;2;22;383;Mandres;376;11;387
28;Normandie;27;2;03;384;Manneville-la-Raoult;505;11;516
28;Normandie;27;2;17;385;Manneville-sur-Risle;1514;42;1556
28;Normandie;27;1;18;386;Le Manoir;1310;7;1317
28;Normandie;27;2;04;388;Marais-Vernier;498;9;507
28;Normandie;27;2;15;389;Marbeuf;459;17;476
28;Normandie;27;2;89;157;Marbois;1356;20;1376
28;Normandie;27;3;22;390;Marcilly-la-Campagne;1141;16;1157
28;Normandie;27;3;20;391;Marcilly-sur-Eure;1605;21;1626
28;Normandie;27;1;19;392;Martagny;151;4;155
28;Normandie;27;2;03;393;Martainville;499;2;501
28;Normandie;27;1;18;394;Martot;531;11;542
28;Normandie;27;2;06;395;Mélicourt;85;1;86
28;Normandie;27;1;19;396;Ménesqueville;465;9;474
28;Normandie;27;1;16;397;Ménilles;1739;42;1781
28;Normandie;27;2;02;398;Menneval;1460;105;1565
28;Normandie;27;1;16;399;Mercey;52;1;53
28;Normandie;27;1;16;400;Merey;345;4;349
28;Normandie;27;2;02;049;Mesnil-en-Ouche;4623;123;4746
28;Normandie;27;3;15;401;Le Mesnil-Fuguet;174;3;177
28;Normandie;27;1;18;403;Le Mesnil-Jourdain;234;12;246
28;Normandie;27;2;06;404;Mesnil-Rousset;92;1;93
28;Normandie;27;2;03;541;Mesnil-Saint-Jean ;215;6;221
28;Normandie;27;1;19;405;Mesnil-sous-Vienne;106;5;111
28;Normandie;27;3;20;406;Mesnil-sur-l'Estrée;895;24;919
28;Normandie;27;1;01;407;Mesnil-Verclives;323;9;332
28;Normandie;27;2;  ;198;Mesnils-sur-Iton ;6126;254;6380
28;Normandie;27;1;01;408;Mézières-en-Vexin;606;19;625
28;Normandie;27;3;11;410;Miserey;634;7;641
28;Normandie;27;3;22;411;Moisville;236;2;238
28;Normandie;27;2;17;413;Montfort-sur-Risle;767;12;779
28;Normandie;27;2;06;414;Montreuil-l'Argillé;832;10;842
28;Normandie;27;2;05;062;Les Monts du Roumois;1563;47;1610
28;Normandie;27;2;03;415;Morainville-Jouveaux;371;7;378
28;Normandie;27;1;13;417;Morgny;662;12;674
28;Normandie;27;2;07;418;Morsan;107;0;107
28;Normandie;27;3;20;419;Mouettes;773;18;791
28;Normandie;27;1;13;420;Mouflaines;164;7;171
28;Normandie;27;3;20;421;Mousseaux-Neuville;644;13;657
28;Normandie;27;1;01;422;Muids;877;22;899
28;Normandie;27;3;20;423;Muzy;788;18;806
28;Normandie;27;3;08;424;Nagel-Séez-Mesnil;326;8;334
28;Normandie;27;2;  ;425;Nassandres sur Risle ;2396;46;2442
28;Normandie;27;2;06;427;Neaufles-Auvergny;422;8;430
28;Normandie;27;1;13;426;Neaufles-Saint-Martin;1306;7;1313
28;Normandie;27;2;15;428;Le Neubourg;4204;215;4419
28;Normandie;27;1;16;429;Neuilly;181;0;181
28;Normandie;27;1;13;430;La Neuve-Grange;331;3;334
28;Normandie;27;2;06;431;La Neuve-Lyre;575;6;581
28;Normandie;27;2;07;432;La Neuville-du-Bosc;675;7;682
28;Normandie;27;2;07;433;Neuville-sur-Authou;191;2;193
28;Normandie;27;2;03;434;Noards;56;0;56
28;Normandie;27;2;03;435;La Noë-Poulain;275;3;278
28;Normandie;27;3;08;436;Nogent-le-Sec;435;6;441
28;Normandie;27;1;13;437;Nojeon-en-Vexin;339;6;345
28;Normandie;27;3;22;438;Nonancourt;2290;40;2330
28;Normandie;27;3;10;439;Normanville;1133;37;1170
28;Normandie;27;2;07;441;Notre-Dame-d'Épine;78;1;79
28;Normandie;27;1;01;440;Notre-Dame-de-l'Isle;665;22;687
28;Normandie;27;2;06;442;Notre-Dame-du-Hamel;204;7;211
28;Normandie;27;2;02;444;Le Noyer-en-Ouche;228;2;230
28;Normandie;27;1;13;445;Noyers;257;4;261
28;Normandie;27;3;08;446;Ormes;484;3;487
28;Normandie;27;1;16;448;Pacy-sur-Eure;5069;127;5196
28;Normandie;27;3;08;451;Parville;300;6;306
28;Normandie;27;2;  ;263;Perrey ;1239;13;1252
28;Normandie;27;1;19;453;Perriers-sur-Andelle;1798;20;1818
28;Normandie;27;1;19;454;Perruel;467;7;474
28;Normandie;27;2;03;455;Piencourt;160;3;163
28;Normandie;27;1;18;456;Pinterville;752;18;770
28;Normandie;27;2;22;457;Piseux;720;12;732
28;Normandie;27;1;18;458;Pîtres;2580;26;2606
28;Normandie;27;2;03;459;Les Places;76;2;78
28;Normandie;27;2;02;460;Plainville;200;5;205
28;Normandie;27;2;03;462;Le Planquay;159;1;160
28;Normandie;27;2;02;463;Plasnes;719;8;727
28;Normandie;27;3;11;464;Le Plessis-Grohan;881;18;899
28;Normandie;27;1;16;465;Le Plessis-Hébert;399;13;412
28;Normandie;27;2;07;466;Le Plessis-Sainte-Opportune;335;5;340
28;Normandie;27;2;17;467;Pont-Audemer ;10120;270;10390
28;Normandie;27;2;17;468;Pont-Authou;615;8;623
28;Normandie;27;1;18;469;Pont-de-l'Arche;4151;57;4208
28;Normandie;27;1;19;470;Pont-Saint-Pierre;1143;22;1165
28;Normandie;27;1;01;473;Port-Mort;916;26;942
28;Normandie;27;1;21;471;Porte-de-Seine ;207;7;214
28;Normandie;27;3;08;472;Portes;274;3;277
28;Normandie;27;1;21;474;Poses;1167;22;1189
28;Normandie;27;2;03;475;La Poterie-Mathieu;165;1;166
28;Normandie;27;2;17;476;Les Préaux;382;8;390
28;Normandie;27;1;01;477;Pressagny-l'Orgueilleux;700;26;726
28;Normandie;27;3;20;478;Prey;950;25;975
28;Normandie;27;1;13;480;Puchay;640;7;647
28;Normandie;27;2;22;481;Pullay;404;54;458
28;Normandie;27;2;15;482;La Pyle;167;4;171
28;Normandie;27;1;18;483;Quatremare;429;6;435
28;Normandie;27;2;04;485;Quillebeuf-sur-Seine;839;8;847
28;Normandie;27;2;15;486;Quittebeuf;659;18;677
28;Normandie;27;1;19;487;Radepont;657;2;659
28;Normandie;27;1;19;488;Renneville;193;4;197
28;Normandie;27;3;10;489;Reuilly;523;13;536
28;Normandie;27;1;13;490;Richeville;270;4;274
28;Normandie;27;2;07;492;Romilly-la-Puthenaye;318;10;328
28;Normandie;27;1;19;493;Romilly-sur-Andelle;3277;51;3328
28;Normandie;27;1;01;495;La Roquette;238;2;240
28;Normandie;27;1;19;496;Rosay-sur-Lieure;522;6;528
28;Normandie;27;2;07;498;Rouge-Perriers;367;4;371
28;Normandie;27;2;04;497;Rougemontiers;1052;17;1069
28;Normandie;27;2;04;500;Routot;1650;55;1705
28;Normandie;27;1;16;501;Rouvray;258;6;264
28;Normandie;27;2;06;502;Rugles;2231;28;2259
28;Normandie;27;3;15;504;Sacquenville;1262;37;1299
28;Normandie;27;2;06;505;Saint-Agnan-de-Cernières;164;1;165
28;Normandie;27;3;20;507;Saint-André-de-l'Eure;3996;65;4061
28;Normandie;27;2;06;508;Saint-Antonin-de-Sommaire;191;2;193
28;Normandie;27;2;15;511;Saint-Aubin-d'Écrosville;707;11;718
28;Normandie;27;2;03;512;Saint-Aubin-de-Scellon;338;7;345
28;Normandie;27;2;06;514;Saint-Aubin-du-Thenney;375;2;377
28;Normandie;27;1;12;517;Saint-Aubin-sur-Gaillon;2048;46;2094
28;Normandie;27;2;04;518;Saint-Aubin-sur-Quillebeuf;735;13;748
28;Normandie;27;2;03;520;Saint-Benoît-des-Ombres;142;1;143
28;Normandie;27;2;22;521;Saint-Christophe-sur-Avre;139;6;145
28;Normandie;27;2;03;522;Saint-Christophe-sur-Condé;458;4;462
28;Normandie;27;2;07;527;Saint-Cyr-de-Salerne;207;7;214
28;Normandie;27;2;05;529;Saint-Cyr-la-Campagne;431;9;440
28;Normandie;27;2;06;530;Saint-Denis-d'Augerons;83;3;86
28;Normandie;27;2;05;531;Saint-Denis-des-Monts;208;4;212
28;Normandie;27;1;13;533;Saint-Denis-le-Ferment;491;20;511
28;Normandie;27;2;05;534;Saint-Didier-des-Bois;887;10;897
28;Normandie;27;3;08;535;Saint-Élier;438;9;447
28;Normandie;27;2;07;536;Saint-Éloi-de-Fourques;530;15;545
28;Normandie;27;1;14;537;Saint-Étienne-du-Vauvray;878;14;892
28;Normandie;27;2;03;538;Saint-Étienne-l'Allier;546;9;555
28;Normandie;27;1;12;539;Saint-Étienne-sous-Bailleul;384;13;397
28;Normandie;27;2;03;542;Saint-Georges-du-Vièvre;882;15;897
28;Normandie;27;3;20;543;Saint-Georges-Motel;896;11;907
28;Normandie;27;3;20;544;Saint-Germain-de-Fresney;206;5;211
28;Normandie;27;2;05;545;Saint-Germain-de-Pasquier;124;5;129
28;Normandie;27;3;10;546;Saint-Germain-des-Angles;169;2;171
28;Normandie;27;2;03;547;Saint-Germain-la-Campagne;877;21;898
28;Normandie;27;3;22;548;Saint-Germain-sur-Avre;1171;25;1196
28;Normandie;27;2;03;550;Saint-Grégoire-du-Vièvre;312;7;319
28;Normandie;27;2;06;552;Saint-Jean-du-Thenney;248;5;253
28;Normandie;27;1;12;553;Saint-Julien-de-la-Liègue;417;2;419
28;Normandie;27;3;20;555;Saint-Laurent-des-Bois;247;5;252
28;Normandie;27;2;06;556;Saint-Laurent-du-Tencement;64;0;64
28;Normandie;27;2;02;557;Saint-Léger-de-Rôtes;455;6;461
28;Normandie;27;2;05;558;Saint-Léger-du-Gennetey;179;6;185
28;Normandie;27;3;11;560;Saint-Luc;252;12;264
28;Normandie;27;2;03;561;Saint-Maclou;637;11;648
28;Normandie;27;1;16;562;Saint-Marcel;4446;136;4582
28;Normandie;27;2;17;563;Saint-Mards-de-Blacarville;819;23;842
28;Normandie;27;2;03;564;Saint-Mards-de-Fresne;333;6;339
28;Normandie;27;2;02;569;Saint-Martin-du-Tilleul;242;10;252
28;Normandie;27;3;15;570;Saint-Martin-la-Campagne;99;2;101
28;Normandie;27;2;03;571;Saint-Martin-Saint-Firmin;329;10;339
28;Normandie;27;2;15;572;Saint-Meslin-du-Bosc;282;4;286
28;Normandie;27;2;05;579;Saint-Ouen-de-Pontcheuil;97;2;99
28;Normandie;27;2;04;580;Saint-Ouen-de-Thouberville;2382;30;2412
28;Normandie;27;2;05;582;Saint-Ouen-du-Tilleul;1662;16;1678
28;Normandie;27;2;07;584;Saint-Paul-de-Fourques;288;9;297
28;Normandie;27;2;05;586;Saint-Philbert-sur-Boissey;171;1;172
28;Normandie;27;2;17;587;Saint-Philbert-sur-Risle;789;6;795
28;Normandie;27;1;12;589;Saint-Pierre-de-Bailleul;960;31;991
28;Normandie;27;2;06;590;Saint-Pierre-de-Cernières;230;3;233
28;Normandie;27;2;03;591;Saint-Pierre-de-Cormeilles;602;12;614
28;Normandie;27;2;07;592;Saint-Pierre-de-Salerne;246;3;249
28;Normandie;27;2;05;593;Saint-Pierre-des-Fleurs;1588;22;1610
28;Normandie;27;2;03;594;Saint-Pierre-des-Ifs;277;1;278
28;Normandie;27;2;05;595;Saint-Pierre-du-Bosguérard;1023;13;1036
28;Normandie;27;2;03;597;Saint-Pierre-du-Val;578;1;579
28;Normandie;27;1;14;598;Saint-Pierre-du-Vauvray;1264;26;1290
28;Normandie;27;1;12;599;Saint-Pierre-la-Garenne;910;10;920
28;Normandie;27;2;04;601;Saint-Samson-de-la-Roque;434;10;444
28;Normandie;27;3;09;602;Saint-Sébastien-de-Morsent;5646;170;5816
28;Normandie;27;2;03;603;Saint-Siméon;313;6;319
28;Normandie;27;2;03;604;Saint-Sulpice-de-Grimbouville;160;2;162
28;Normandie;27;2;03;605;Saint-Sylvestre-de-Cormeilles;245;5;250
28;Normandie;27;2;17;606;Saint-Symphorien;489;1;490
28;Normandie;27;2;07;609;Saint-Victor-d'Épine;327;6;333
28;Normandie;27;2;02;608;Saint-Victor-de-Chrétienville;451;9;460
28;Normandie;27;2;22;610;Saint-Victor-sur-Avre;57;1;58
28;Normandie;27;3;10;611;Saint-Vigor;325;10;335
28;Normandie;27;1;16;612;Saint-Vincent-des-Bois;331;6;337
28;Normandie;27;2;03;613;Saint-Vincent-du-Boulay;380;4;384
28;Normandie;27;2;15;524;Sainte-Colombe-la-Commanderie;862;6;868
28;Normandie;27;1;16;525;Sainte-Colombe-près-Vernon;303;18;321
28;Normandie;27;1;23;540;Sainte-Geneviève-lès-Gasny;669;15;684
28;Normandie;27;2;06;578;Sainte-Marie-d'Attez ;599;16;615
28;Normandie;27;1;13;567;Sainte-Marie-de-Vatimesnil;270;6;276
28;Normandie;27;3;08;568;Sainte-Marthe;501;8;509
28;Normandie;27;2;07;576;Sainte-Opportune-du-Bosc;641;15;656
28;Normandie;27;2;04;577;Sainte-Opportune-la-Mare;438;11;449
28;Normandie;27;1;13;614;Sancourt;161;2;163
28;Normandie;27;3;11;615;Sassey;192;3;195
28;Normandie;27;1;13;617;Saussay-la-Campagne;531;9;540
28;Normandie;27;2;05;616;La Saussaye;1883;52;1935
28;Normandie;27;3;08;618;Sébécourt;473;11;484
28;Normandie;27;2;17;620;Selles;464;2;466
28;Normandie;27;3;20;621;Serez;163;5;168
28;Normandie;27;2;02;622;Serquigny;1910;65;1975
28;Normandie;27;1;18;623;Surtauville;488;9;497
28;Normandie;27;1;18;624;Surville;891;24;915
28;Normandie;27;1;01;625;Suzay;352;2;354
28;Normandie;27;2;22;693;Sylvains-Lès-Moulins;1293;32;1325
28;Normandie;27;1;18;412;Terres de Bord ;1481;35;1516
28;Normandie;27;2;03;627;Le Theil-Nolent;246;12;258
28;Normandie;27;2;85;089;Thénouville;1010;17;1027
28;Normandie;27;2;03;629;Thiberville;1792;16;1808
28;Normandie;27;2;07;630;Thibouville;315;49;364
28;Normandie;27;2;17;631;Thierville;371;4;375
28;Normandie;27;1;13;632;Le Thil;562;8;570
28;Normandie;27;1;13;633;Les Thilliers-en-Vexin;492;4;496
28;Normandie;27;1;01;635;Le Thuit;141;1;142
28;Normandie;27;2;05;638;Le Thuit de l'Oison;3670;52;3722
28;Normandie;27;3;08;640;Tilleul-Dame-Agnès;193;4;197
28;Normandie;27;2;15;641;Le Tilleul-Lambert;256;5;261
28;Normandie;27;2;22;643;Tillières-sur-Avre;1077;23;1100
28;Normandie;27;1;01;644;Tilly;550;41;591
28;Normandie;27;2;04;645;Tocqueville;155;4;159
28;Normandie;27;2;03;646;Le Torpt;446;4;450
28;Normandie;27;1;19;649;Touffreville;352;7;359
28;Normandie;27;2;15;650;Tournedos-Bois-Hubert;472;8;480
28;Normandie;27;3;15;652;Tourneville;311;8;319
28;Normandie;27;2;05;654;Tourville-la-Campagne;1100;12;1112
28;Normandie;27;2;17;655;Tourville-sur-Pont-Audemer;726;165;891
28;Normandie;27;2;17;656;Toutainville;1327;32;1359
28;Normandie;27;2;  ;516;Treis-Sants-en-Ouche ;1416;34;1450
28;Normandie;27;2;15;658;Le Tremblay-Omonville;348;6;354
28;Normandie;27;3;11;659;La Trinité;120;6;126
28;Normandie;27;2;06;660;La Trinité-de-Réville;238;2;240
28;Normandie;27;2;04;661;La Trinité-de-Thouberville;427;9;436
28;Normandie;27;2;17;662;Triqueville;330;11;341
28;Normandie;27;1;12;676;Les Trois Lacs;1780;44;1824
28;Normandie;27;2;15;663;Le Troncq;170;4;174
28;Normandie;27;1;19;664;Le Tronquay;512;7;519
28;Normandie;27;2;04;665;Trouville-la-Haule;764;13;777
28;Normandie;27;1;18;666;La Vacherie;567;19;586
28;Normandie;27;1;12;022;Le Val d'Hazey;5451;111;5562
28;Normandie;27;1;19;294;Val d'Orger;990;16;1006
28;Normandie;27;3;11;668;Le Val-David;712;11;723
28;Normandie;27;1;21;701;Val-de-Reuil;13114;289;13403
28;Normandie;27;3;08;447;Le Val-Doré;909;56;965
28;Normandie;27;2;02;667;Valailles;381;9;390
28;Normandie;27;2;04;669;Valletot;434;6;440
28;Normandie;27;1;19;670;Vandrimare;958;18;976
28;Normandie;27;2;03;671;Vannecrocq;159;6;165
28;Normandie;27;1;19;672;Vascœuil;354;1;355
28;Normandie;27;1;01;673;Vatteville;180;4;184
28;Normandie;27;1;21;528;Le Vaudreuil;3701;83;3784
28;Normandie;27;1;16;674;Vaux-sur-Eure;268;7;275
28;Normandie;27;2;15;677;Venon;405;8;413
28;Normandie;27;3;08;678;Les Ventes;1036;24;1060
28;Normandie;27;2;86;679;Verneuil d'Avre et d'Iton;7854;385;8239
28;Normandie;27;2;06;680;Verneusses;197;6;203
28;Normandie;27;1;23;681;Vernon;23777;687;24464
28;Normandie;27;1;13;682;Vesly;676;17;693
28;Normandie;27;1;01;213;Vexin-sur-Epte;6008;137;6145
28;Normandie;27;1;01;683;Vézillon;242;3;245
28;Normandie;27;3;11;684;Le Vieil-Évreux;829;14;843
28;Normandie;27;2;06;685;La Vieille-Lyre;655;18;673
28;Normandie;27;2;04;686;Vieux-Port;47;0;47
28;Normandie;27;1;16;689;Villegats;349;16;365
28;Normandie;27;1;13;690;Villers-en-Vexin;312;1;313
28;Normandie;27;1;12;691;Villers-sur-le-Roule;862;19;881
28;Normandie;27;2;15;692;Villettes;166;6;172
28;Normandie;27;1;16;694;Villez-sous-Bailleul;313;15;328
28;Normandie;27;2;15;695;Villez-sur-le-Neubourg;282;6;288
28;Normandie;27;1;16;696;Villiers-en-Désœuvre;937;17;954
28;Normandie;27;1;14;697;Vironvay;331;17;348
28;Normandie;27;2;15;698;Vitot;560;13;573
28;Normandie;27;2;05;699;Voiscreville;122;3;125
28;Normandie;27;2;15;700;Vraiville;718;5;723
24;Centre-Val de Loire;28;3;01;001;Abondant;2368;55;2423
24;Centre-Val de Loire;28;3;08;003;Allainville;138;4;142
24;Centre-Val de Loire;28;1;15;004;Allonnes;315;3;318
24;Centre-Val de Loire;28;2;07;005;Alluyes;753;90;843
24;Centre-Val de Loire;28;1;12;006;Amilly;1833;47;1880
24;Centre-Val de Loire;28;3;01;007;Anet;2714;103;2817
24;Centre-Val de Loire;28;4;13;236;Arcisses ;2190;60;2250
24;Centre-Val de Loire;28;3;14;008;Ardelles;201;2;203
24;Centre-Val de Loire;28;1;02;009;Ardelu;73;1;74
24;Centre-Val de Loire;28;4;13;010;Argenvilliers;328;9;337
24;Centre-Val de Loire;28;1;02;013;Aunay-sous-Auneau;1504;24;1528
24;Centre-Val de Loire;28;3;08;014;Aunay-sous-Crécy;643;7;650
24;Centre-Val de Loire;28;1;02;015;Auneau-Bleury-Saint-Symphorien;6039;86;6125
24;Centre-Val de Loire;28;4;03;016;Les Autels-Villevillon;143;7;150
24;Centre-Val de Loire;28;4;03;018;Authon-du-Perche ;1506;16;1522
24;Centre-Val de Loire;28;2;15;019;Baigneaux;213;4;217
24;Centre-Val de Loire;28;1;02;023;Bailleau-Armenonville;1381;26;1407
24;Centre-Val de Loire;28;1;06;022;Bailleau-l'Évêque;1151;31;1182
24;Centre-Val de Loire;28;1;11;021;Bailleau-le-Pin;1558;29;1587
24;Centre-Val de Loire;28;1;12;024;Barjouville;1710;59;1769
24;Centre-Val de Loire;28;1;15;025;Barmainville;112;2;114
24;Centre-Val de Loire;28;1;15;026;Baudreville;252;0;252
24;Centre-Val de Loire;28;4;03;027;La Bazoche-Gouet;1220;20;1240
24;Centre-Val de Loire;28;2;15;028;Bazoches-en-Dunois;260;5;265
24;Centre-Val de Loire;28;2;15;029;Bazoches-les-Hautes;313;7;320
24;Centre-Val de Loire;28;3;14;030;Beauche;274;8;282
24;Centre-Val de Loire;28;4;03;031;Beaumont-les-Autels;393;111;504
24;Centre-Val de Loire;28;1;15;032;Beauvilliers;333;4;337
24;Centre-Val de Loire;28;4;13;033;Belhomert-Guéhouville;799;32;831
24;Centre-Val de Loire;28;1;05;035;Berchères-les-Pierres;988;23;1011
24;Centre-Val de Loire;28;1;04;034;Berchères-Saint-Germain;856;11;867
24;Centre-Val de Loire;28;3;01;036;Berchères-sur-Vesgre;849;20;869
24;Centre-Val de Loire;28;3;14;037;Bérou-la-Mulotière;335;5;340
24;Centre-Val de Loire;28;4;03;038;Béthonvilliers;116;5;121
24;Centre-Val de Loire;28;1;02;039;Béville-le-Comte;1665;31;1696
24;Centre-Val de Loire;28;1;11;040;Billancelles;324;9;333
24;Centre-Val de Loire;28;1;11;041;Blandainville;276;2;278
24;Centre-Val de Loire;28;3;08;045;Boissy-en-Drouais;218;6;224
24;Centre-Val de Loire;28;3;14;046;Boissy-lès-Perche;490;9;499
24;Centre-Val de Loire;28;1;15;047;Boisville-la-Saint-Père;718;15;733
24;Centre-Val de Loire;28;1;15;049;Boncé;245;5;250
24;Centre-Val de Loire;28;3;01;050;Boncourt;266;6;272
24;Centre-Val de Loire;28;2;07;051;Bonneval;4950;101;5051
24;Centre-Val de Loire;28;1;10;052;Bouglainval;760;15;775
24;Centre-Val de Loire;28;3;14;053;Le Boullay-les-Deux-Églises;256;3;259
24;Centre-Val de Loire;28;3;09;054;Le Boullay-Mivoye;495;11;506
24;Centre-Val de Loire;28;3;09;055;Le Boullay-Thierry;556;9;565
24;Centre-Val de Loire;28;1;05;048;La Bourdinière-Saint-Loup;734;14;748
24;Centre-Val de Loire;28;3;01;056;Boutigny-Prouais;1722;46;1768
24;Centre-Val de Loire;28;2;15;057;Bouville;588;9;597
24;Centre-Val de Loire;28;3;09;058;Bréchamps;354;4;358
24;Centre-Val de Loire;28;3;14;059;Brezolles;1832;28;1860
24;Centre-Val de Loire;28;1;04;060;Briconville;257;5;262
24;Centre-Val de Loire;28;2;03;061;Brou;3356;37;3393
24;Centre-Val de Loire;28;3;01;062;Broué;891;15;906
24;Centre-Val de Loire;28;3;01;064;Bû;1985;50;2035
24;Centre-Val de Loire;28;2;15;065;Bullainville;109;5;114
24;Centre-Val de Loire;28;1;11;067;Cernay;90;2;92
24;Centre-Val de Loire;28;1;04;068;Challet;432;10;442
24;Centre-Val de Loire;28;1;04;070;Champhol;3682;107;3789
24;Centre-Val de Loire;28;4;13;071;Champrond-en-Gâtine;675;3;678
24;Centre-Val de Loire;28;4;13;072;Champrond-en-Perchet;408;0;408
24;Centre-Val de Loire;28;1;02;073;Champseru;338;1;339
24;Centre-Val de Loire;28;1;02;074;La Chapelle-d'Aunainville;265;4;269
24;Centre-Val de Loire;28;2;07;075;La Chapelle-du-Noyer;1027;181;1208
24;Centre-Val de Loire;28;3;01;076;La Chapelle-Forainvilliers;197;3;200
24;Centre-Val de Loire;28;3;14;077;La Chapelle-Fortin;182;3;185
24;Centre-Val de Loire;28;4;03;078;Chapelle-Guillaume;185;4;189
24;Centre-Val de Loire;28;4;03;079;Chapelle-Royale;303;4;307
24;Centre-Val de Loire;28;4;03;080;Charbonnières;252;3;255
24;Centre-Val de Loire;28;1;11;081;Charonville;311;5;316
24;Centre-Val de Loire;28;3;09;082;Charpont;631;14;645
24;Centre-Val de Loire;28;1;10;084;Chartainvilliers;719;9;728
24;Centre-Val de Loire;28;1;98;085;Chartres;38426;1164;39590
24;Centre-Val de Loire;28;4;13;086;Chassant;328;8;336
24;Centre-Val de Loire;28;3;14;087;Châtaincourt;238;4;242
24;Centre-Val de Loire;28;2;07;088;Châteaudun;13078;335;13413
24;Centre-Val de Loire;28;3;14;089;Châteauneuf-en-Thymerais;2596;32;2628
24;Centre-Val de Loire;28;3;14;090;Les Châtelets;102;3;105
24;Centre-Val de Loire;28;1;11;091;Les Châtelliers-Notre-Dame;141;3;144
24;Centre-Val de Loire;28;1;02;092;Châtenay;234;6;240
24;Centre-Val de Loire;28;3;09;094;Chaudon;1677;27;1704
24;Centre-Val de Loire;28;1;11;095;Chauffours;276;6;282
24;Centre-Val de Loire;28;3;01;096;La Chaussée-d'Ivry;1189;17;1206
24;Centre-Val de Loire;28;3;01;098;Cherisy;1854;49;1903
24;Centre-Val de Loire;28;1;11;099;Chuisnes;1117;22;1139
24;Centre-Val de Loire;28;1;12;100;Cintray;425;6;431
24;Centre-Val de Loire;28;1;04;102;Clévilliers;709;9;718
24;Centre-Val de Loire;28;2;03;103;Cloyes-les-Trois-Rivières ;5651;125;5776
24;Centre-Val de Loire;28;1;04;104;Coltainville;891;28;919
24;Centre-Val de Loire;28;4;13;105;Combres;558;6;564
24;Centre-Val de Loire;28;2;03;012;Commune nouvelle d'Arrou;3727;64;3791
24;Centre-Val de Loire;28;2;07;106;Conie-Molitard;407;11;418
24;Centre-Val de Loire;28;1;05;107;Corancez;368;9;377
24;Centre-Val de Loire;28;2;15;108;Cormainville;232;8;240
24;Centre-Val de Loire;28;4;13;109;Les Corvées-les-Yys;317;5;322
24;Centre-Val de Loire;28;1;05;110;Le Coudray;4131;118;4249
24;Centre-Val de Loire;28;4;03;111;Coudray-au-Perche;349;12;361
24;Centre-Val de Loire;28;3;10;113;Coulombs;1350;32;1382
24;Centre-Val de Loire;28;2;15;114;Courbehaye;136;0;136
24;Centre-Val de Loire;28;1;11;116;Courville-sur-Eure;2851;62;2913
24;Centre-Val de Loire;28;3;08;117;Crécy-Couvé;270;10;280
24;Centre-Val de Loire;28;3;09;118;Croisilles;433;15;448
24;Centre-Val de Loire;28;4;13;119;La Croix-du-Perche;158;2;160
24;Centre-Val de Loire;28;3;14;120;Crucey-Villages;462;2;464
24;Centre-Val de Loire;28;2;15;121;Dambron;106;0;106
24;Centre-Val de Loire;28;1;05;122;Dammarie;1512;23;1535
24;Centre-Val de Loire;28;2;03;123;Dampierre-sous-Brou;457;8;465
24;Centre-Val de Loire;28;3;14;124;Dampierre-sur-Avre;739;20;759
24;Centre-Val de Loire;28;2;07;126;Dancy;202;4;206
24;Centre-Val de Loire;28;2;07;127;Dangeau;1267;27;1294
24;Centre-Val de Loire;28;1;11;128;Dangers;432;5;437
24;Centre-Val de Loire;28;1;02;129;Denonville;758;19;777
24;Centre-Val de Loire;28;3;14;130;Digny;992;13;1005
24;Centre-Val de Loire;28;2;07;132;Donnemain-Saint-Mamès;671;16;687
24;Centre-Val de Loire;28;3;99;134;Dreux;30664;530;31194
24;Centre-Val de Loire;28;1;10;135;Droue-sur-Drouette;1231;57;1288
24;Centre-Val de Loire;28;3;09;136;Écluzelles;166;5;171
24;Centre-Val de Loire;28;1;02;137;Écrosnes;847;17;864
24;Centre-Val de Loire;28;1;15;406;Éole-en-Beauce ;1240;19;1259
24;Centre-Val de Loire;28;1;11;139;Épeautrolles;188;2;190
24;Centre-Val de Loire;28;1;10;140;Épernon;5592;67;5659
24;Centre-Val de Loire;28;1;11;141;Ermenonville-la-Grande;316;11;327
24;Centre-Val de Loire;28;1;11;142;Ermenonville-la-Petite;187;2;189
24;Centre-Val de Loire;28;3;14;143;Escorpain;247;3;250
24;Centre-Val de Loire;28;4;03;144;Les Étilleux;216;7;223
24;Centre-Val de Loire;28;3;10;146;Faverolles;857;11;868
24;Centre-Val de Loire;28;3;14;147;Favières;589;10;599
24;Centre-Val de Loire;28;1;11;148;Le Favril;369;11;380
24;Centre-Val de Loire;28;3;14;149;La Ferté-Vidame;660;19;679
24;Centre-Val de Loire;28;3;14;151;Fessanvilliers-Mattanvilliers;176;5;181
24;Centre-Val de Loire;28;2;07;153;Flacey;209;7;216
24;Centre-Val de Loire;28;1;11;154;Fontaine-la-Guyon;1684;33;1717
24;Centre-Val de Loire;28;3;14;155;Fontaine-les-Ribouts;205;2;207
24;Centre-Val de Loire;28;4;13;156;Fontaine-Simon;911;16;927
24;Centre-Val de Loire;28;2;15;157;Fontenay-sur-Conie;124;4;128
24;Centre-Val de Loire;28;1;12;158;Fontenay-sur-Eure;1048;27;1075
24;Centre-Val de Loire;28;3;14;159;La Framboisière;340;4;344
24;Centre-Val de Loire;28;1;02;160;Francourville;833;8;841
24;Centre-Val de Loire;28;4;03;161;Frazé;502;7;509
24;Centre-Val de Loire;28;1;15;164;Fresnay-l'Évêque;737;10;747
24;Centre-Val de Loire;28;1;05;162;Fresnay-le-Comte;315;5;320
24;Centre-Val de Loire;28;1;04;163;Fresnay-le-Gilmert;207;3;210
24;Centre-Val de Loire;28;4;11;166;Friaize;249;2;251
24;Centre-Val de Loire;28;1;11;167;Fruncé;395;6;401
24;Centre-Val de Loire;28;1;02;168;Gallardon;3690;58;3748
24;Centre-Val de Loire;28;1;02;169;Garancières-en-Beauce;221;7;228
24;Centre-Val de Loire;28;3;08;170;Garancières-en-Drouais;277;6;283
24;Centre-Val de Loire;28;3;08;171;Garnay;898;21;919
24;Centre-Val de Loire;28;1;10;172;Gas;795;15;810
24;Centre-Val de Loire;28;1;04;173;Gasville-Oisème;1487;34;1521
24;Centre-Val de Loire;28;4;13;175;La Gaudaine;172;4;176
24;Centre-Val de Loire;28;2;15;176;Le Gault-Saint-Denis;675;13;688
24;Centre-Val de Loire;28;1;05;177;Gellainville;662;12;674
24;Centre-Val de Loire;28;3;01;178;Germainville;301;6;307
24;Centre-Val de Loire;28;3;01;180;Gilles;512;14;526
24;Centre-Val de Loire;28;2;03;182;Gohory;319;2;321
24;Centre-Val de Loire;28;1;15;183;Gommerville ;690;3;693
24;Centre-Val de Loire;28;1;15;184;Gouillons;341;4;345
24;Centre-Val de Loire;28;3;01;185;Goussainville;1297;22;1319
24;Centre-Val de Loire;28;3;01;187;Guainville;655;13;668
24;Centre-Val de Loire;28;1;02;188;Le Gué-de-Longroi;946;16;962
24;Centre-Val de Loire;28;1;15;189;Guilleville;179;4;183
24;Centre-Val de Loire;28;2;15;190;Guillonville;449;12;461
24;Centre-Val de Loire;28;1;10;191;Hanches;2691;57;2748
24;Centre-Val de Loire;28;4;13;192;Happonvilliers;313;3;316
24;Centre-Val de Loire;28;3;01;193;Havelu;138;3;141
24;Centre-Val de Loire;28;1;02;194;Houville-la-Branche;416;16;432
24;Centre-Val de Loire;28;1;10;195;Houx;752;22;774
24;Centre-Val de Loire;28;1;11;196;Illiers-Combray;3296;50;3346
24;Centre-Val de Loire;28;1;15;197;Intréville;145;3;148
24;Centre-Val de Loire;28;2;07;198;Jallans;808;31;839
24;Centre-Val de Loire;28;1;15;199;Janville-en-Beauce ;2571;50;2621
24;Centre-Val de Loire;28;3;14;200;Jaudrais;419;5;424
24;Centre-Val de Loire;28;1;04;201;Jouy;1951;41;1992
24;Centre-Val de Loire;28;3;14;202;Lamblore;323;6;329
24;Centre-Val de Loire;28;1;11;203;Landelles;639;7;646
24;Centre-Val de Loire;28;3;14;206;Laons;682;12;694
24;Centre-Val de Loire;28;1;02;207;Léthuin;229;4;233
24;Centre-Val de Loire;28;1;02;208;Levainville;386;14;400
24;Centre-Val de Loire;28;1;06;209;Lèves;5743;161;5904
24;Centre-Val de Loire;28;1;15;210;Levesville-la-Chenard;219;2;221
24;Centre-Val de Loire;28;2;07;211;Logron;581;7;588
24;Centre-Val de Loire;28;2;15;212;Loigny-la-Bataille;206;8;214
24;Centre-Val de Loire;28;3;10;213;Lormaye;663;10;673
24;Centre-Val de Loire;28;4;13;214;La Loupe;3334;81;3415
24;Centre-Val de Loire;28;1;15;215;Louville-la-Chenard;253;6;259
24;Centre-Val de Loire;28;3;08;216;Louvilliers-en-Drouais;200;1;201
24;Centre-Val de Loire;28;3;14;217;Louvilliers-lès-Perche;181;2;183
24;Centre-Val de Loire;28;1;12;218;Lucé;15435;220;15655
24;Centre-Val de Loire;28;4;03;219;Luigny;366;9;375
24;Centre-Val de Loire;28;1;12;220;Luisant;6673;319;6992
24;Centre-Val de Loire;28;2;15;221;Lumeau;145;8;153
24;Centre-Val de Loire;28;1;11;222;Luplanté;385;6;391
24;Centre-Val de Loire;28;3;09;223;Luray;1531;22;1553
24;Centre-Val de Loire;28;1;11;225;Magny;649;11;660
24;Centre-Val de Loire;28;3;14;226;Maillebois;912;16;928
24;Centre-Val de Loire;28;1;10;227;Maintenon;4374;80;4454
24;Centre-Val de Loire;28;1;06;229;Mainvilliers;11087;260;11347
24;Centre-Val de Loire;28;1;02;230;Maisons;379;7;386
24;Centre-Val de Loire;28;3;14;231;La Mancelière;182;3;185
24;Centre-Val de Loire;28;4;13;232;Manou;590;30;620
24;Centre-Val de Loire;28;2;07;233;Marboué;1151;26;1177
24;Centre-Val de Loire;28;1;11;234;Marchéville;473;11;484
24;Centre-Val de Loire;28;3;01;235;Marchezais;357;3;360
24;Centre-Val de Loire;28;4;13;237;Marolles-les-Buis;209;4;213
24;Centre-Val de Loire;28;3;08;239;Marville-Moutiers-Brûlé;983;25;1008
24;Centre-Val de Loire;28;4;13;240;Meaucé;528;8;536
24;Centre-Val de Loire;28;1;11;242;Méréglise;99;3;102
24;Centre-Val de Loire;28;1;15;243;Mérouville;216;6;222
24;Centre-Val de Loire;28;1;11;245;Meslay-le-Grenet;352;9;361
24;Centre-Val de Loire;28;2;15;246;Meslay-le-Vidame;526;9;535
24;Centre-Val de Loire;28;3;01;247;Le Mesnil-Simon;568;15;583
24;Centre-Val de Loire;28;3;14;248;Le Mesnil-Thomas;332;6;338
24;Centre-Val de Loire;28;1;10;249;Mévoisins;618;18;636
24;Centre-Val de Loire;28;3;09;251;Mézières-en-Drouais;1067;27;1094
24;Centre-Val de Loire;28;4;03;252;Miermaigne;192;3;195
24;Centre-Val de Loire;28;1;05;253;Mignières;1068;84;1152
24;Centre-Val de Loire;28;1;11;254;Mittainvilliers-Vérigny;798;13;811
24;Centre-Val de Loire;28;1;02;255;Moinville-la-Jeulin;170;0;170
24;Centre-Val de Loire;28;2;07;256;Moléans;455;14;469
24;Centre-Val de Loire;28;1;02;257;Mondonville-Saint-Jean;87;2;89
24;Centre-Val de Loire;28;2;07;259;Montboissier;326;5;331
24;Centre-Val de Loire;28;2;07;260;Montharville;99;5;104
24;Centre-Val de Loire;28;4;03;261;Montigny-le-Chartif;608;12;620
24;Centre-Val de Loire;28;3;14;263;Montigny-sur-Avre;255;7;262
24;Centre-Val de Loire;28;4;13;264;Montireau;139;5;144
24;Centre-Val de Loire;28;4;13;265;Montlandon;247;2;249
24;Centre-Val de Loire;28;3;01;267;Montreuil;508;5;513
24;Centre-Val de Loire;28;1;02;268;Morainville;18;2;20
24;Centre-Val de Loire;28;1;05;269;Morancez;1904;41;1945
24;Centre-Val de Loire;28;2;07;270;Moriers;224;4;228
24;Centre-Val de Loire;28;3;14;271;Morvilliers;146;4;150
24;Centre-Val de Loire;28;2;03;272;Mottereau;162;3;165
24;Centre-Val de Loire;28;4;03;273;Moulhard;140;2;142
24;Centre-Val de Loire;28;1;15;274;Moutiers;245;6;251
24;Centre-Val de Loire;28;3;10;275;Néron;657;15;672
24;Centre-Val de Loire;28;1;15;276;Neuvy-en-Beauce;210;8;218
24;Centre-Val de Loire;28;2;15;277;Neuvy-en-Dunois;308;13;321
24;Centre-Val de Loire;28;1;05;278;Nogent-le-Phaye;1474;34;1508
24;Centre-Val de Loire;28;3;10;279;Nogent-le-Roi;4032;66;4098
24;Centre-Val de Loire;28;4;13;280;Nogent-le-Rotrou;9610;451;10061
24;Centre-Val de Loire;28;1;11;281;Nogent-sur-Eure;503;9;512
24;Centre-Val de Loire;28;4;13;282;Nonvilliers-Grandhoux;430;11;441
24;Centre-Val de Loire;28;2;15;283;Nottonville;295;5;300
24;Centre-Val de Loire;28;1;15;284;Oinville-Saint-Liphard;277;9;286
24;Centre-Val de Loire;28;1;02;285;Oinville-sous-Auneau;346;9;355
24;Centre-Val de Loire;28;1;11;286;Ollé;617;15;632
24;Centre-Val de Loire;28;2;15;287;Orgères-en-Beauce;1028;15;1043
24;Centre-Val de Loire;28;3;09;289;Ormoy;227;6;233
24;Centre-Val de Loire;28;1;11;290;Orrouer;294;9;303
24;Centre-Val de Loire;28;1;15;291;Ouarville;530;16;546
24;Centre-Val de Loire;28;3;09;292;Ouerre;734;16;750
24;Centre-Val de Loire;28;3;01;293;Oulins;1201;28;1229
24;Centre-Val de Loire;28;1;02;294;Oysonville;524;13;537
24;Centre-Val de Loire;28;2;15;296;Péronville;270;4;274
24;Centre-Val de Loire;28;1;10;298;Pierres;2769;57;2826
24;Centre-Val de Loire;28;3;10;299;Les Pinthières;175;6;181
24;Centre-Val de Loire;28;1;15;300;Poinville;148;6;154
24;Centre-Val de Loire;28;1;04;301;Poisvilliers;444;6;450
24;Centre-Val de Loire;28;1;11;302;Pontgouin;1097;325;1422
24;Centre-Val de Loire;28;2;15;303;Poupry;106;3;109
24;Centre-Val de Loire;28;1;15;304;Prasville;432;6;438
24;Centre-Val de Loire;28;2;15;305;Pré-Saint-Évroult;296;5;301
24;Centre-Val de Loire;28;2;15;306;Pré-Saint-Martin;203;6;209
24;Centre-Val de Loire;28;3;14;308;Prudemanche;258;11;269
24;Centre-Val de Loire;28;1;05;309;Prunay-le-Gillon;1073;16;1089
24;Centre-Val de Loire;28;3;14;310;La Puisaye;270;6;276
24;Centre-Val de Loire;28;3;14;312;Puiseux;133;2;135
24;Centre-Val de Loire;28;1;15;313;Réclainville;192;1;193
24;Centre-Val de Loire;28;3;14;314;Les Ressuintes;118;8;126
24;Centre-Val de Loire;28;3;14;315;Revercourt;23;1;24
24;Centre-Val de Loire;28;3;14;316;Rohaire;127;3;130
24;Centre-Val de Loire;28;1;02;317;Roinville;564;4;568
24;Centre-Val de Loire;28;1;15;319;Rouvray-Saint-Denis;404;14;418
24;Centre-Val de Loire;28;3;01;321;Rouvres;838;14;852
24;Centre-Val de Loire;28;3;14;322;Rueil-la-Gadelière;502;9;511
24;Centre-Val de Loire;28;3;14;323;Saint-Ange-et-Torçay;286;1;287
24;Centre-Val de Loire;28;1;11;324;Saint-Arnoult-des-Bois;887;23;910
24;Centre-Val de Loire;28;1;06;325;Saint-Aubin-des-Bois;1038;26;1064
24;Centre-Val de Loire;28;2;11;326;Saint-Avit-les-Guespières;362;2;364
24;Centre-Val de Loire;28;4;03;327;Saint-Bomer;193;2;195
24;Centre-Val de Loire;28;2;07;329;Saint-Christophe;159;2;161
24;Centre-Val de Loire;28;1;11;333;Saint-Denis-des-Puits;139;4;143
24;Centre-Val de Loire;28;2;07;334;Saint-Denis-Lanneray ;2219;54;2273
24;Centre-Val de Loire;28;4;13;335;Saint-Éliph;866;24;890
24;Centre-Val de Loire;28;1;11;336;Saint-Éman;108;1;109
24;Centre-Val de Loire;28;1;11;337;Saint-Georges-sur-Eure;2809;67;2876
24;Centre-Val de Loire;28;1;11;339;Saint-Germain-le-Gaillard;350;11;361
24;Centre-Val de Loire;28;3;14;341;Saint-Jean-de-Rebervilliers;248;5;253
24;Centre-Val de Loire;28;4;13;342;Saint-Jean-Pierre-Fixte;261;5;266
24;Centre-Val de Loire;28;3;10;343;Saint-Laurent-la-Gâtine;441;11;452
24;Centre-Val de Loire;28;1;02;344;Saint-Léger-des-Aubées;263;10;273
24;Centre-Val de Loire;28;3;14;346;Saint-Lubin-de-Cravant;57;3;60
24;Centre-Val de Loire;28;3;01;347;Saint-Lubin-de-la-Haye;945;30;975
24;Centre-Val de Loire;28;3;14;348;Saint-Lubin-des-Joncherets;3996;70;4066
24;Centre-Val de Loire;28;3;10;349;Saint-Lucien;256;8;264
24;Centre-Val de Loire;28;1;11;350;Saint-Luperce;924;21;945
24;Centre-Val de Loire;28;3;14;351;Saint-Maixme-Hauterive;411;8;419
24;Centre-Val de Loire;28;1;10;352;Saint-Martin-de-Nigelles;1568;41;1609
24;Centre-Val de Loire;28;2;07;353;Saint-Maur-sur-le-Loir;404;5;409
24;Centre-Val de Loire;28;4;13;354;Saint-Maurice-Saint-Germain;415;69;484
24;Centre-Val de Loire;28;3;01;355;Saint-Ouen-Marchefroy;296;9;305
24;Centre-Val de Loire;28;1;10;357;Saint-Piat;1055;30;1085
24;Centre-Val de Loire;28;1;04;358;Saint-Prest;2052;67;2119
24;Centre-Val de Loire;28;3;14;359;Saint-Rémy-sur-Avre;4032;46;4078
24;Centre-Val de Loire;28;3;14;360;Saint-Sauveur-Marville;924;17;941
24;Centre-Val de Loire;28;4;13;362;Saint-Victor-de-Buthon;506;12;518
24;Centre-Val de Loire;28;3;09;332;Sainte-Gemme-Moronval;1092;21;1113
24;Centre-Val de Loire;28;4;13;331;Saintigny;996;20;1016
24;Centre-Val de Loire;28;1;02;363;Sainville;1026;13;1039
24;Centre-Val de Loire;28;2;15;364;Sancheville;779;13;792
24;Centre-Val de Loire;28;1;11;365;Sandarville;409;9;418
24;Centre-Val de Loire;28;1;02;366;Santeuil;320;3;323
24;Centre-Val de Loire;28;1;15;367;Santilly;333;6;339
24;Centre-Val de Loire;28;3;14;368;La Saucelle;197;3;200
24;Centre-Val de Loire;28;3;08;369;Saulnières;717;9;726
24;Centre-Val de Loire;28;2;07;370;Saumeray;499;11;510
24;Centre-Val de Loire;28;3;01;371;Saussay;1100;20;1120
24;Centre-Val de Loire;28;3;10;372;Senantes;572;12;584
24;Centre-Val de Loire;28;3;14;373;Senonches;3060;48;3108
24;Centre-Val de Loire;28;3;14;374;Serazereux;542;3;545
24;Centre-Val de Loire;28;3;01;375;Serville;369;6;375
24;Centre-Val de Loire;28;3;01;377;Sorel-Moussel;1783;44;1827
24;Centre-Val de Loire;28;4;13;378;Souancé-au-Perche;527;11;538
24;Centre-Val de Loire;28;1;10;379;Soulaires;461;10;471
24;Centre-Val de Loire;28;1;05;380;Sours;1984;171;2155
24;Centre-Val de Loire;28;2;15;382;Terminiers;891;15;906
24;Centre-Val de Loire;28;1;15;383;Theuville;707;6;713
24;Centre-Val de Loire;28;4;11;385;Le Thieulin;452;34;486
24;Centre-Val de Loire;28;3;14;386;Thimert-Gâtelles;1245;21;1266
24;Centre-Val de Loire;28;4;13;387;Thiron-Gardais;985;11;996
24;Centre-Val de Loire;28;1;05;388;Thivars;1052;32;1084
24;Centre-Val de Loire;28;2;07;389;Thiville;342;8;350
24;Centre-Val de Loire;28;2;15;390;Tillay-le-Péneux;319;6;325
24;Centre-Val de Loire;28;1;15;391;Toury;2587;32;2619
24;Centre-Val de Loire;28;1;15;392;Trancrainville;163;2;165
24;Centre-Val de Loire;28;3;14;393;Tremblay-les-Villages;2257;66;2323
24;Centre-Val de Loire;28;3;08;394;Tréon;1412;28;1440
24;Centre-Val de Loire;28;4;13;395;Trizay-Coutretot-Saint-Serge;439;14;453
24;Centre-Val de Loire;28;2;07;396;Trizay-lès-Bonneval;313;4;317
24;Centre-Val de Loire;28;1;02;397;Umpeau;402;13;415
24;Centre-Val de Loire;28;2;03;398;Unverre;1181;22;1203
24;Centre-Val de Loire;28;2;15;400;Varize;195;8;203
24;Centre-Val de Loire;28;4;13;401;Vaupillon;455;8;463
24;Centre-Val de Loire;28;1;05;403;Ver-lès-Chartres;776;21;797
24;Centre-Val de Loire;28;3;08;404;Vernouillet;12522;151;12673
24;Centre-Val de Loire;28;3;08;405;Vert-en-Drouais;1075;21;1096
24;Centre-Val de Loire;28;4;13;407;Vichères;297;8;305
24;Centre-Val de Loire;28;1;02;408;Vierville;126;3;129
24;Centre-Val de Loire;28;2;11;409;Vieuvicq;465;16;481
24;Centre-Val de Loire;28;1;15;422;Les Villages Vovéens;3907;61;3968
24;Centre-Val de Loire;28;2;07;410;Villampuy;305;4;309
24;Centre-Val de Loire;28;1;15;411;Villars;173;2;175
24;Centre-Val de Loire;28;1;11;414;Villebon;70;6;76
24;Centre-Val de Loire;28;2;07;330;Villemaury ;1383;33;1416
24;Centre-Val de Loire;28;3;09;415;Villemeux-sur-Eure;1665;31;1696
24;Centre-Val de Loire;28;3;10;417;Villiers-le-Morhier;1339;28;1367
24;Centre-Val de Loire;28;2;07;418;Villiers-Saint-Orien;163;5;168
24;Centre-Val de Loire;28;2;15;419;Vitray-en-Beauce;350;8;358
24;Centre-Val de Loire;28;1;02;421;Voise;277;5;282
24;Centre-Val de Loire;28;1;02;423;Yermenonville;598;14;612
24;Centre-Val de Loire;28;2;03;424;Yèvres;1630;39;1669
24;Centre-Val de Loire;28;1;02;425;Ymeray;594;11;605
24;Centre-Val de Loire;28;1;15;426;Ymonville;501;9;510
53;Bretagne;29;2;09;001;Argol;992;18;1010
53;Bretagne;29;4;25;002;Arzano;1377;33;1410
53;Bretagne;29;4;10;003;Audierne;3692;66;3758
53;Bretagne;29;4;16;004;Bannalec;5663;158;5821
53;Bretagne;29;4;25;005;Baye;1198;30;1228
53;Bretagne;29;4;11;006;Bénodet;3584;62;3646
53;Bretagne;29;2;07;007;Berrien;907;31;938
53;Bretagne;29;4;10;008;Beuzec-Cap-Sizun;999;21;1020
53;Bretagne;29;3;14;010;Bodilis;1628;34;1662
53;Bretagne;29;1;04;011;Bohars;3516;85;3601
53;Bretagne;29;2;07;012;Bolazec;196;2;198
53;Bretagne;29;2;07;013;Botmeur;216;6;222
53;Bretagne;29;3;20;014;Botsorhel;428;8;436
53;Bretagne;29;1;18;015;Bourg-Blanc;3560;63;3623
53;Bretagne;29;2;07;016;Brasparts;1026;11;1037
53;Bretagne;29;1;27;017;Brélès;868;27;895
53;Bretagne;29;2;07;018;Brennilis;437;5;442
53;Bretagne;29;1;98;019;Brest;139602;2676;142278
53;Bretagne;29;4;06;020;Briec;5633;113;5746
53;Bretagne;29;2;09;022;Camaret-sur-Mer;2504;55;2559
53;Bretagne;29;3;17;023;Carantec;3173;103;3276
53;Bretagne;29;2;07;024;Carhaix-Plouguer;7164;612;7776
53;Bretagne;29;2;09;025;Cast;1545;45;1590
53;Bretagne;29;2;09;026;Châteaulin;5189;440;5629
53;Bretagne;29;2;06;027;Châteauneuf-du-Faou;3665;100;3765
53;Bretagne;29;4;10;028;Cléden-Cap-Sizun;933;20;953
53;Bretagne;29;2;07;029;Cléden-Poher;1151;18;1169
53;Bretagne;29;3;26;030;Cléder;3731;117;3848
53;Bretagne;29;4;25;031;Clohars-Carnoët;4432;111;4543
53;Bretagne;29;4;11;032;Clohars-Fouesnant;2068;50;2118
53;Bretagne;29;2;06;033;Le Cloître-Pleyben;527;10;537
53;Bretagne;29;3;20;034;Le Cloître-Saint-Thégonnec;659;6;665
53;Bretagne;29;1;18;035;Coat-Méal;1107;18;1125
53;Bretagne;29;2;07;036;Collorec;609;7;616
53;Bretagne;29;4;19;037;Combrit;4138;123;4261
53;Bretagne;29;3;14;038;Commana;1017;26;1043
53;Bretagne;29;4;08;039;Concarneau;19502;852;20354
53;Bretagne;29;4;10;145;Confort-Meilars;876;28;904
53;Bretagne;29;1;27;040;Le Conquet;2731;75;2806
53;Bretagne;29;2;06;041;Coray;1893;31;1924
53;Bretagne;29;2;09;042;Crozon;7415;220;7635
53;Bretagne;29;1;21;043;Daoulas;1802;45;1847
53;Bretagne;29;2;09;044;Dinéault;2069;39;2108
53;Bretagne;29;1;21;045;Dirinon;2228;67;2295
53;Bretagne;29;4;10;046;Douarnenez;14015;368;14383
53;Bretagne;29;1;15;047;Le Drennec;1855;35;1890
53;Bretagne;29;4;06;048;Edern;2244;43;2287
53;Bretagne;29;4;08;049;Elliant;3307;141;3448
53;Bretagne;29;4;11;051;Ergué-Gabéric;8313;200;8513
53;Bretagne;29;2;21;053;Le Faou;1735;41;1776
53;Bretagne;29;2;07;054;La Feuillée;643;15;658
53;Bretagne;29;1;15;055;Le Folgoët;3211;78;3289
53;Bretagne;29;1;13;056;La Forest-Landerneau;1913;31;1944
53;Bretagne;29;4;11;057;La Forêt-Fouesnant;3401;120;3521
53;Bretagne;29;4;11;058;Fouesnant;9668;475;10143
53;Bretagne;29;3;20;059;Garlan;1051;32;1083
53;Bretagne;29;4;11;060;Gouesnach;2778;79;2857
53;Bretagne;29;1;04;061;Gouesnou;6166;133;6299
53;Bretagne;29;2;06;062;Gouézec;1097;35;1132
53;Bretagne;29;4;10;063;Goulien;432;7;439
53;Bretagne;29;1;15;064;Goulven;445;4;449
53;Bretagne;29;4;19;065;Gourlizon;901;15;916
53;Bretagne;29;4;23;066;Guengat;1805;30;1835
53;Bretagne;29;3;20;067;Guerlesquin;1314;41;1355
53;Bretagne;29;3;14;068;Guiclan;2493;52;2545
53;Bretagne;29;4;19;070;Guiler-sur-Goyen;526;10;536
53;Bretagne;29;1;04;069;Guilers;7987;158;8145
53;Bretagne;29;4;25;071;Guilligomarc'h;779;3;782
53;Bretagne;29;4;22;072;Guilvinec;2670;48;2718
53;Bretagne;29;3;20;073;Guimaëc;942;34;976
53;Bretagne;29;3;14;074;Guimiliau;1007;17;1024
53;Bretagne;29;1;12;075;Guipavas;14842;352;15194
53;Bretagne;29;1;15;077;Guissény;1999;47;2046
53;Bretagne;29;1;21;078;Hanvec;2029;46;2075
53;Bretagne;29;3;17;079;Henvic;1309;45;1354
53;Bretagne;29;1;21;080;Hôpital-Camfrout;2239;70;2309
53;Bretagne;29;2;07;081;Huelgoat;1409;27;1436
53;Bretagne;29;3;26;082;Île-de-Batz;455;13;468
53;Bretagne;29;4;10;083;Île-de-Sein;255;2;257
53;Bretagne;29;1;27;084;Île-Molène;151;6;157
53;Bretagne;29;4;19;085;Île-Tudy;735;18;753
53;Bretagne;29;1;21;086;Irvillac;1442;22;1464
53;Bretagne;29;4;10;087;Le Juch;723;16;739
53;Bretagne;29;2;07;089;Kergloff;871;23;894
53;Bretagne;29;4;10;090;Kerlaz;783;25;808
53;Bretagne;29;1;15;091;Kerlouan;2106;39;2145
53;Bretagne;29;1;15;093;Kernilis;1437;31;1468
53;Bretagne;29;1;15;094;Kernouës;677;15;692
53;Bretagne;29;1;18;095;Kersaint-Plabennec;1474;26;1500
53;Bretagne;29;3;14;097;Lampaul-Guimiliau;2043;53;2096
53;Bretagne;29;1;27;098;Lampaul-Plouarzel;2128;53;2181
53;Bretagne;29;1;18;099;Lampaul-Ploudalmézeau;830;22;852
53;Bretagne;29;1;15;100;Lanarvily;418;12;430
53;Bretagne;29;1;18;101;Landéda;3572;111;3683
53;Bretagne;29;2;07;102;Landeleau;948;12;960
53;Bretagne;29;1;13;103;Landerneau;15914;613;16527
53;Bretagne;29;2;09;104;Landévennec;341;6;347
53;Bretagne;29;3;14;105;Landivisiau;9142;320;9462
53;Bretagne;29;4;06;106;Landrévarzec;1846;41;1887
53;Bretagne;29;4;06;107;Landudal;881;13;894
53;Bretagne;29;4;19;108;Landudec;1454;39;1493
53;Bretagne;29;1;18;109;Landunvez;1481;36;1517
53;Bretagne;29;4;06;110;Langolen;869;14;883
53;Bretagne;29;3;26;111;Lanhouarneau;1309;24;1333
53;Bretagne;29;1;27;112;Lanildut;960;18;978
53;Bretagne;29;3;20;113;Lanmeur;2307;38;2345
53;Bretagne;29;3;20;114;Lannéanou;364;7;371
53;Bretagne;29;2;06;115;Lannédern;292;4;296
53;Bretagne;29;1;13;116;Lanneuffret;152;2;154
53;Bretagne;29;1;18;117;Lannilis;5651;117;5768
53;Bretagne;29;1;27;119;Lanrivoaré;1469;36;1505
53;Bretagne;29;2;09;120;Lanvéoc;2033;65;2098
53;Bretagne;29;2;06;122;Laz;668;16;684
53;Bretagne;29;2;06;123;Lennon;791;20;811
53;Bretagne;29;1;15;124;Lesneven;7306;229;7535
53;Bretagne;29;2;06;125;Leuhan;830;18;848
53;Bretagne;29;1;15;126;Loc-Brévalaire;206;6;212
53;Bretagne;29;3;14;128;Loc-Eguiner;404;6;410
53;Bretagne;29;1;27;130;Locmaria-Plouzané;5089;130;5219
53;Bretagne;29;3;14;131;Locmélar;472;14;486
53;Bretagne;29;3;17;132;Locquénolé;791;30;821
53;Bretagne;29;3;20;133;Locquirec;1510;43;1553
53;Bretagne;29;4;23;134;Locronan;785;26;811
53;Bretagne;29;4;22;135;Loctudy;4050;108;4158
53;Bretagne;29;4;25;136;Locunolé;1156;23;1179
53;Bretagne;29;1;21;137;Logonna-Daoulas;2126;52;2178
53;Bretagne;29;2;07;139;Lopérec;867;141;1008
53;Bretagne;29;1;21;140;Loperhet;3835;85;3920
53;Bretagne;29;2;07;141;Loqueffret;354;4;358
53;Bretagne;29;2;06;142;Lothey;455;4;459
53;Bretagne;29;4;10;143;Mahalon;963;21;984
53;Bretagne;29;1;21;144;La Martyre;744;9;753
53;Bretagne;29;4;08;146;Melgven;3396;49;3445
53;Bretagne;29;4;25;147;Mellac;3183;78;3261
53;Bretagne;29;3;26;148;Mespaul;955;31;986
53;Bretagne;29;1;27;076;Milizac-Guipronvel;4521;65;4586
53;Bretagne;29;4;16;150;Moëlan-sur-Mer;6765;133;6898
53;Bretagne;29;3;17;151;Morlaix;14729;475;15204
53;Bretagne;29;2;07;152;Motreff;701;15;716
53;Bretagne;29;4;16;153;Névez;2673;52;2725
53;Bretagne;29;1;27;155;Ouessant;834;19;853
53;Bretagne;29;1;13;156;Pencran;2010;42;2052
53;Bretagne;29;4;22;158;Penmarch;5142;103;5245
53;Bretagne;29;4;19;159;Peumerit;824;16;840
53;Bretagne;29;1;18;160;Plabennec;8465;163;8628
53;Bretagne;29;4;11;161;Pleuven;3087;79;3166
53;Bretagne;29;2;06;162;Pleyben;3656;265;3921
53;Bretagne;29;3;17;163;Pleyber-Christ;3161;76;3237
53;Bretagne;29;4;22;165;Plobannalec-Lesconil;3521;85;3606
53;Bretagne;29;2;09;166;Ploéven;514;19;533
53;Bretagne;29;4;19;167;Plogastel-Saint-Germain;1978;44;2022
53;Bretagne;29;4;10;168;Plogoff;1229;20;1249
53;Bretagne;29;4;23;169;Plogonnec;3154;75;3229
53;Bretagne;29;4;23;170;Plomelin;4187;164;4351
53;Bretagne;29;4;19;171;Plomeur;3800;74;3874
53;Bretagne;29;2;09;172;Plomodiern;2191;66;2257
53;Bretagne;29;4;23;173;Plonéis;2464;55;2519
53;Bretagne;29;4;19;174;Plonéour-Lanvern;6147;185;6332
53;Bretagne;29;2;07;175;Plonévez-du-Faou;2106;51;2157
53;Bretagne;29;2;09;176;Plonévez-Porzay;1762;43;1805
53;Bretagne;29;1;27;177;Plouarzel;3784;89;3873
53;Bretagne;29;1;18;178;Ploudalmézeau;6292;128;6420
53;Bretagne;29;1;15;179;Ploudaniel;3719;117;3836
53;Bretagne;29;1;21;180;Ploudiry;933;23;956
53;Bretagne;29;1;13;181;Plouédern;2878;70;2948
53;Bretagne;29;3;20;182;Plouégat-Guérand;1064;22;1086
53;Bretagne;29;3;20;183;Plouégat-Moysan;713;9;722
53;Bretagne;29;3;26;184;Plouénan;2520;57;2577
53;Bretagne;29;3;26;185;Plouescat;3471;93;3564
53;Bretagne;29;3;20;186;Plouezoc'h;1600;60;1660
53;Bretagne;29;3;14;187;Plougar;788;28;816
53;Bretagne;29;3;20;188;Plougasnou;2757;123;2880
53;Bretagne;29;1;12;189;Plougastel-Daoulas;13330;367;13697
53;Bretagne;29;1;27;190;Plougonvelin;4179;104;4283
53;Bretagne;29;3;20;191;Plougonven;3477;95;3572
53;Bretagne;29;3;26;192;Plougoulm;1761;45;1806
53;Bretagne;29;3;14;193;Plougourvest;1413;28;1441
53;Bretagne;29;1;15;195;Plouguerneau;6623;129;6752
53;Bretagne;29;1;18;196;Plouguin;2160;42;2202
53;Bretagne;29;4;10;197;Plouhinec;3960;120;4080
53;Bretagne;29;1;15;198;Plouider;1852;47;1899
53;Bretagne;29;3;20;199;Plouigneau ;5084;180;5264
53;Bretagne;29;1;27;201;Ploumoguer;2059;37;2096
53;Bretagne;29;1;15;021;Plounéour-Brignogan-plages ;1913;49;1962
53;Bretagne;29;3;17;202;Plounéour-Ménez;1263;35;1298
53;Bretagne;29;3;14;204;Plounéventer;2084;35;2119
53;Bretagne;29;3;26;206;Plounévez-Lochrist;2280;96;2376
53;Bretagne;29;2;07;205;Plounévézel;1201;26;1227
53;Bretagne;29;1;27;208;Plourin;1241;29;1270
53;Bretagne;29;3;20;207;Plourin-lès-Morlaix;4489;289;4778
53;Bretagne;29;1;18;209;Plouvien;3785;103;3888
53;Bretagne;29;3;14;210;Plouvorn;2866;72;2938
53;Bretagne;29;2;07;211;Plouyé;662;18;680
53;Bretagne;29;1;03;212;Plouzané;12979;240;13219
53;Bretagne;29;3;14;213;Plouzévédé;1761;40;1801
53;Bretagne;29;4;19;214;Plovan;680;26;706
53;Bretagne;29;4;19;215;Plozévet;2955;74;3029
53;Bretagne;29;4;23;216;Pluguffan;4157;102;4259
53;Bretagne;29;4;16;217;Pont-Aven;2811;58;2869
53;Bretagne;29;4;10;218;Pont-Croix;1570;31;1601
53;Bretagne;29;2;21;302;Pont-de-Buis-lès-Quimerch;3716;142;3858
53;Bretagne;29;4;22;220;Pont-l'Abbé;8310;396;8706
53;Bretagne;29;1;27;221;Porspoder;1795;54;1849
53;Bretagne;29;2;09;222;Port-Launay;395;7;402
53;Bretagne;29;4;10;224;Pouldergat;1208;26;1234
53;Bretagne;29;4;19;225;Pouldreuzic;2165;45;2210
53;Bretagne;29;4;10;226;Poullan-sur-Mer;1516;96;1612
53;Bretagne;29;2;07;227;Poullaouen ;1490;32;1522
53;Bretagne;29;4;10;228;Primelin;679;17;696
53;Bretagne;29;4;09;229;Quéménéven;1116;34;1150
53;Bretagne;29;4;25;230;Querrien;1713;33;1746
53;Bretagne;29;4;99;232;Quimper;63166;2472;65638
53;Bretagne;29;4;25;233;Quimperlé;12188;457;12645
53;Bretagne;29;4;25;234;Rédené;2907;62;2969
53;Bretagne;29;1;12;235;Le Relecq-Kerhuon;11625;232;11857
53;Bretagne;29;4;16;236;Riec-sur-Bélon;4172;117;4289
53;Bretagne;29;1;13;237;La Roche-Maurice;1797;45;1842
53;Bretagne;29;2;09;238;Roscanvel;837;29;866
53;Bretagne;29;3;26;239;Roscoff;3447;84;3531
53;Bretagne;29;2;21;240;Rosnoën;958;26;984
53;Bretagne;29;4;08;241;Rosporden;7633;162;7795
53;Bretagne;29;2;09;243;Saint-Coulitz;451;10;461
53;Bretagne;29;3;14;244;Saint-Derrien;813;13;826
53;Bretagne;29;1;13;245;Saint-Divy;1540;21;1561
53;Bretagne;29;1;21;246;Saint-Eloy;211;5;216
53;Bretagne;29;4;11;247;Saint-Évarzec;3516;113;3629
53;Bretagne;29;1;15;248;Saint-Frégant;834;8;842
53;Bretagne;29;2;06;249;Saint-Goazec;710;10;720
53;Bretagne;29;2;07;250;Saint-Hernin;757;17;774
53;Bretagne;29;3;20;251;Saint-Jean-du-Doigt;648;12;660
53;Bretagne;29;4;19;252;Saint-Jean-Trolimon;944;26;970
53;Bretagne;29;3;17;254;Saint-Martin-des-Champs;4626;146;4772
53;Bretagne;29;1;15;255;Saint-Méen;922;20;942
53;Bretagne;29;2;09;256;Saint-Nic;767;20;787
53;Bretagne;29;1;18;257;Saint-Pabu;2072;62;2134
53;Bretagne;29;3;26;259;Saint-Pol-de-Léon;6603;242;6845
53;Bretagne;29;1;27;260;Saint-Renan;8122;194;8316
53;Bretagne;29;2;07;261;Saint-Rivoal;201;3;204
53;Bretagne;29;3;14;262;Saint-Sauveur;786;10;796
53;Bretagne;29;2;21;263;Saint-Ségal;1110;16;1126
53;Bretagne;29;3;14;264;Saint-Servais;781;11;792
53;Bretagne;29;3;17;266;Saint-Thégonnec Loc-Eguiner;3035;77;3112
53;Bretagne;29;2;06;267;Saint-Thois;718;18;736
53;Bretagne;29;1;13;268;Saint-Thonan;1875;36;1911
53;Bretagne;29;4;25;269;Saint-Thurien;1037;15;1052
53;Bretagne;29;1;21;270;Saint-Urbain;1641;35;1676
53;Bretagne;29;3;14;271;Saint-Vougay;898;33;931
53;Bretagne;29;4;08;272;Saint-Yvi;3202;67;3269
53;Bretagne;29;3;17;265;Sainte-Sève;1030;31;1061
53;Bretagne;29;3;26;273;Santec;2401;78;2479
53;Bretagne;29;4;16;274;Scaër;5345;112;5457
53;Bretagne;29;2;07;275;Scrignac;734;19;753
53;Bretagne;29;3;26;276;Sibiril;1200;29;1229
53;Bretagne;29;3;14;277;Sizun;2271;77;2348
53;Bretagne;29;2;07;278;Spézet;1783;44;1827
53;Bretagne;29;3;17;279;Taulé;2914;77;2991
53;Bretagne;29;2;09;280;Telgruc-sur-Mer;2085;59;2144
53;Bretagne;29;4;08;281;Tourch;1012;27;1039
53;Bretagne;29;1;27;282;Trébabu;359;10;369
53;Bretagne;29;4;22;284;Treffiagat;2405;99;2504
53;Bretagne;29;3;26;285;Tréflaouénan;515;7;522
53;Bretagne;29;1;21;286;Tréflévénez;243;9;252
53;Bretagne;29;3;26;287;Tréflez;962;21;983
53;Bretagne;29;1;15;288;Trégarantec;605;7;612
53;Bretagne;29;2;09;289;Trégarvan;116;6;122
53;Bretagne;29;1;18;290;Tréglonou;677;15;692
53;Bretagne;29;2;06;291;Trégourez;960;18;978
53;Bretagne;29;4;19;292;Tréguennec;316;6;322
53;Bretagne;29;4;16;293;Trégunc;7039;224;7263
53;Bretagne;29;1;21;294;Le Tréhou;637;14;651
53;Bretagne;29;1;13;295;Trémaouézan;554;23;577
53;Bretagne;29;4;19;296;Tréméoc;1341;39;1380
53;Bretagne;29;4;25;297;Tréméven;2315;44;2359
53;Bretagne;29;4;19;298;Tréogat;580;11;591
53;Bretagne;29;1;27;299;Tréouergat;337;3;340
53;Bretagne;29;4;16;300;Le Trévoux;1601;51;1652
53;Bretagne;29;3;14;301;Trézilidé;386;2;388
76;Occitanie;30;2;20;001;Aigaliers;512;13;525
76;Occitanie;30;3;15;002;Aigremont;784;15;799
76;Occitanie;30;2;01;003;Aigues-Mortes;8456;79;8535
76;Occitanie;30;2;21;004;Aigues-Vives;3338;62;3400
76;Occitanie;30;2;14;005;Aiguèze;214;3;217
76;Occitanie;30;2;01;006;Aimargues;5682;52;5734
76;Occitanie;30;1;98;007;Alès;40802;610;41412
76;Occitanie;30;1;18;008;Allègre-les-Fumades;928;17;945
76;Occitanie;30;3;22;009;Alzon;172;3;175
76;Occitanie;30;1;02;010;Anduze;3382;41;3423
76;Occitanie;30;2;23;011;Les Angles;8311;201;8512
76;Occitanie;30;2;06;012;Aramon;4224;75;4299
76;Occitanie;30;2;16;013;Argilliers;469;22;491
76;Occitanie;30;2;20;014;Arpaillargues-et-Aureillac;1018;27;1045
76;Occitanie;30;3;22;015;Arphy;162;5;167
76;Occitanie;30;3;22;016;Arre;287;10;297
76;Occitanie;30;3;22;017;Arrigas;211;2;213
76;Occitanie;30;2;07;018;Aspères;507;13;520
76;Occitanie;30;2;01;019;Aubais;2843;59;2902
76;Occitanie;30;2;21;020;Aubord;2367;43;2410
76;Occitanie;30;2;20;021;Aubussargues;316;4;320
76;Occitanie;30;1;08;022;Aujac;179;7;186
76;Occitanie;30;2;07;023;Aujargues;817;17;834
76;Occitanie;30;3;22;024;Aulas;466;7;473
76;Occitanie;30;3;22;025;Aumessas;228;3;231
76;Occitanie;30;3;22;026;Avèze;1081;33;1114
76;Occitanie;30;1;02;027;Bagard;2565;62;2627
76;Occitanie;30;2;05;028;Bagnols-sur-Cèze;18072;356;18428
76;Occitanie;30;1;18;029;Barjac;1612;26;1638
76;Occitanie;30;2;20;030;Baron;361;4;365
76;Occitanie;30;2;20;031;La Bastide-d'Engras;199;2;201
76;Occitanie;30;2;06;032;Beaucaire;15718;139;15857
76;Occitanie;30;2;21;033;Beauvoisin;4905;53;4958
76;Occitanie;30;2;06;034;Bellegarde;7273;84;7357
76;Occitanie;30;2;03;035;Belvézet;242;1;243
76;Occitanie;30;2;21;036;Bernis;3425;27;3452
76;Occitanie;30;1;18;037;Bessèges;2838;33;2871
76;Occitanie;30;3;22;038;Bez-et-Esparon;330;11;341
76;Occitanie;30;2;16;039;Bezouce;2293;31;2324
76;Occitanie;30;3;22;040;Blandas;130;2;132
76;Occitanie;30;2;20;041;Blauzac;1216;21;1237
76;Occitanie;30;1;02;042;Boisset-et-Gaujac;2549;44;2593
76;Occitanie;30;2;07;043;Boissières;575;11;586
76;Occitanie;30;1;08;044;Bonnevaux;89;0;89
76;Occitanie;30;1;18;045;Bordezac;391;4;395
76;Occitanie;30;1;15;046;Boucoiran-et-Nozières;972;14;986
76;Occitanie;30;2;09;047;Bouillargues;6305;135;6440
76;Occitanie;30;1;03;048;Bouquet;179;3;182
76;Occitanie;30;2;20;049;Bourdic;377;17;394
76;Occitanie;30;3;15;050;Bragassargues;172;1;173
76;Occitanie;30;1;08;051;Branoux-les-Taillades;1338;30;1368
76;Occitanie;30;3;22;052;Bréau-Mars ;629;19;648
76;Occitanie;30;1;15;053;Brignon;778;12;790
76;Occitanie;30;1;03;055;Brouzet-lès-Alès;660;12;672
76;Occitanie;30;3;15;054;Brouzet-lès-Quissac;296;4;300
76;Occitanie;30;2;20;056;La Bruguière;329;7;336
76;Occitanie;30;2;16;057;Cabrières;1644;28;1672
76;Occitanie;30;3;22;058;La Cadière-et-Cambo;210;10;220
76;Occitanie;30;2;01;059;Le Cailar;2410;28;2438
76;Occitanie;30;2;09;060;Caissargues;4089;80;4169
76;Occitanie;30;2;20;061;La Calmette;2282;26;2308
76;Occitanie;30;2;07;062;Calvisson;5833;97;5930
76;Occitanie;30;3;22;064;Campestre-et-Luc;111;2;113
76;Occitanie;30;3;15;065;Canaules-et-Argentières;452;4;456
76;Occitanie;30;2;07;066;Cannes-et-Clairan;540;12;552
76;Occitanie;30;2;20;067;La Capelle-et-Masmolène;426;6;432
76;Occitanie;30;3;15;068;Cardet;876;22;898
76;Occitanie;30;3;15;069;Carnas;492;12;504
76;Occitanie;30;2;14;070;Carsan;718;23;741
76;Occitanie;30;3;15;071;Cassagnoles;400;2;402
76;Occitanie;30;1;04;072;Castelnau-Valence;460;10;470
76;Occitanie;30;2;16;073;Castillon-du-Gard;1665;88;1753
76;Occitanie;30;3;22;074;Causse-Bégon;22;0;22
76;Occitanie;30;2;19;075;Caveirac;4244;112;4356
76;Occitanie;30;2;05;076;Cavillargues;858;29;887
76;Occitanie;30;1;08;077;Cendras;1778;35;1813
76;Occitanie;30;1;08;079;Chambon;263;6;269
76;Occitanie;30;1;08;080;Chamborigaud;863;5;868
76;Occitanie;30;2;05;081;Chusclan;967;29;996
76;Occitanie;30;2;19;082;Clarensac;4236;97;4333
76;Occitanie;30;2;21;083;Codognan;2418;38;2456
76;Occitanie;30;2;17;084;Codolet;639;11;650
76;Occitanie;30;2;16;085;Collias;1073;15;1088
76;Occitanie;30;2;20;086;Collorgues;622;10;632
76;Occitanie;30;3;15;087;Colognac;223;6;229
76;Occitanie;30;2;07;088;Combas;631;15;646
76;Occitanie;30;2;06;089;Comps;1777;31;1808
76;Occitanie;30;1;08;090;Concoules;259;4;263
76;Occitanie;30;2;07;091;Congénies;1667;34;1701
76;Occitanie;30;2;05;092;Connaux;1683;49;1732
76;Occitanie;30;3;22;093;Conqueyrac;97;2;99
76;Occitanie;30;1;08;094;Corbès;147;1;148
76;Occitanie;30;3;15;095;Corconne;564;11;575
76;Occitanie;30;2;14;096;Cornillon;942;21;963
76;Occitanie;30;1;18;097;Courry;280;5;285
76;Occitanie;30;2;07;098;Crespian;424;4;428
76;Occitanie;30;3;15;099;Cros;245;8;253
76;Occitanie;30;1;15;100;Cruviers-Lascours;701;9;710
76;Occitanie;30;1;04;101;Deaux;645;16;661
76;Occitanie;30;2;20;102;Dions;564;9;573
76;Occitanie;30;2;16;103;Domazan;935;11;946
76;Occitanie;30;2;15;104;Domessargues;748;18;766
76;Occitanie;30;3;22;105;Dourbies;140;5;145
76;Occitanie;30;3;15;106;Durfort-et-Saint-Martin-de-Sossenac;707;16;723
76;Occitanie;30;2;16;107;Estézargues;587;12;599
76;Occitanie;30;3;22;108;L' Estréchure;159;5;164
76;Occitanie;30;1;04;109;Euzet;449;7;456
76;Occitanie;30;2;20;110;Flaux;374;9;383
76;Occitanie;30;2;20;111;Foissac;431;9;440
76;Occitanie;30;2;07;112;Fons;1563;15;1578
76;Occitanie;30;2;03;113;Fons-sur-Lussan;237;3;240
76;Occitanie;30;2;07;114;Fontanès;689;10;699
76;Occitanie;30;2;20;115;Fontarèches;256;8;264
76;Occitanie;30;2;16;116;Fournès;1081;12;1093
76;Occitanie;30;2;06;117;Fourques;2843;57;2900
76;Occitanie;30;3;15;119;Fressac;159;5;164
76;Occitanie;30;1;18;120;Gagnières;1085;15;1100
76;Occitanie;30;3;15;121;Gailhan;248;4;252
76;Occitanie;30;2;07;122;Gajan;687;12;699
76;Occitanie;30;2;01;123;Gallargues-le-Montueux;3667;92;3759
76;Occitanie;30;2;14;124;Le Garn;215;2;217
76;Occitanie;30;2;09;125;Garons;4950;50;5000
76;Occitanie;30;2;20;126;Garrigues-Sainte-Eulalie;729;19;748
76;Occitanie;30;2;05;127;Gaujac;1087;26;1113
76;Occitanie;30;2;19;128;Générac;4095;68;4163
76;Occitanie;30;1;02;129;Générargues;694;20;714
76;Occitanie;30;1;08;130;Génolhac;833;20;853
76;Occitanie;30;2;14;131;Goudargues;1103;33;1136
76;Occitanie;30;1;08;132;La Grand-Combe;5021;97;5118
76;Occitanie;30;2;01;133;Le Grau-du-Roi;8457;73;8530
76;Occitanie;30;2;14;134;Issirac;307;4;311
76;Occitanie;30;2;06;135;Jonquières-Saint-Vincent;3814;39;3853
76;Occitanie;30;2;07;136;Junas;1126;17;1143
76;Occitanie;30;1;08;137;Lamelouze;137;3;140
76;Occitanie;30;2;19;138;Langlade;2204;55;2259
76;Occitanie;30;3;22;139;Lanuéjols;355;23;378
76;Occitanie;30;3;22;140;Lasalle;1122;11;1133
76;Occitanie;30;2;17;141;Laudun-l'Ardoise;6316;117;6433
76;Occitanie;30;1;08;142;Laval-Pradel;1147;22;1169
76;Occitanie;30;2;14;143;Laval-Saint-Roman;216;5;221
76;Occitanie;30;2;07;144;Lecques;466;9;475
76;Occitanie;30;2;16;145;Lédenon;1590;24;1614
76;Occitanie;30;3;15;146;Lédignan;1472;24;1496
76;Occitanie;30;1;15;147;Lézan;1517;27;1544
76;Occitanie;30;3;15;148;Liouc;302;7;309
76;Occitanie;30;2;17;149;Lirac;914;20;934
76;Occitanie;30;3;15;150;Logrian-Florian;264;6;270
76;Occitanie;30;2;03;151;Lussan;488;7;495
76;Occitanie;30;1;18;152;Les Mages;2059;34;2093
76;Occitanie;30;1;08;153;Malons-et-Elze;124;0;124
76;Occitanie;30;3;22;154;Mandagout;402;7;409
76;Occitanie;30;2;09;155;Manduel;6871;96;6967
76;Occitanie;30;2;09;156;Marguerittes;8635;162;8797
76;Occitanie;30;1;04;158;Martignargues;427;9;436
76;Occitanie;30;1;18;159;Le Martinet;745;5;750
76;Occitanie;30;3;15;160;Maruéjols-lès-Gardon;252;4;256
76;Occitanie;30;1;15;161;Massanes;194;6;200
76;Occitanie;30;1;15;162;Massillargues-Attuech;664;15;679
76;Occitanie;30;2;15;163;Mauressargues;164;6;170
76;Occitanie;30;1;18;164;Méjannes-le-Clap;715;14;729
76;Occitanie;30;1;04;165;Méjannes-lès-Alès;1209;32;1241
76;Occitanie;30;2;16;166;Meynes;2479;150;2629
76;Occitanie;30;1;18;167;Meyrannes;810;16;826
76;Occitanie;30;1;08;168;Mialet;621;17;638
76;Occitanie;30;2;19;169;Milhaud;5717;134;5851
76;Occitanie;30;3;22;170;Molières-Cavaillac;931;31;962
76;Occitanie;30;1;18;171;Molières-sur-Cèze;1228;12;1240
76;Occitanie;30;3;15;172;Monoblet;746;8;754
76;Occitanie;30;1;03;173;Mons;1697;31;1728
76;Occitanie;30;2;15;354;Montagnac;204;4;208
76;Occitanie;30;2;20;174;Montaren-et-Saint-Médiers;1418;38;1456
76;Occitanie;30;2;14;175;Montclus;200;1;201
76;Occitanie;30;3;22;176;Montdardier;199;3;202
76;Occitanie;30;1;04;177;Monteils;652;10;662
76;Occitanie;30;2;17;178;Montfaucon;1507;38;1545
76;Occitanie;30;2;16;179;Montfrin;3176;53;3229
76;Occitanie;30;2;07;180;Montignargues;587;10;597
76;Occitanie;30;2;07;181;Montmirat;442;5;447
76;Occitanie;30;2;07;182;Montpezat;1309;21;1330
76;Occitanie;30;2;15;183;Moulézan;652;4;656
76;Occitanie;30;2;15;184;Moussac;1511;12;1523
76;Occitanie;30;2;21;185;Mus;1429;19;1448
76;Occitanie;30;2;07;186;Nages-et-Solorgues;1818;48;1866
76;Occitanie;30;1;18;187;Navacelles;315;8;323
76;Occitanie;30;1;15;188;Ners;706;13;719
76;Occitanie;30;2;99;189;Nîmes;149633;2242;151875
76;Occitanie;30;2;05;191;Orsan;1166;28;1194
76;Occitanie;30;3;15;192;Orthoux-Sérignac-Quilhan;422;12;434
76;Occitanie;30;2;07;193;Parignargues;687;6;693
76;Occitanie;30;1;18;194;Peyremale;281;2;283
76;Occitanie;30;3;22;195;Peyrolles;33;3;36
76;Occitanie;30;2;05;196;Le Pin;440;10;450
76;Occitanie;30;1;03;197;Les Plans;263;7;270
76;Occitanie;30;3;22;198;Les Plantiers;259;6;265
76;Occitanie;30;3;22;199;Pommiers;56;1;57
76;Occitanie;30;3;22;200;Pompignan;954;14;968
76;Occitanie;30;2;14;202;Pont-Saint-Esprit;10397;191;10588
76;Occitanie;30;1;08;201;Ponteils-et-Brésis;367;6;373
76;Occitanie;30;1;08;203;Portes;339;8;347
76;Occitanie;30;1;18;204;Potelières;368;5;373
76;Occitanie;30;2;20;205;Pougnadoresse;247;4;251
76;Occitanie;30;2;09;206;Poulx;4032;118;4150
76;Occitanie;30;2;16;207;Pouzilhac;733;6;739
76;Occitanie;30;3;15;208;Puechredon;44;0;44
76;Occitanie;30;2;23;209;Pujaut;4028;134;4162
76;Occitanie;30;3;15;210;Quissac;3259;33;3292
76;Occitanie;30;2;16;211;Redessan;4082;58;4140
76;Occitanie;30;2;16;212;Remoulins;2259;43;2302
76;Occitanie;30;3;22;213;Revens;21;0;21
76;Occitanie;30;1;02;214;Ribaute-les-Tavernes;2159;49;2208
76;Occitanie;30;1;18;215;Rivières;376;3;379
76;Occitanie;30;1;18;216;Robiac-Rochessadoule;833;15;848
76;Occitanie;30;2;23;217;Rochefort-du-Gard;7574;182;7756
76;Occitanie;30;1;18;218;Rochegude;252;3;255
76;Occitanie;30;2;09;356;Rodilhan;2866;179;3045
76;Occitanie;30;3;22;219;Rogues;107;2;109
76;Occitanie;30;2;14;222;La Roque-sur-Cèze;182;7;189
76;Occitanie;30;3;22;220;Roquedur;256;6;262
76;Occitanie;30;2;17;221;Roquemaure;5520;65;5585
76;Occitanie;30;1;18;223;Rousson;4177;112;4289
76;Occitanie;30;2;07;224;La Rouvière;613;15;628
76;Occitanie;30;2;05;225;Sabran;1647;53;1700
76;Occitanie;30;2;14;226;Saint-Alexandre;1225;25;1250
76;Occitanie;30;1;18;227;Saint-Ambroix;3257;40;3297
76;Occitanie;30;2;14;232;Saint-André-d'Olérargues;428;14;442
76;Occitanie;30;3;22;229;Saint-André-de-Majencoules;594;9;603
76;Occitanie;30;2;14;230;Saint-André-de-Roquepertuis;585;9;594
76;Occitanie;30;3;22;231;Saint-André-de-Valborgne;367;11;378
76;Occitanie;30;2;07;233;Saint-Bauzély;653;10;663
76;Occitanie;30;3;15;234;Saint-Bénézet;279;7;286
76;Occitanie;30;1;08;236;Saint-Bonnet-de-Salendrinque;119;3;122
76;Occitanie;30;2;16;235;Saint-Bonnet-du-Gard;843;12;855
76;Occitanie;30;1;18;237;Saint-Brès;649;12;661
76;Occitanie;30;3;22;238;Saint-Bresson;58;0;58
76;Occitanie;30;1;04;240;Saint-Césaire-de-Gauzignan;385;4;389
76;Occitanie;30;2;20;241;Saint-Chaptes;1877;29;1906
76;Occitanie;30;2;14;242;Saint-Christol-de-Rodières;160;2;162
76;Occitanie;30;1;02;243;Saint-Christol-lez-Alès;7042;184;7226
76;Occitanie;30;2;07;244;Saint-Clément;369;6;375
76;Occitanie;30;2;19;245;Saint-Côme-et-Maruéjols;809;14;823
76;Occitanie;30;1;18;247;Saint-Denis;291;9;300
76;Occitanie;30;2;20;248;Saint-Dézéry;459;4;463
76;Occitanie;30;2;19;249;Saint-Dionisy;1056;13;1069
76;Occitanie;30;1;04;250;Saint-Étienne-de-l'Olm;398;12;410
76;Occitanie;30;2;05;251;Saint-Étienne-des-Sorts;552;12;564
76;Occitanie;30;3;15;252;Saint-Félix-de-Pallières;239;8;247
76;Occitanie;30;1;18;253;Saint-Florent-sur-Auzonnet;1171;16;1187
76;Occitanie;30;2;17;254;Saint-Geniès-de-Comolas;1983;39;2022
76;Occitanie;30;2;07;255;Saint-Geniès-de-Malgoirès;3036;32;3068
76;Occitanie;30;2;14;256;Saint-Gervais;742;15;757
76;Occitanie;30;2;16;257;Saint-Gervasy;1949;26;1975
76;Occitanie;30;2;19;258;Saint-Gilles;13787;106;13893
76;Occitanie;30;2;16;260;Saint-Hilaire-d'Ozilhan;1074;22;1096
76;Occitanie;30;1;04;259;Saint-Hilaire-de-Brethmas;4408;78;4486
76;Occitanie;30;1;04;261;Saint-Hippolyte-de-Caton;220;4;224
76;Occitanie;30;2;20;262;Saint-Hippolyte-de-Montaigu;257;12;269
76;Occitanie;30;3;22;263;Saint-Hippolyte-du-Fort;3856;143;3999
76;Occitanie;30;1;04;264;Saint-Jean-de-Ceyrargues;167;1;168
76;Occitanie;30;3;15;265;Saint-Jean-de-Crieulon;243;2;245
76;Occitanie;30;1;18;266;Saint-Jean-de-Maruéjols-et-Avéjan;886;11;897
76;Occitanie;30;1;15;267;Saint-Jean-de-Serres;518;11;529
76;Occitanie;30;1;18;268;Saint-Jean-de-Valériscle;648;16;664
76;Occitanie;30;1;08;269;Saint-Jean-du-Gard;2436;171;2607
76;Occitanie;30;1;02;270;Saint-Jean-du-Pin;1512;39;1551
76;Occitanie;30;1;18;271;Saint-Julien-de-Cassagnas;712;15;727
76;Occitanie;30;3;22;272;Saint-Julien-de-la-Nef;142;6;148
76;Occitanie;30;2;14;273;Saint-Julien-de-Peyrolas;1425;26;1451
76;Occitanie;30;1;18;274;Saint-Julien-les-Rosiers;3367;61;3428
76;Occitanie;30;1;03;275;Saint-Just-et-Vacquières;308;5;313
76;Occitanie;30;2;01;276;Saint-Laurent-d'Aigouze;3501;43;3544
76;Occitanie;30;2;14;277;Saint-Laurent-de-Carnols;496;9;505
76;Occitanie;30;2;17;278;Saint-Laurent-des-Arbres;3032;68;3100
76;Occitanie;30;2;20;279;Saint-Laurent-la-Vernède;671;11;682
76;Occitanie;30;3;22;280;Saint-Laurent-le-Minier;350;11;361
76;Occitanie;30;2;07;281;Saint-Mamert-du-Gard;1643;22;1665
76;Occitanie;30;2;14;282;Saint-Marcel-de-Careiret;847;17;864
76;Occitanie;30;3;22;283;Saint-Martial;182;3;185
76;Occitanie;30;1;03;284;Saint-Martin-de-Valgalgues;4472;62;4534
76;Occitanie;30;1;04;285;Saint-Maurice-de-Cazevieille;741;8;749
76;Occitanie;30;2;20;286;Saint-Maximin;758;18;776
76;Occitanie;30;2;14;287;Saint-Michel-d'Euzet;643;11;654
76;Occitanie;30;2;14;288;Saint-Nazaire;1249;19;1268
76;Occitanie;30;3;15;289;Saint-Nazaire-des-Gardies;85;2;87
76;Occitanie;30;1;08;291;Saint-Paul-la-Coste;288;5;293
76;Occitanie;30;2;17;355;Saint-Paul-les-Fonts;1029;21;1050
76;Occitanie;30;2;14;290;Saint-Paulet-de-Caisson;1820;59;1879
76;Occitanie;30;2;05;292;Saint-Pons-la-Calm;448;10;458
76;Occitanie;30;1;18;293;Saint-Privat-de-Champclos;347;5;352
76;Occitanie;30;1;03;294;Saint-Privat-des-Vieux;5218;126;5344
76;Occitanie;30;2;20;295;Saint-Quentin-la-Poterie;3063;63;3126
76;Occitanie;30;3;22;296;Saint-Roman-de-Codières;155;15;170
76;Occitanie;30;3;22;297;Saint-Sauveur-Camprieu;234;11;245
76;Occitanie;30;1;08;298;Saint-Sébastien-d'Aigrefeuille;500;19;519
76;Occitanie;30;2;20;299;Saint-Siffret;1082;48;1130
76;Occitanie;30;3;15;300;Saint-Théodorit;535;12;547
76;Occitanie;30;1;18;303;Saint-Victor-de-Malcap;835;21;856
76;Occitanie;30;2;20;301;Saint-Victor-des-Oules;304;4;308
76;Occitanie;30;2;17;302;Saint-Victor-la-Coste;2104;46;2150
76;Occitanie;30;2;20;228;Sainte-Anastasie;1704;32;1736
76;Occitanie;30;1;08;239;Sainte-Cécile-d'Andorge;590;3;593
76;Occitanie;30;1;08;246;Sainte-Croix-de-Caderle;111;7;118
76;Occitanie;30;2;14;304;Salazac;185;3;188
76;Occitanie;30;1;03;305;Salindres;3518;38;3556
76;Occitanie;30;2;07;306;Salinelles;563;8;571
76;Occitanie;30;1;08;307;Les Salles-du-Gardon;2598;26;2624
76;Occitanie;30;2;20;308;Sanilhac-Sagriès;776;51;827
76;Occitanie;30;3;15;309;Sardan;319;1;320
76;Occitanie;30;3;22;310;Saumane;278;6;284
76;Occitanie;30;3;15;311;Sauve;1912;22;1934
76;Occitanie;30;2;17;312;Sauveterre;2051;47;2098
76;Occitanie;30;2;07;313;Sauzet;750;7;757
76;Occitanie;30;3;15;314;Savignargues;237;4;241
76;Occitanie;30;2;23;315;Saze;2051;38;2089
76;Occitanie;30;1;08;316;Sénéchas;244;7;251
76;Occitanie;30;2;16;317;Sernhac;1748;15;1763
76;Occitanie;30;1;03;318;Servas;208;4;212
76;Occitanie;30;2;20;319;Serviers-et-Labaume;608;23;631
76;Occitanie;30;1;03;320;Seynes;161;2;163
76;Occitanie;30;2;07;321;Sommières;4972;62;5034
76;Occitanie;30;3;22;322;Soudorgues;271;6;277
76;Occitanie;30;1;08;323;Soustelle;123;2;125
76;Occitanie;30;2;07;324;Souvignargues;876;15;891
76;Occitanie;30;3;22;325;Sumène;1469;36;1505
76;Occitanie;30;2;17;326;Tavel;1994;37;2031
76;Occitanie;30;1;18;327;Tharaux;56;2;58
76;Occitanie;30;2;16;328;Théziers;1045;18;1063
76;Occitanie;30;1;08;329;Thoiras;438;16;454
76;Occitanie;30;1;15;330;Tornac;923;25;948
76;Occitanie;30;2;05;331;Tresques;1803;50;1853
76;Occitanie;30;3;22;332;Trèves;121;1;122
76;Occitanie;30;2;21;333;Uchaud;4345;42;4387
76;Occitanie;30;2;20;334;Uzès;8420;344;8764
76;Occitanie;30;1;08;335;Vabres;130;4;134
76;Occitanie;30;3;22;339;Val-d'Aigoual ;1420;21;1441
76;Occitanie;30;2;06;336;Vallabrègues;1379;20;1399
76;Occitanie;30;2;20;337;Vallabrix;427;6;433
76;Occitanie;30;2;03;338;Vallérargues;141;4;145
76;Occitanie;30;2;16;340;Valliguières;592;11;603
76;Occitanie;30;2;21;341;Vauvert;11633;120;11753
76;Occitanie;30;2;14;342;Vénéjan;1265;42;1307
76;Occitanie;30;2;14;343;Verfeuil;606;8;614
76;Occitanie;30;2;21;344;Vergèze;5243;75;5318
76;Occitanie;30;1;08;345;La Vernarède;340;1;341
76;Occitanie;30;2;16;346;Vers-Pont-du-Gard;1822;34;1856
76;Occitanie;30;2;21;347;Vestric-et-Candiac;1393;21;1414
76;Occitanie;30;1;04;348;Vézénobres;1777;101;1878
76;Occitanie;30;3;15;349;Vic-le-Fesq;534;3;537
76;Occitanie;30;3;22;350;Le Vigan;3785;118;3903
76;Occitanie;30;2;23;351;Villeneuve-lès-Avignon;11769;386;12155
76;Occitanie;30;2;07;352;Villevieille;1751;34;1785
76;Occitanie;30;3;22;353;Vissec;63;1;64
76;Occitanie;31;2;06;001;Agassac;121;3;124
76;Occitanie;31;3;07;002;Aignes;243;6;249
76;Occitanie;31;3;07;003;Aigrefeuille;1274;29;1303
76;Occitanie;31;2;06;005;Alan;296;8;304
76;Occitanie;31;3;13;006;Albiac;215;6;221
76;Occitanie;31;2;06;007;Ambax;65;0;65
76;Occitanie;31;2;06;008;Anan;248;4;252
76;Occitanie;31;2;02;009;Antichan-de-Frontignes;185;3;188
76;Occitanie;31;2;02;010;Antignac;107;3;110
76;Occitanie;31;2;02;011;Arbas;265;6;271
76;Occitanie;31;2;02;012;Arbon;100;2;102
76;Occitanie;31;2;02;013;Ardiège;361;11;372
76;Occitanie;31;2;02;014;Arguenos;77;4;81
76;Occitanie;31;2;02;015;Argut-Dessous;22;1;23
76;Occitanie;31;2;02;017;Arlos;100;2;102
76;Occitanie;31;2;02;018;Arnaud-Guilhem;229;4;233
76;Occitanie;31;2;02;019;Artigue;31;1;32
76;Occitanie;31;2;02;020;Aspet;877;72;949
76;Occitanie;31;2;14;021;Aspret-Sarrat;132;5;137
76;Occitanie;31;3;05;022;Aucamville;8691;91;8782
76;Occitanie;31;2;06;023;Aulon;310;5;315
76;Occitanie;31;1;07;024;Auragne;425;5;430
76;Occitanie;31;3;04;025;Aureville;906;15;921
76;Occitanie;31;3;13;026;Auriac-sur-Vendinelle;1048;21;1069
76;Occitanie;31;1;01;027;Auribail;202;5;207
76;Occitanie;31;2;06;028;Aurignac;1185;70;1255
76;Occitanie;31;3;13;029;Aurin;333;6;339
76;Occitanie;31;2;02;030;Ausseing;75;1;76
76;Occitanie;31;2;14;031;Ausson;588;20;608
76;Occitanie;31;3;03;032;Aussonne;7187;79;7266
76;Occitanie;31;1;01;033;Auterive;9869;94;9963
76;Occitanie;31;2;02;034;Auzas;235;9;244
76;Occitanie;31;3;04;035;Auzeville-Tolosane;4092;247;4339
76;Occitanie;31;3;04;036;Auzielle;1553;47;1600
76;Occitanie;31;3;13;037;Avignonet-Lauragais;1578;12;1590
76;Occitanie;31;3;07;004;Ayguesvives;2663;50;2713
76;Occitanie;31;3;10;038;Azas;664;11;675
76;Occitanie;31;2;06;039;Bachas;76;2;78
76;Occitanie;31;2;02;040;Bachos;36;1;37
76;Occitanie;31;2;02;041;Bagiry;112;2;114
76;Occitanie;31;2;02;042;Bagnères-de-Luchon;2293;143;2436
76;Occitanie;31;2;14;043;Balesta;143;6;149
76;Occitanie;31;3;24;044;Balma;16520;289;16809
76;Occitanie;31;2;02;045;Barbazan;492;10;502
76;Occitanie;31;2;02;046;Baren;12;0;12
76;Occitanie;31;1;01;047;Bax;88;1;89
76;Occitanie;31;3;07;048;Baziège;3383;58;3441
76;Occitanie;31;3;10;049;Bazus;566;13;579
76;Occitanie;31;2;02;050;Beauchalot;642;9;651
76;Occitanie;31;1;06;051;Beaufort;467;5;472
76;Occitanie;31;1;01;052;Beaumont-sur-Lèze;1557;31;1588
76;Occitanie;31;3;24;053;Beaupuy;1340;28;1368
76;Occitanie;31;3;13;054;Beauteville;180;1;181
76;Occitanie;31;3;13;055;Beauville;170;3;173
76;Occitanie;31;3;03;056;Beauzelle;6676;80;6756
76;Occitanie;31;3;07;057;Belberaud;1504;51;1555
76;Occitanie;31;3;07;058;Belbèze-de-Lauragais;126;1;127
76;Occitanie;31;2;02;059;Belbèze-en-Comminges;115;6;121
76;Occitanie;31;3;13;060;Bélesta-en-Lauragais;117;5;122
76;Occitanie;31;3;08;061;Bellegarde-Sainte-Marie;192;12;204
76;Occitanie;31;3;08;062;Bellesserre;108;4;112
76;Occitanie;31;2;06;063;Benque;164;2;166
76;Occitanie;31;2;02;064;Benque-Dessous-et-Dessus;26;0;26
76;Occitanie;31;1;06;065;Bérat;3015;58;3073
76;Occitanie;31;3;27;066;Bessières;4100;60;4160
76;Occitanie;31;2;02;067;Bezins-Garraux;43;0;43
76;Occitanie;31;2;02;068;Billière;25;0;25
76;Occitanie;31;2;02;590;Binos;44;0;44
76;Occitanie;31;3;03;069;Blagnac;25152;481;25633
76;Occitanie;31;2;14;070;Blajan;478;8;486
76;Occitanie;31;1;01;071;Bois-de-la-Pierre;437;3;440
76;Occitanie;31;2;06;072;Boissède;69;2;71
76;Occitanie;31;3;27;073;Bondigoux;598;20;618
76;Occitanie;31;3;10;074;Bonrepos-Riquet;291;7;298
76;Occitanie;31;1;11;075;Bonrepos-sur-Aussonnelle;1211;22;1233
76;Occitanie;31;2;14;076;Bordes-de-Rivière;477;12;489
76;Occitanie;31;3;27;077;Le Born;570;14;584
76;Occitanie;31;2;14;078;Boudrac;146;2;148
76;Occitanie;31;3;27;079;Bouloc;4689;88;4777
76;Occitanie;31;2;14;080;Boulogne-sur-Gesse;1630;41;1671
76;Occitanie;31;2;02;081;Bourg-d'Oueil;5;0;5
76;Occitanie;31;3;13;082;Bourg-Saint-Bernard;1089;20;1109
76;Occitanie;31;2;06;083;Boussan;234;2;236
76;Occitanie;31;1;06;084;Boussens;1081;24;1105
76;Occitanie;31;2;02;085;Boutx;246;3;249
76;Occitanie;31;2;06;086;Bouzin;92;4;96
76;Occitanie;31;1;11;087;Bragayrac;328;2;330
76;Occitanie;31;3;21;088;Brax;2836;94;2930
76;Occitanie;31;3;08;089;Bretx;673;6;679
76;Occitanie;31;3;08;090;Brignemont;380;5;385
76;Occitanie;31;3;05;091;Bruguières;5890;104;5994
76;Occitanie;31;2;02;092;Burgalays;122;0;122
76;Occitanie;31;3;08;093;Le Burgaud;972;11;983
76;Occitanie;31;3;27;094;Buzet-sur-Tarn;2819;50;2869
76;Occitanie;31;2;02;095;Cabanac-Cazaux;127;1;128
76;Occitanie;31;3;08;096;Cabanac-Séguenville;177;1;178
76;Occitanie;31;3;13;097;Le Cabanial;450;12;462
76;Occitanie;31;3;08;098;Cadours;1087;18;1105
76;Occitanie;31;3;07;099;Caignac;390;4;394
76;Occitanie;31;3;07;100;Calmont;2362;31;2393
76;Occitanie;31;1;06;101;Cambernard;466;4;470
76;Occitanie;31;3;13;102;Cambiac;217;3;220
76;Occitanie;31;1;01;103;Canens;59;0;59
76;Occitanie;31;1;01;104;Capens;672;13;685
76;Occitanie;31;3;13;105;Caragoudes;224;5;229
76;Occitanie;31;3;13;106;Caraman;2520;46;2566
76;Occitanie;31;1;01;107;Carbonne;5752;110;5862
76;Occitanie;31;2;14;108;Cardeilhac;270;2;272
76;Occitanie;31;2;06;109;Cassagnabère-Tournas;463;3;466
76;Occitanie;31;2;02;110;Cassagne;639;13;652
76;Occitanie;31;1;01;111;Castagnac;283;4;287
76;Occitanie;31;2;02;112;Castagnède;190;5;195
76;Occitanie;31;3;04;113;Castanet-Tolosan;13811;244;14055
76;Occitanie;31;2;02;114;Castelbiague;246;3;249
76;Occitanie;31;2;06;115;Castelgaillard;60;1;61
76;Occitanie;31;3;05;116;Castelginest;10734;117;10851
76;Occitanie;31;3;10;117;Castelmaurou;4320;98;4418
76;Occitanie;31;3;27;118;Castelnau-d'Estrétefonds;6468;102;6570
76;Occitanie;31;1;06;119;Castelnau-Picampeau;208;5;213
76;Occitanie;31;3;08;120;Le Castéra;723;18;741
76;Occitanie;31;2;14;121;Castéra-Vignoles;63;1;64
76;Occitanie;31;1;06;122;Casties-Labrande;114;2;116
76;Occitanie;31;2;02;123;Castillon-de-Larboust;72;1;73
76;Occitanie;31;2;02;124;Castillon-de-Saint-Martory;385;9;394
76;Occitanie;31;2;02;125;Cathervielle;35;0;35
76;Occitanie;31;3;08;126;Caubiac;391;10;401
76;Occitanie;31;2;02;127;Caubous;4;1;5
76;Occitanie;31;1;01;128;Caujac;843;21;864
76;Occitanie;31;2;06;593;Cazac;87;0;87
76;Occitanie;31;2;14;130;Cazaril-Tambourès;86;3;89
76;Occitanie;31;2;02;129;Cazarilh-Laspènes;21;5;26
76;Occitanie;31;2;02;131;Cazaunous;71;1;72
76;Occitanie;31;2;02;132;Cazaux-Layrisse;63;1;64
76;Occitanie;31;2;02;133;Cazeaux-de-Larboust;100;4;104
76;Occitanie;31;2;06;134;Cazeneuve-Montaut;79;0;79
76;Occitanie;31;1;06;135;Cazères;4846;72;4918
76;Occitanie;31;3;27;136;Cépet;2003;24;2027
76;Occitanie;31;3;13;137;Cessales;161;0;161
76;Occitanie;31;2;14;138;Charlas;246;6;252
76;Occitanie;31;2;02;139;Chaum;192;4;196
76;Occitanie;31;2;02;140;Chein-Dessus;180;7;187
76;Occitanie;31;2;14;141;Ciadoux;221;2;223
76;Occitanie;31;2;02;142;Cier-de-Luchon;243;7;250
76;Occitanie;31;2;02;143;Cier-de-Rivière;277;8;285
76;Occitanie;31;2;02;144;Cierp-Gaud;728;12;740
76;Occitanie;31;1;01;145;Cintegabelle;2909;65;2974
76;Occitanie;31;2;02;146;Cirès;14;0;14
76;Occitanie;31;2;14;147;Clarac;644;12;656
76;Occitanie;31;3;04;148;Clermont-le-Fort;497;16;513
76;Occitanie;31;3;21;149;Colomiers;39097;551;39648
76;Occitanie;31;3;03;150;Cornebarrieu;6862;98;6960
76;Occitanie;31;3;07;151;Corronsac;839;22;861
76;Occitanie;31;2;06;152;Coueilles;93;5;98
76;Occitanie;31;1;06;153;Couladère;417;12;429
76;Occitanie;31;2;02;155;Couret;236;2;238
76;Occitanie;31;3;08;156;Cox;349;11;360
76;Occitanie;31;3;26;157;Cugnaux;18267;237;18504
76;Occitanie;31;2;14;158;Cuguron;181;7;188
76;Occitanie;31;2;14;159;Le Cuing;469;5;474
76;Occitanie;31;3;08;160;Daux;2381;27;2408
76;Occitanie;31;3;07;161;Deyme;1185;21;1206
76;Occitanie;31;3;07;162;Donneville;1043;84;1127
76;Occitanie;31;3;24;163;Drémil-Lafage;2650;65;2715
76;Occitanie;31;3;08;164;Drudas;209;6;215
76;Occitanie;31;1;12;165;Eaunes;6234;96;6330
76;Occitanie;31;1;11;166;Empeaux;268;4;272
76;Occitanie;31;2;02;167;Encausse-les-Thermes;692;14;706
76;Occitanie;31;2;06;168;Eoux;125;0;125
76;Occitanie;31;3;07;169;Escalquens;6955;161;7116
76;Occitanie;31;2;14;170;Escanecrabe;245;10;255
76;Occitanie;31;2;02;591;Escoulis;80;1;81
76;Occitanie;31;3;07;171;Espanès;313;10;323
76;Occitanie;31;2;06;172;Esparron;52;1;53
76;Occitanie;31;1;01;173;Esperce;265;3;268
76;Occitanie;31;2;02;174;Estadens;533;4;537
76;Occitanie;31;2;14;175;Estancarbon;608;10;618
76;Occitanie;31;2;02;176;Esténos;189;5;194
76;Occitanie;31;2;02;177;Eup;136;2;138
76;Occitanie;31;2;06;178;Fabas;199;3;202
76;Occitanie;31;3;13;179;Le Faget;333;20;353
76;Occitanie;31;3;13;180;Falga;132;6;138
76;Occitanie;31;1;09;181;Le Fauga;2069;28;2097
76;Occitanie;31;3;05;182;Fenouillet;5272;59;5331
76;Occitanie;31;2;02;183;Figarol;311;9;320
76;Occitanie;31;3;24;184;Flourens;2009;37;2046
76;Occitanie;31;3;13;185;Folcarde;119;1;120
76;Occitanie;31;3;05;186;Fonbeauzard;2981;30;3011
76;Occitanie;31;1;11;187;Fonsorbes;12036;325;12361
76;Occitanie;31;1;11;188;Fontenilles;5914;162;6076
76;Occitanie;31;1;06;189;Forgues;215;4;219
76;Occitanie;31;2;02;190;Fos;233;0;233
76;Occitanie;31;2;02;191;Fougaron;96;2;98
76;Occitanie;31;3;07;192;Fourquevaux;784;21;805
76;Occitanie;31;1;06;193;Le Fousseret;1896;30;1926
76;Occitanie;31;3;13;194;Francarville;175;2;177
76;Occitanie;31;2;02;195;Francazal;30;0;30
76;Occitanie;31;1;06;196;Francon;244;3;247
76;Occitanie;31;2;14;197;Franquevielle;330;8;338
76;Occitanie;31;2;02;198;Le Fréchet;101;3;104
76;Occitanie;31;2;02;199;Fronsac;205;7;212
76;Occitanie;31;2;02;200;Frontignan-de-Comminges;79;4;83
76;Occitanie;31;2;06;201;Frontignan-Savès;71;0;71
76;Occitanie;31;3;27;202;Fronton;6166;146;6312
76;Occitanie;31;1;09;203;Frouzins;9157;160;9317
76;Occitanie;31;1;06;204;Fustignac;80;3;83
76;Occitanie;31;3;05;205;Gagnac-sur-Garonne;3122;27;3149
76;Occitanie;31;1;01;206;Gaillac-Toulza;1288;15;1303
76;Occitanie;31;2;02;207;Galié;79;6;85
76;Occitanie;31;2;02;208;Ganties;325;5;330
76;Occitanie;31;3;08;209;Garac;150;4;154
76;Occitanie;31;3;13;210;Gardouch;1264;24;1288
76;Occitanie;31;3;27;211;Gargas;691;8;699
76;Occitanie;31;3;10;212;Garidech;1851;14;1865
76;Occitanie;31;2;02;213;Garin;147;3;150
76;Occitanie;31;3;10;215;Gauré;481;15;496
76;Occitanie;31;3;10;216;Gémil;269;10;279
76;Occitanie;31;2;02;217;Génos;66;1;67
76;Occitanie;31;2;14;218;Gensac-de-Boulogne;118;4;122
76;Occitanie;31;1;01;219;Gensac-sur-Garonne;445;2;447
76;Occitanie;31;3;07;220;Gibel;368;5;373
76;Occitanie;31;2;02;221;Gouaux-de-Larboust;68;0;68
76;Occitanie;31;2;02;222;Gouaux-de-Luchon;47;0;47
76;Occitanie;31;2;06;223;Goudex;44;1;45
76;Occitanie;31;2;02;224;Gourdan-Polignan;1203;186;1389
76;Occitanie;31;1;01;225;Goutevernisse;186;3;189
76;Occitanie;31;1;01;226;Gouzens;81;7;88
76;Occitanie;31;3;04;227;Goyrans;843;36;879
76;Occitanie;31;3;10;228;Gragnague;1853;40;1893
76;Occitanie;31;1;06;229;Gratens;691;17;708
76;Occitanie;31;3;05;230;Gratentour;4272;77;4349
76;Occitanie;31;1;01;231;Grazac;639;8;647
76;Occitanie;31;3;08;232;Grenade;8841;166;9007
76;Occitanie;31;1;01;233;Grépiac;991;33;1024
76;Occitanie;31;3;08;234;Le Grès;434;8;442
76;Occitanie;31;2;02;235;Guran;44;1;45
76;Occitanie;31;2;02;236;Herran;75;1;76
76;Occitanie;31;2;02;237;His;227;30;257
76;Occitanie;31;2;02;238;Huos;486;11;497
76;Occitanie;31;2;06;239;L' Isle-en-Dodon;1633;28;1661
76;Occitanie;31;3;07;240;Issus;594;10;604
76;Occitanie;31;2;02;241;Izaut-de-l'Hôtel;305;5;310
76;Occitanie;31;2;02;242;Jurvielle;19;2;21
76;Occitanie;31;3;13;243;Juzes;77;4;81
76;Occitanie;31;2;02;245;Juzet-d'Izaut;187;5;192
76;Occitanie;31;2;02;244;Juzet-de-Luchon;375;17;392
76;Occitanie;31;2;14;246;Labarthe-Inard;864;15;879
76;Occitanie;31;2;14;247;Labarthe-Rivière;1317;28;1345
76;Occitanie;31;1;12;248;Labarthe-sur-Lèze;6275;104;6379
76;Occitanie;31;3;07;249;Labastide-Beauvoir;1265;26;1291
76;Occitanie;31;1;06;250;Labastide-Clermont;669;17;686
76;Occitanie;31;2;06;251;Labastide-Paumès;144;1;145
76;Occitanie;31;3;10;252;Labastide-Saint-Sernin;1918;24;1942
76;Occitanie;31;1;09;253;Labastidette;2809;35;2844
76;Occitanie;31;3;04;254;Labège;3972;141;4113
76;Occitanie;31;2;02;255;Labroquère;318;10;328
76;Occitanie;31;1;01;256;Labruyère-Dorsa;290;6;296
76;Occitanie;31;1;01;258;Lacaugne;229;6;235
76;Occitanie;31;3;04;259;Lacroix-Falgarde;2080;48;2128
76;Occitanie;31;2;02;260;Laffite-Toupière;100;1;101
76;Occitanie;31;1;01;261;Lafitte-Vigordane;1209;18;1227
76;Occitanie;31;3;13;262;Lagarde;415;11;426
76;Occitanie;31;1;12;263;Lagardelle-sur-Lèze;3107;56;3163
76;Occitanie;31;1;01;264;Lagrâce-Dieu;564;7;571
76;Occitanie;31;3;08;265;Lagraulet-Saint-Nicolas;246;4;250
76;Occitanie;31;1;06;266;Lahage;202;1;203
76;Occitanie;31;1;01;267;Lahitère;63;0;63
76;Occitanie;31;2;14;268;Lalouret-Laffiteau;135;3;138
76;Occitanie;31;1;09;269;Lamasquère;1484;15;1499
76;Occitanie;31;2;14;270;Landorthe;1000;34;1034
76;Occitanie;31;3;13;271;Lanta;2113;41;2154
76;Occitanie;31;1;01;272;Lapeyrère;66;3;69
76;Occitanie;31;3;10;273;Lapeyrouse-Fossat;2854;68;2922
76;Occitanie;31;2;14;274;Larcan;179;5;184
76;Occitanie;31;3;08;275;Laréole;166;5;171
76;Occitanie;31;3;08;592;Larra;1960;31;1991
76;Occitanie;31;2;14;276;Larroque;290;5;295
76;Occitanie;31;3;08;277;Lasserre-Pradère ;1522;42;1564
76;Occitanie;31;2;06;278;Latoue;320;5;325
76;Occitanie;31;1;01;279;Latour;77;1;78
76;Occitanie;31;1;01;280;Latrape;369;13;382
76;Occitanie;31;3;08;281;Launac;1359;33;1392
76;Occitanie;31;3;22;282;Launaguet;8942;111;9053
76;Occitanie;31;1;06;283;Lautignac;268;1;269
76;Occitanie;31;3;07;284;Lauzerville;1631;54;1685
76;Occitanie;31;3;10;285;Lavalette;743;13;756
76;Occitanie;31;1;01;286;Lavelanet-de-Comminges;620;8;628
76;Occitanie;31;1;09;287;Lavernose-Lacasse;3153;80;3233
76;Occitanie;31;3;27;288;Layrac-sur-Tarn;316;9;325
76;Occitanie;31;2;14;289;Lécussan;270;3;273
76;Occitanie;31;2;02;290;Lège;40;1;41
76;Occitanie;31;3;08;291;Léguevin;9328;250;9578
76;Occitanie;31;1;06;292;Lescuns;72;1;73
76;Occitanie;31;3;05;293;Lespinasse;2783;23;2806
76;Occitanie;31;2;14;294;Lespiteau;97;1;98
76;Occitanie;31;2;14;295;Lespugue;82;0;82
76;Occitanie;31;2;02;296;Lestelle-de-Saint-Martory;438;11;449
76;Occitanie;31;3;08;297;Lévignac;2110;41;2151
76;Occitanie;31;1;06;299;Lherm;3726;80;3806
76;Occitanie;31;2;14;300;Lieoux;126;3;129
76;Occitanie;31;2;06;301;Lilhac;132;1;133
76;Occitanie;31;2;14;302;Lodes;291;7;298
76;Occitanie;31;1;01;303;Longages;3104;33;3137
76;Occitanie;31;3;13;304;Loubens-Lauragais;455;10;465
76;Occitanie;31;2;14;305;Loudet;196;6;202
76;Occitanie;31;2;02;306;Lourde;92;0;92
76;Occitanie;31;2;02;308;Luscan;51;0;51
76;Occitanie;31;1;06;309;Lussan-Adeilhac;228;2;230
76;Occitanie;31;3;13;310;Lux;342;5;347
76;Occitanie;31;3;27;311;La Magdelaine-sur-Tarn;1178;21;1199
76;Occitanie;31;1;01;312;Mailholas;34;1;35
76;Occitanie;31;2;02;313;Malvezie;112;2;114
76;Occitanie;31;2;02;314;Mancioux;391;5;396
76;Occitanie;31;2;02;315;Mane;959;43;1002
76;Occitanie;31;2;02;316;Marignac;488;8;496
76;Occitanie;31;1;06;317;Marignac-Lasclares;474;9;483
76;Occitanie;31;1;06;318;Marignac-Laspeyres;212;5;217
76;Occitanie;31;1;01;319;Marliac;142;1;143
76;Occitanie;31;1;01;320;Marquefave;953;41;994
76;Occitanie;31;2;02;321;Marsoulas;124;8;132
76;Occitanie;31;2;06;322;Martisserre;64;2;66
76;Occitanie;31;2;02;323;Martres-de-Rivière;356;13;369
76;Occitanie;31;1;06;324;Martres-Tolosane;2376;43;2419
76;Occitanie;31;3;13;325;Mascarville;179;12;191
76;Occitanie;31;1;01;326;Massabrac;91;0;91
76;Occitanie;31;1;06;327;Mauran;223;1;224
76;Occitanie;31;3;13;328;Mauremont;318;10;328
76;Occitanie;31;3;13;329;Maurens;207;2;209
76;Occitanie;31;1;01;330;Mauressac;512;11;523
76;Occitanie;31;3;13;331;Maureville;306;12;318
76;Occitanie;31;3;07;332;Mauvaisin;225;4;229
76;Occitanie;31;2;06;333;Mauvezin;91;3;94
76;Occitanie;31;1;01;334;Mauzac;1291;23;1314
76;Occitanie;31;2;02;335;Mayrègne;25;2;27
76;Occitanie;31;2;02;336;Mazères-sur-Salat;623;12;635
76;Occitanie;31;2;02;337;Melles;91;1;92
76;Occitanie;31;3;08;338;Menville;775;23;798
76;Occitanie;31;3;08;339;Mérenvielle;492;6;498
76;Occitanie;31;3;04;340;Mervilla;272;8;280
76;Occitanie;31;3;08;341;Merville;5878;100;5978
76;Occitanie;31;2;02;342;Milhas;174;0;174
76;Occitanie;31;2;06;343;Mirambeau;61;0;61
76;Occitanie;31;2;14;344;Miramont-de-Comminges;773;12;785
76;Occitanie;31;1;01;345;Miremont;2558;35;2593
76;Occitanie;31;3;27;346;Mirepoix-sur-Tarn;1027;13;1040
76;Occitanie;31;2;06;347;Molas;167;4;171
76;Occitanie;31;2;02;348;Moncaup;38;0;38
76;Occitanie;31;1;06;349;Mondavezan;902;18;920
76;Occitanie;31;2;14;350;Mondilhan;87;1;88
76;Occitanie;31;3;03;351;Mondonville;4850;87;4937
76;Occitanie;31;3;24;352;Mondouzil;230;12;242
76;Occitanie;31;1;06;353;Monès;92;0;92
76;Occitanie;31;3;07;354;Monestrol;56;0;56
76;Occitanie;31;3;24;355;Mons;1774;53;1827
76;Occitanie;31;2;02;369;Mont-de-Galié;42;2;44
76;Occitanie;31;3;08;356;Montaigut-sur-Save;1760;44;1804
76;Occitanie;31;2;02;357;Montastruc-de-Salies;302;2;304
76;Occitanie;31;3;10;358;Montastruc-la-Conseillère;3503;99;3602
76;Occitanie;31;1;06;359;Montastruc-Savès;74;2;76
76;Occitanie;31;2;02;360;Montauban-de-Luchon;497;7;504
76;Occitanie;31;1;01;361;Montaut;515;5;520
76;Occitanie;31;1;06;362;Montberaud;207;5;212
76;Occitanie;31;2;06;363;Montbernard;219;5;224
76;Occitanie;31;3;10;364;Montberon;3066;65;3131
76;Occitanie;31;1;01;365;Montbrun-Bocage;476;11;487
76;Occitanie;31;3;07;366;Montbrun-Lauragais;633;20;653
76;Occitanie;31;1;06;367;Montclar-de-Comminges;78;5;83
76;Occitanie;31;3;13;368;Montclar-Lauragais;244;13;257
76;Occitanie;31;1;06;370;Montégut-Bourjac;136;1;137
76;Occitanie;31;3;13;371;Montégut-Lauragais;430;15;445
76;Occitanie;31;2;02;372;Montespan;457;7;464
76;Occitanie;31;2;06;373;Montesquieu-Guittaut;178;2;180
76;Occitanie;31;3;13;374;Montesquieu-Lauragais;993;13;1006
76;Occitanie;31;1;01;375;Montesquieu-Volvestre;3079;68;3147
76;Occitanie;31;2;02;376;Montgaillard-de-Salies;104;3;107
76;Occitanie;31;3;13;377;Montgaillard-Lauragais;727;9;736
76;Occitanie;31;2;14;378;Montgaillard-sur-Save;83;2;85
76;Occitanie;31;1;01;379;Montgazin;188;2;190
76;Occitanie;31;3;07;380;Montgeard;489;8;497
76;Occitanie;31;3;07;381;Montgiscard;2536;59;2595
76;Occitanie;31;1;06;382;Montgras;108;1;109
76;Occitanie;31;3;10;383;Montjoire;1283;25;1308
76;Occitanie;31;3;07;384;Montlaur;1737;35;1772
76;Occitanie;31;2;14;385;Montmaurin;206;4;210
76;Occitanie;31;2;06;386;Montoulieu-Saint-Bernard;213;6;219
76;Occitanie;31;1;06;387;Montoussin;130;0;130
76;Occitanie;31;3;10;388;Montpitol;389;12;401
76;Occitanie;31;3;24;389;Montrabé;4089;77;4166
76;Occitanie;31;2;14;390;Montréjeau;2763;33;2796
76;Occitanie;31;2;02;391;Montsaunès;448;31;479
76;Occitanie;31;3;13;392;Mourvilles-Basses;77;4;81
76;Occitanie;31;3;13;393;Mourvilles-Hautes;168;5;173
76;Occitanie;31;2;02;394;Moustajon;132;3;135
76;Occitanie;31;1;09;395;Muret;24813;561;25374
76;Occitanie;31;3;07;396;Nailloux;3900;63;3963
76;Occitanie;31;2;14;397;Nénigan;61;1;62
76;Occitanie;31;2;14;398;Nizan-Gesse;93;1;94
76;Occitanie;31;1;01;399;Noé;2904;64;2968
76;Occitanie;31;3;13;400;Nogaret;86;0;86
76;Occitanie;31;3;07;401;Noueilles;397;6;403
76;Occitanie;31;3;07;402;Odars;889;31;920
76;Occitanie;31;3;08;403;Ondes;748;133;881
76;Occitanie;31;2;02;404;Oô;97;4;101
76;Occitanie;31;2;02;405;Ore;108;3;111
76;Occitanie;31;1;06;406;Palaminy;808;11;819
76;Occitanie;31;3;10;407;Paulhac;1238;29;1267
76;Occitanie;31;2;02;408;Payssous;89;3;92
76;Occitanie;31;3;04;409;Péchabou;2341;54;2395
76;Occitanie;31;3;10;410;Pechbonnieu;4429;86;4515
76;Occitanie;31;3;04;411;Pechbusque;885;21;906
76;Occitanie;31;2;14;412;Péguilhan;276;8;284
76;Occitanie;31;3;08;413;Pelleport;511;12;523
76;Occitanie;31;2;06;414;Peyrissas;82;2;84
76;Occitanie;31;2;06;415;Peyrouzet;83;2;85
76;Occitanie;31;1;01;416;Peyssies;583;7;590
76;Occitanie;31;3;21;417;Pibrac;8517;252;8769
76;Occitanie;31;3;24;418;Pin-Balma;921;32;953
76;Occitanie;31;1;06;419;Le Pin-Murelet;175;4;179
76;Occitanie;31;1;12;421;Pins-Justaret;4363;69;4432
76;Occitanie;31;1;12;420;Pinsaguel;2806;37;2843
76;Occitanie;31;1;06;422;Plagne;95;0;95
76;Occitanie;31;1;06;423;Plagnole;304;3;307
76;Occitanie;31;3;11;424;Plaisance-du-Touch;18888;402;19290
76;Occitanie;31;1;06;425;Le Plan;444;7;451
76;Occitanie;31;2;02;426;Pointis-de-Rivière;850;11;861
76;Occitanie;31;2;14;427;Pointis-Inard;926;15;941
76;Occitanie;31;1;06;428;Polastron;52;2;54
76;Occitanie;31;3;07;429;Pompertuzat;2317;38;2355
76;Occitanie;31;2;14;430;Ponlat-Taillebourg;607;14;621
76;Occitanie;31;2;02;431;Portet-d'Aspet;62;1;63
76;Occitanie;31;2;02;432;Portet-de-Luchon;38;4;42
76;Occitanie;31;1;12;433;Portet-sur-Garonne;9791;124;9915
76;Occitanie;31;2;02;434;Poubeau;78;4;82
76;Occitanie;31;1;06;435;Poucharramet;909;13;922
76;Occitanie;31;1;06;436;Pouy-de-Touges;407;10;417
76;Occitanie;31;3;07;437;Pouze;86;4;90
76;Occitanie;31;3;07;439;Préserville;716;15;731
76;Occitanie;31;2;02;440;Proupiary;74;1;75
76;Occitanie;31;3;13;441;Prunet;150;2;152
76;Occitanie;31;1;01;442;Puydaniel;535;8;543
76;Occitanie;31;2;06;443;Puymaurin;292;5;297
76;Occitanie;31;3;08;444;Puysségur;143;4;147
76;Occitanie;31;3;24;445;Quint-Fonsegrives;5641;113;5754
76;Occitanie;31;3;25;446;Ramonville-Saint-Agne;14467;308;14775
76;Occitanie;31;2;02;447;Razecueillé;36;1;37
76;Occitanie;31;3;04;448;Rebigue;467;24;491
76;Occitanie;31;2;14;449;Régades;136;4;140
76;Occitanie;31;3;13;450;Renneville;547;13;560
76;Occitanie;31;3;13;451;Revel;9610;306;9916
76;Occitanie;31;2;14;452;Rieucazé;55;0;55
76;Occitanie;31;3;13;453;Rieumajou;136;2;138
76;Occitanie;31;1;06;454;Rieumes;3531;85;3616
76;Occitanie;31;1;01;455;Rieux-Volvestre;2595;55;2650
76;Occitanie;31;2;06;456;Riolas;50;1;51
76;Occitanie;31;2;02;457;Roquefort-sur-Garonne;790;13;803
76;Occitanie;31;1;12;458;Roques;4654;53;4707
76;Occitanie;31;3;10;459;Roquesérière;695;17;712
76;Occitanie;31;1;12;460;Roquettes;4131;66;4197
76;Occitanie;31;2;02;461;Rouède;291;3;294
76;Occitanie;31;3;10;462;Rouffiac-Tolosan;1909;40;1949
76;Occitanie;31;3;13;463;Roumens;245;4;249
76;Occitanie;31;1;11;464;Sabonnères;319;9;328
76;Occitanie;31;2;02;465;Saccourvielle;17;0;17
76;Occitanie;31;1;11;466;Saiguède;803;22;825
76;Occitanie;31;3;05;467;Saint-Alban;6183;50;6233
76;Occitanie;31;2;06;468;Saint-André;227;8;235
76;Occitanie;31;1;06;469;Saint-Araille;144;3;147
76;Occitanie;31;2;02;470;Saint-Aventin;66;3;69
76;Occitanie;31;2;02;471;Saint-Béat-Lez ;382;8;390
76;Occitanie;31;2;02;472;Saint-Bertrand-de-Comminges;242;6;248
76;Occitanie;31;3;08;473;Saint-Cézert;435;1;436
76;Occitanie;31;1;01;474;Saint-Christaud;241;4;245
76;Occitanie;31;1;09;475;Saint-Clar-de-Rivière;1358;26;1384
76;Occitanie;31;1;06;476;Saint-Élix-le-Château;889;20;909
76;Occitanie;31;2;06;477;Saint-Élix-Séglan;42;0;42
76;Occitanie;31;3;13;478;Saint-Félix-Lauragais;1270;34;1304
76;Occitanie;31;2;14;479;Saint-Ferréol-de-Comminges;59;1;60
76;Occitanie;31;2;06;482;Saint-Frajou;214;4;218
76;Occitanie;31;2;14;483;Saint-Gaudens;11604;560;12164
76;Occitanie;31;3;10;484;Saint-Geniès-Bellevue;2452;63;2515
76;Occitanie;31;3;13;485;Saint-Germier;113;2;115
76;Occitanie;31;1;09;486;Saint-Hilaire;1282;20;1302
76;Occitanie;31;2;14;487;Saint-Ignan;227;5;232
76;Occitanie;31;3;23;488;Saint-Jean;10929;138;11067
76;Occitanie;31;3;10;489;Saint-Jean-Lherm;376;11;387
76;Occitanie;31;3;05;490;Saint-Jory;5902;63;5965
76;Occitanie;31;3;13;491;Saint-Julia;413;11;424
76;Occitanie;31;1;01;492;Saint-Julien-sur-Garonne;552;5;557
76;Occitanie;31;2;14;493;Saint-Lary-Boujean;136;6;142
76;Occitanie;31;2;06;494;Saint-Laurent;180;1;181
76;Occitanie;31;3;07;495;Saint-Léon;1279;13;1292
76;Occitanie;31;3;10;497;Saint-Loup-Cammas;2192;45;2237
76;Occitanie;31;2;14;498;Saint-Loup-en-Comminges;37;0;37
76;Occitanie;31;1;11;499;Saint-Lys;9488;182;9670
76;Occitanie;31;2;02;500;Saint-Mamet;558;19;577
76;Occitanie;31;3;10;501;Saint-Marcel-Paulel;420;7;427
76;Occitanie;31;2;14;502;Saint-Marcet;361;9;370
76;Occitanie;31;2;02;503;Saint-Martory;1000;11;1011
76;Occitanie;31;2;02;504;Saint-Médard;222;16;238
76;Occitanie;31;1;06;505;Saint-Michel;320;6;326
76;Occitanie;31;3;04;506;Saint-Orens-de-Gameville;12522;218;12740
76;Occitanie;31;2;02;508;Saint-Paul-d'Oueil;34;0;34
76;Occitanie;31;3;08;507;Saint-Paul-sur-Save;1627;24;1651
76;Occitanie;31;2;02;509;Saint-Pé-d'Ardet;152;1;153
76;Occitanie;31;2;14;510;Saint-Pé-Delbosc;141;0;141
76;Occitanie;31;3;10;511;Saint-Pierre;235;8;243
76;Occitanie;31;3;13;512;Saint-Pierre-de-Lages;888;27;915
76;Occitanie;31;2;14;513;Saint-Plancard;371;6;377
76;Occitanie;31;3;13;514;Saint-Rome;56;2;58
76;Occitanie;31;3;27;515;Saint-Rustice;448;9;457
76;Occitanie;31;3;27;516;Saint-Sauveur;1768;16;1784
76;Occitanie;31;1;01;517;Saint-Sulpice-sur-Lèze;2356;62;2418
76;Occitanie;31;1;11;518;Saint-Thomas;577;15;592
76;Occitanie;31;3;13;519;Saint-Vincent;192;8;200
76;Occitanie;31;3;07;480;Sainte-Foy-d'Aigrefeuille;2045;61;2106
76;Occitanie;31;1;06;481;Sainte-Foy-de-Peyrolières;2091;46;2137
76;Occitanie;31;3;08;496;Sainte-Livrade;261;13;274
76;Occitanie;31;1;06;520;Sajas;122;3;125
76;Occitanie;31;2;02;521;Saleich;340;8;348
76;Occitanie;31;2;06;522;Salerm;58;2;60
76;Occitanie;31;2;02;523;Salies-du-Salat;1775;106;1881
76;Occitanie;31;2;02;524;Salles-et-Pratviel;131;2;133
76;Occitanie;31;1;01;525;Salles-sur-Garonne;584;14;598
76;Occitanie;31;3;13;527;La Salvetat-Lauragais;146;3;149
76;Occitanie;31;3;08;526;La Salvetat-Saint-Gilles;8397;192;8589
76;Occitanie;31;2;14;528;Saman;126;4;130
76;Occitanie;31;2;06;529;Samouillan;118;2;120
76;Occitanie;31;1;06;530;Sana;254;5;259
76;Occitanie;31;2;14;531;Sarrecave;78;0;78
76;Occitanie;31;2;14;532;Sarremezan;95;0;95
76;Occitanie;31;1;12;533;Saubens;2240;50;2290
76;Occitanie;31;3;13;534;Saussens;208;0;208
76;Occitanie;31;2;02;535;Sauveterre-de-Comminges;658;17;675
76;Occitanie;31;2;14;536;Saux-et-Pomarède;262;8;270
76;Occitanie;31;2;14;537;Savarthès;176;5;181
76;Occitanie;31;1;06;538;Savères;222;4;226
76;Occitanie;31;2;14;539;Sédeilhac;62;2;64
76;Occitanie;31;3;13;540;Ségreville;309;8;317
76;Occitanie;31;3;03;541;Seilh;3277;74;3351
76;Occitanie;31;2;02;542;Seilhan;208;3;211
76;Occitanie;31;1;06;543;Sénarens;109;2;111
76;Occitanie;31;2;02;544;Sengouagnet;210;2;212
76;Occitanie;31;2;02;545;Sepx;217;4;221
76;Occitanie;31;3;07;546;Seyre;131;2;133
76;Occitanie;31;1;09;547;Seysses;9322;121;9443
76;Occitanie;31;2;02;548;Signac;49;0;49
76;Occitanie;31;2;02;549;Sode;19;0;19
76;Occitanie;31;2;02;550;Soueich;527;15;542
76;Occitanie;31;3;13;551;Tarabel;500;16;516
76;Occitanie;31;2;06;552;Terrebasse;135;4;139
76;Occitanie;31;3;08;553;Thil;1161;25;1186
76;Occitanie;31;2;02;554;Touille;242;1;243
76;Occitanie;31;3;99;555;Toulouse;486828;5114;491942
76;Occitanie;31;3;26;557;Tournefeuille;27688;609;28297
76;Occitanie;31;2;14;556;Les Tourreilles;380;9;389
76;Occitanie;31;3;13;558;Toutens;345;4;349
76;Occitanie;31;2;02;559;Trébons-de-Luchon;6;0;6
76;Occitanie;31;3;13;560;Trébons-sur-la-Grasse;460;8;468
76;Occitanie;31;3;23;561;L' Union;11458;166;11624
76;Occitanie;31;2;02;562;Urau;121;1;122
76;Occitanie;31;3;27;563;Vacquiers;1310;36;1346
76;Occitanie;31;2;02;564;Valcabrère;142;1;143
76;Occitanie;31;2;14;565;Valentine;878;15;893
76;Occitanie;31;3;13;566;Vallègue;522;4;526
76;Occitanie;31;3;13;567;Vallesvilles;426;6;432
76;Occitanie;31;3;07;568;Varennes;272;5;277
76;Occitanie;31;3;13;569;Vaudreuille;382;10;392
76;Occitanie;31;3;13;570;Vaux;298;5;303
76;Occitanie;31;3;13;571;Vendine;287;4;291
76;Occitanie;31;1;12;572;Venerque;2633;84;2717
76;Occitanie;31;3;10;573;Verfeil;3631;71;3702
76;Occitanie;31;1;12;574;Vernet;2985;34;3019
76;Occitanie;31;3;04;575;Vieille-Toulouse;1170;37;1207
76;Occitanie;31;3;13;576;Vieillevigne;345;7;352
76;Occitanie;31;3;08;577;Vignaux;141;0;141
76;Occitanie;31;3;04;578;Vigoulet-Auzil;918;31;949
76;Occitanie;31;3;10;579;Villariès;796;13;809
76;Occitanie;31;1;12;580;Villate;943;20;963
76;Occitanie;31;3;27;581;Villaudric;1557;31;1588
76;Occitanie;31;3;13;582;Villefranche-de-Lauragais;4662;63;4725
76;Occitanie;31;3;27;583;Villematier;1068;25;1093
76;Occitanie;31;3;27;584;Villemur-sur-Tarn;5962;96;6058
76;Occitanie;31;2;14;585;Villeneuve-de-Rivière;1789;42;1831
76;Occitanie;31;2;14;586;Villeneuve-Lécussan;558;3;561
76;Occitanie;31;3;27;587;Villeneuve-lès-Bouloc;1624;12;1636
76;Occitanie;31;3;26;588;Villeneuve-Tolosane;9987;125;10112
76;Occitanie;31;3;13;589;Villenouvelle;1404;18;1422
76;Occitanie;32;3;01;001;Aignan;730;64;794
76;Occitanie;32;1;05;002;Ansan;78;5;83
76;Occitanie;32;1;10;003;Antras;47;2;49
76;Occitanie;32;3;01;004;Arblade-le-Bas;142;2;144
76;Occitanie;32;2;12;005;Arblade-le-Haut;318;5;323
76;Occitanie;32;2;11;007;Ardizas;222;5;227
76;Occitanie;32;3;16;008;Armentieux;75;0;75
76;Occitanie;32;3;16;009;Armous-et-Cau;88;1;89
76;Occitanie;32;3;03;010;Arrouède;103;0;103
76;Occitanie;32;1;05;012;Aubiet;1095;28;1123
76;Occitanie;32;1;99;013;Auch;22200;1099;23299
76;Occitanie;32;1;10;014;Augnax;112;5;117
76;Occitanie;32;3;03;015;Aujan-Mournède;89;1;90
76;Occitanie;32;1;13;016;Auradé;671;16;687
76;Occitanie;32;3;01;017;Aurensan;134;5;139
76;Occitanie;32;1;03;018;Aurimont;209;3;212
76;Occitanie;32;3;03;468;Aussos;82;0;82
76;Occitanie;32;1;06;019;Auterive;518;17;535
76;Occitanie;32;3;15;020;Aux-Aussat;278;8;286
76;Occitanie;32;2;11;021;Avensac;75;1;76
76;Occitanie;32;3;01;022;Avéron-Bergelle;154;6;160
76;Occitanie;32;2;09;023;Avezan;109;3;112
76;Occitanie;32;1;07;024;Ayguetinte;162;3;165
76;Occitanie;32;2;12;025;Ayzieu;159;2;161
76;Occitanie;32;2;11;026;Bajonnette;109;0;109
76;Occitanie;32;3;01;027;Barcelonne-du-Gers;1375;38;1413
76;Occitanie;32;3;15;028;Barcugnan;106;3;109
76;Occitanie;32;3;04;029;Barran;667;20;687
76;Occitanie;32;3;16;030;Bars;129;3;132
76;Occitanie;32;2;08;031;Bascous;165;2;167
76;Occitanie;32;3;16;032;Bassoues;320;4;324
76;Occitanie;32;1;08;033;Bazian;108;0;108
76;Occitanie;32;3;15;034;Bazugues;55;3;58
76;Occitanie;32;2;07;035;Beaucaire;246;4;250
76;Occitanie;32;3;16;036;Beaumarchés;665;40;705
76;Occitanie;32;2;02;037;Beaumont;133;7;140
76;Occitanie;32;1;11;038;Beaupuy;197;8;205
76;Occitanie;32;3;15;039;Beccas;118;4;122
76;Occitanie;32;1;03;040;Bédéchan;144;1;145
76;Occitanie;32;3;03;041;Bellegarde;181;4;185
76;Occitanie;32;3;15;042;Belloc-Saint-Clamens;129;4;133
76;Occitanie;32;1;08;043;Belmont;150;4;154
76;Occitanie;32;2;07;044;Béraut;320;9;329
76;Occitanie;32;3;15;045;Berdoues;420;19;439
76;Occitanie;32;3;01;046;Bernède;205;1;206
76;Occitanie;32;2;14;047;Berrac;107;1;108
76;Occitanie;32;1;17;048;Betcave-Aguin;87;0;87
76;Occitanie;32;2;12;049;Bétous;82;3;85
76;Occitanie;32;3;15;050;Betplan;97;4;101
76;Occitanie;32;1;17;051;Bézéril;129;2;131
76;Occitanie;32;1;08;052;Bezolles;138;4;142
76;Occitanie;32;3;03;053;Bézues-Bajon;191;3;194
76;Occitanie;32;1;10;054;Biran;388;9;397
76;Occitanie;32;2;09;055;Bivès;133;2;135
76;Occitanie;32;1;05;056;Blanquefort;53;4;57
76;Occitanie;32;2;07;057;Blaziert;133;3;136
76;Occitanie;32;3;16;058;Blousson-Sérian;41;2;43
76;Occitanie;32;1;10;059;Bonas;134;2;136
76;Occitanie;32;3;06;060;Boucagnères;214;4;218
76;Occitanie;32;1;03;061;Boulaur;186;3;189
76;Occitanie;32;2;12;062;Bourrouillan;160;2;162
76;Occitanie;32;3;01;063;Bouzon-Gellenave;184;9;193
76;Occitanie;32;2;02;064;Bretagne-d'Armagnac;410;12;422
76;Occitanie;32;3;04;065;Le Brouilh-Monbert;228;3;231
76;Occitanie;32;2;09;066;Brugnens;256;11;267
76;Occitanie;32;3;03;067;Cabas-Loumassès;52;4;56
76;Occitanie;32;2;09;068;Cadeilhan;139;3;142
76;Occitanie;32;1;17;069;Cadeillan;63;3;66
76;Occitanie;32;3;01;070;Cahuzac-sur-Adour;217;3;220
76;Occitanie;32;1;08;071;Caillavet;195;9;204
76;Occitanie;32;1;08;072;Callian;48;1;49
76;Occitanie;32;2;12;073;Campagne-d'Armagnac;219;3;222
76;Occitanie;32;2;02;075;Cassaigne;225;4;229
76;Occitanie;32;1;03;076;Castelnau-Barbarens;531;10;541
76;Occitanie;32;3;16;077;Castelnau-d'Anglès;88;2;90
76;Occitanie;32;2;09;078;Castelnau-d'Arbieu;232;9;241
76;Occitanie;32;2;02;079;Castelnau d'Auzan Labarrère;1234;23;1257
76;Occitanie;32;2;07;080;Castelnau-sur-l'Auvignon;143;6;149
76;Occitanie;32;3;01;081;Castelnavet;131;2;133
76;Occitanie;32;2;14;082;Castéra-Lectourois;349;6;355
76;Occitanie;32;1;07;083;Castéra-Verduzan;997;24;1021
76;Occitanie;32;2;09;084;Castéron;52;2;54
76;Occitanie;32;2;14;085;Castet-Arrouy;180;7;187
76;Occitanie;32;3;15;086;Castex;82;2;84
76;Occitanie;32;2;12;087;Castex-d'Armagnac;113;4;117
76;Occitanie;32;1;08;088;Castillon-Debats;323;0;323
76;Occitanie;32;1;10;089;Castillon-Massas;247;6;253
76;Occitanie;32;1;17;090;Castillon-Savès;342;8;350
76;Occitanie;32;1;10;091;Castin;355;17;372
76;Occitanie;32;2;11;092;Catonvielle;95;4;99
76;Occitanie;32;3;01;093;Caumont;100;7;107
76;Occitanie;32;2;12;094;Caupenne-d'Armagnac;431;16;447
76;Occitanie;32;2;07;095;Caussens;610;12;622
76;Occitanie;32;2;12;096;Cazaubon;1639;36;1675
76;Occitanie;32;1;08;097;Cazaux-d'Anglès;118;2;120
76;Occitanie;32;1;17;098;Cazaux-Savès;316;5;321
76;Occitanie;32;3;16;099;Cazaux-Villecomtal;72;2;74
76;Occitanie;32;2;02;100;Cazeneuve;155;4;159
76;Occitanie;32;2;09;101;Céran;227;3;230
76;Occitanie;32;2;09;102;Cézan;225;2;227
76;Occitanie;32;3;03;103;Chélan;171;8;179
76;Occitanie;32;3;15;104;Clermont-Pouyguillès;160;3;163
76;Occitanie;32;1;13;105;Clermont-Savès;354;10;364
76;Occitanie;32;2;11;106;Cologne;920;68;988
76;Occitanie;32;2;07;107;Condom;6508;207;6715
76;Occitanie;32;3;01;108;Corneillan;153;10;163
76;Occitanie;32;3;16;109;Couloumé-Mondebat;196;5;201
76;Occitanie;32;2;08;110;Courrensan;401;5;406
76;Occitanie;32;3;16;111;Courties;53;0;53
76;Occitanie;32;1;10;112;Crastes;251;12;263
76;Occitanie;32;2;12;113;Cravencères;91;1;92
76;Occitanie;32;3;03;114;Cuélas;124;5;129
76;Occitanie;32;2;08;115;Dému;333;3;336
76;Occitanie;32;3;15;116;Duffort;148;4;152
76;Occitanie;32;1;10;117;Duran;861;28;889
76;Occitanie;32;3;06;118;Durban;146;5;151
76;Occitanie;32;2;02;119;Eauze;3942;71;4013
76;Occitanie;32;2;11;120;Encausse;426;9;435
76;Occitanie;32;1;13;121;Endoufielle;516;16;532
76;Occitanie;32;3;03;122;Esclassan-Labastide;352;10;362
76;Occitanie;32;1;11;123;Escornebœuf;565;13;578
76;Occitanie;32;1;17;124;Espaon;187;0;187
76;Occitanie;32;2;12;125;Espas;123;1;124
76;Occitanie;32;3;15;126;Estampes;160;1;161
76;Occitanie;32;2;12;127;Estang;646;15;661
76;Occitanie;32;3;16;128;Estipouy;206;12;218
76;Occitanie;32;2;09;129;Estramiac;146;0;146
76;Occitanie;32;3;03;130;Faget-Abbatial;217;1;218
76;Occitanie;32;2;14;131;Flamarens;153;2;155
76;Occitanie;32;2;09;132;Fleurance;5982;111;6093
76;Occitanie;32;2;02;133;Fourcès;261;2;263
76;Occitanie;32;1;13;134;Frégouville;343;6;349
76;Occitanie;32;3;01;135;Fustérouau;135;5;140
76;Occitanie;32;3;16;136;Galiax;168;5;173
76;Occitanie;32;1;17;138;Garravet;155;4;159
76;Occitanie;32;2;09;139;Gaudonville;112;1;113
76;Occitanie;32;1;17;140;Gaujac;69;0;69
76;Occitanie;32;1;17;141;Gaujan;116;0;116
76;Occitanie;32;2;09;142;Gavarret-sur-Aulouste;140;2;142
76;Occitanie;32;2;14;143;Gazaupouy;285;11;296
76;Occitanie;32;1;08;144;Gazax-et-Baccarisse;76;0;76
76;Occitanie;32;3;01;145;Gée-Rivière;46;2;48
76;Occitanie;32;2;14;146;Gimbrède;273;4;277
76;Occitanie;32;1;11;147;Gimont;3025;69;3094
76;Occitanie;32;1;11;148;Giscaro;101;0;101
76;Occitanie;32;2;02;149;Gondrin;1196;34;1230
76;Occitanie;32;2;09;150;Goutz;212;6;218
76;Occitanie;32;3;01;151;Goux;63;0;63
76;Occitanie;32;3;15;152;Haget;332;11;343
76;Occitanie;32;3;06;153;Haulies;168;1;169
76;Occitanie;32;2;11;154;Homps;107;1;108
76;Occitanie;32;2;12;155;Le Houga;1168;51;1219
76;Occitanie;32;3;15;156;Idrac-Respaillès;216;4;220
76;Occitanie;32;1;05;157;L' Isle-Arné;181;3;184
76;Occitanie;32;2;14;158;L' Isle-Bouzon;243;10;253
76;Occitanie;32;3;16;159;L' Isle-de-Noé;547;14;561
76;Occitanie;32;1;13;160;L' Isle-Jourdain;8961;219;9180
76;Occitanie;32;3;16;161;Izotges;98;4;102
76;Occitanie;32;1;10;162;Jegun;1145;50;1195
76;Occitanie;32;3;16;163;Jû-Belloc;296;9;305
76;Occitanie;32;3;16;164;Juillac;118;2;120
76;Occitanie;32;1;05;165;Juilles;218;6;224
76;Occitanie;32;1;08;166;Justian;120;1;121
76;Occitanie;32;3;15;167;Laas;303;5;308
76;Occitanie;32;3;03;169;Labarthe;150;4;154
76;Occitanie;32;3;01;170;Labarthète;140;3;143
76;Occitanie;32;1;17;171;Labastide-Savès;176;1;177
76;Occitanie;32;3;15;172;Labéjan;299;15;314
76;Occitanie;32;2;11;173;Labrihe;211;8;219
76;Occitanie;32;3;16;174;Ladevèze-Rivière;218;4;222
76;Occitanie;32;3;16;175;Ladevèze-Ville;223;7;230
76;Occitanie;32;2;14;176;Lagarde;119;5;124
76;Occitanie;32;3;15;177;Lagarde-Hachan;166;5;171
76;Occitanie;32;2;07;178;Lagardère;77;3;80
76;Occitanie;32;2;02;180;Lagraulet-du-Gers;569;9;578
76;Occitanie;32;3;15;181;Laguian-Mazous;243;2;245
76;Occitanie;32;1;17;182;Lahas;180;6;186
76;Occitanie;32;1;05;183;Lahitte;236;11;247
76;Occitanie;32;2;09;184;Lalanne;132;3;135
76;Occitanie;32;3;03;185;Lalanne-Arqué;154;4;158
76;Occitanie;32;3;03;186;Lamaguère;81;0;81
76;Occitanie;32;3;15;187;Lamazère;121;7;128
76;Occitanie;32;2;09;188;Lamothe-Goas;78;3;81
76;Occitanie;32;2;12;191;Lanne-Soubiran;143;1;144
76;Occitanie;32;2;12;189;Lannemaignan;107;3;110
76;Occitanie;32;2;08;190;Lannepax;501;6;507
76;Occitanie;32;3;01;192;Lannux;240;7;247
76;Occitanie;32;2;12;193;Larée;229;3;232
76;Occitanie;32;2;02;194;Larressingle;211;7;218
76;Occitanie;32;2;14;195;Larroque-Engalin;47;2;49
76;Occitanie;32;2;07;196;Larroque-Saint-Sernin;166;0;166
76;Occitanie;32;2;02;197;Larroque-sur-l'Osse;229;6;235
76;Occitanie;32;1;03;198;Lartigue;188;4;192
76;Occitanie;32;3;16;199;Lasserade;194;9;203
76;Occitanie;32;3;04;200;Lasséran;378;11;389
76;Occitanie;32;3;06;201;Lasseube-Propre;340;7;347
76;Occitanie;32;2;12;202;Laujuzan;279;15;294
76;Occitanie;32;2;02;203;Lauraët;251;3;254
76;Occitanie;32;1;10;204;Lavardens;377;11;388
76;Occitanie;32;3;16;205;Laveraët;107;1;108
76;Occitanie;32;1;17;206;Laymont;212;3;215
76;Occitanie;32;1;05;207;Leboulin;341;17;358
76;Occitanie;32;2;14;208;Lectoure;3665;355;4020
76;Occitanie;32;3;01;209;Lelin-Lapujolle;280;3;283
76;Occitanie;32;1;13;210;Lias;672;14;686
76;Occitanie;32;2;12;211;Lias-d'Armagnac;196;7;203
76;Occitanie;32;2;14;212;Ligardes;216;4;220
76;Occitanie;32;1;17;213;Lombez;2159;36;2195
76;Occitanie;32;2;12;214;Loubédat;104;3;107
76;Occitanie;32;3;15;215;Loubersan;149;11;160
76;Occitanie;32;3;03;216;Lourties-Monbrun;164;1;165
76;Occitanie;32;3;16;217;Louslitges;64;2;66
76;Occitanie;32;3;01;218;Loussous-Débat;63;0;63
76;Occitanie;32;1;08;219;Lupiac;304;11;315
76;Occitanie;32;2;12;220;Luppé-Violles;150;3;153
76;Occitanie;32;1;05;221;Lussan;232;3;235
76;Occitanie;32;2;12;222;Magnan;240;3;243
76;Occitanie;32;2;09;223;Magnas;59;31;90
76;Occitanie;32;2;07;224;Maignaut-Tauzia;247;2;249
76;Occitanie;32;3;15;225;Malabat;109;5;114
76;Occitanie;32;3;15;226;Manas-Bastanous;81;5;86
76;Occitanie;32;2;12;227;Manciet;807;27;834
76;Occitanie;32;3;03;228;Manent-Montané;91;1;92
76;Occitanie;32;2;11;229;Mansempuy;78;9;87
76;Occitanie;32;2;02;230;Mansencôme;47;4;51
76;Occitanie;32;1;08;231;Marambat;442;14;456
76;Occitanie;32;2;11;232;Maravat;42;0;42
76;Occitanie;32;3;16;233;Marciac;1220;86;1306
76;Occitanie;32;1;13;234;Marestaing;324;7;331
76;Occitanie;32;3;01;235;Margouët-Meymes;165;8;173
76;Occitanie;32;2;12;236;Marguestau;70;3;73
76;Occitanie;32;1;05;237;Marsan;479;11;490
76;Occitanie;32;3;15;238;Marseillan;87;3;90
76;Occitanie;32;2;14;239;Marsolan;452;11;463
76;Occitanie;32;2;14;241;Mas-d'Auvignon;171;6;177
76;Occitanie;32;3;16;240;Mascaras;64;4;68
76;Occitanie;32;3;03;242;Masseube;1509;424;1933
76;Occitanie;32;2;12;243;Mauléon-d'Armagnac;272;3;275
76;Occitanie;32;3;01;244;Maulichères;167;4;171
76;Occitanie;32;3;01;245;Maumusson-Laguian;148;7;155
76;Occitanie;32;2;12;246;Maupas;202;3;205
76;Occitanie;32;1;11;247;Maurens;309;7;316
76;Occitanie;32;2;09;248;Mauroux;139;4;143
76;Occitanie;32;2;11;249;Mauvezin;2198;49;2247
76;Occitanie;32;3;03;250;Meilhan;79;1;80
76;Occitanie;32;1;10;251;Mérens;67;0;67
76;Occitanie;32;3;15;252;Miélan;1125;20;1145
76;Occitanie;32;2;14;253;Miradoux;513;12;525
76;Occitanie;32;3;15;254;Miramont-d'Astarac;344;13;357
76;Occitanie;32;2;09;255;Miramont-Latour;159;5;164
76;Occitanie;32;3;15;256;Mirande;3455;317;3772
76;Occitanie;32;1;08;257;Mirannes;64;4;68
76;Occitanie;32;1;10;258;Mirepoix;227;5;232
76;Occitanie;32;3;03;260;Monbardon;79;4;83
76;Occitanie;32;1;17;261;Monblanc;360;7;367
76;Occitanie;32;2;11;262;Monbrun;387;14;401
76;Occitanie;32;3;15;263;Moncassin;130;3;133
76;Occitanie;32;2;12;264;Monclar;202;3;205
76;Occitanie;32;3;16;265;Monclar-sur-Losse;107;2;109
76;Occitanie;32;3;03;266;Moncorneil-Grazan;147;1;148
76;Occitanie;32;3;03;267;Monferran-Plavès;116;2;118
76;Occitanie;32;1;13;268;Monferran-Savès;811;29;840
76;Occitanie;32;2;11;269;Monfort;494;4;498
76;Occitanie;32;1;17;270;Mongausy;79;1;80
76;Occitanie;32;2;12;271;Monguilhem;303;8;311
76;Occitanie;32;3;03;272;Monlaur-Bernet;164;3;167
76;Occitanie;32;3;16;273;Monlezun;187;12;199
76;Occitanie;32;2;12;274;Monlezun-d'Armagnac;201;3;204
76;Occitanie;32;3;16;275;Monpardiac;45;1;46
76;Occitanie;32;3;03;280;Mont-d'Astarac;99;2;101
76;Occitanie;32;3;15;281;Mont-de-Marrast;109;5;114
76;Occitanie;32;1;17;276;Montadet;72;1;73
76;Occitanie;32;1;17;277;Montamat;129;3;132
76;Occitanie;32;3;15;278;Montaut;119;7;126
76;Occitanie;32;1;10;279;Montaut-les-Créneaux;709;19;728
76;Occitanie;32;1;05;282;Montégut;667;12;679
76;Occitanie;32;3;15;283;Montégut-Arros;288;6;294
76;Occitanie;32;1;17;284;Montégut-Savès;63;1;64
76;Occitanie;32;3;16;285;Montesquiou;574;18;592
76;Occitanie;32;2;09;286;Montestruc-sur-Gers;700;11;711
76;Occitanie;32;3;03;287;Monties;79;1;80
76;Occitanie;32;1;05;288;Montiron;142;3;145
76;Occitanie;32;1;17;289;Montpézat;242;4;246
76;Occitanie;32;2;02;290;Montréal;1166;34;1200
76;Occitanie;32;2;12;291;Mormès;120;2;122
76;Occitanie;32;2;02;292;Mouchan;396;13;409
76;Occitanie;32;3;16;293;Mouchès;74;2;76
76;Occitanie;32;1;08;294;Mourède;80;3;83
76;Occitanie;32;1;17;295;Nizas;143;8;151
76;Occitanie;32;2;12;296;Nogaro;2012;164;2176
76;Occitanie;32;1;17;297;Noilhan;374;11;385
76;Occitanie;32;1;05;298;Nougaroulet;376;12;388
76;Occitanie;32;2;08;299;Noulens;102;0;102
76;Occitanie;32;3;06;300;Orbessan;291;3;294
76;Occitanie;32;1;10;301;Ordan-Larroque;905;25;930
76;Occitanie;32;3;06;302;Ornézan;228;10;238
76;Occitanie;32;3;16;303;Pallanne;60;2;62
76;Occitanie;32;3;03;304;Panassac;289;9;298
76;Occitanie;32;2;12;305;Panjas;405;8;413
76;Occitanie;32;2;09;306;Pauilhac;613;48;661
76;Occitanie;32;1;04;307;Pavie;2490;119;2609
76;Occitanie;32;1;17;308;Pébées;104;2;106
76;Occitanie;32;1;17;309;Pellefigue;115;5;120
76;Occitanie;32;2;12;310;Perchède;121;1;122
76;Occitanie;32;2;14;311;Pergain-Taillac;313;6;319
76;Occitanie;32;1;06;312;Pessan;671;14;685
76;Occitanie;32;2;09;313;Pessoulens;141;4;145
76;Occitanie;32;2;14;314;Peyrecave;73;5;78
76;Occitanie;32;1;08;315;Peyrusse-Grande;160;2;162
76;Occitanie;32;1;10;316;Peyrusse-Massas;106;3;109
76;Occitanie;32;1;08;317;Peyrusse-Vieille;68;0;68
76;Occitanie;32;2;09;318;Pis;111;2;113
76;Occitanie;32;3;16;319;Plaisance;1446;26;1472
76;Occitanie;32;2;14;320;Plieux;142;7;149
76;Occitanie;32;1;17;321;Polastron;273;5;278
76;Occitanie;32;1;17;322;Pompiac;196;3;199
76;Occitanie;32;3;15;323;Ponsampère;117;5;122
76;Occitanie;32;3;03;324;Ponsan-Soubiran;85;3;88
76;Occitanie;32;3;03;327;Pouy-Loubrin;84;1;85
76;Occitanie;32;2;14;328;Pouy-Roquelaure;121;6;127
76;Occitanie;32;3;01;325;Pouydraguin;131;2;133
76;Occitanie;32;3;16;326;Pouylebon;142;4;146
76;Occitanie;32;2;09;329;Préchac;164;3;167
76;Occitanie;32;3;16;330;Préchac-sur-Adour;196;5;201
76;Occitanie;32;1;10;331;Preignan;1263;36;1299
76;Occitanie;32;1;08;332;Préneron;130;1;131
76;Occitanie;32;3;01;333;Projan;183;0;183
76;Occitanie;32;1;13;334;Pujaudran;1550;38;1588
76;Occitanie;32;1;10;335;Puycasquier;446;9;455
76;Occitanie;32;1;17;336;Puylausic;161;9;170
76;Occitanie;32;2;09;337;Puységur;75;3;78
76;Occitanie;32;2;08;338;Ramouzens;166;5;171
76;Occitanie;32;1;11;339;Razengues;242;9;251
76;Occitanie;32;2;12;340;Réans;290;3;293
76;Occitanie;32;2;09;341;Réjaumont;242;4;246
76;Occitanie;32;3;16;342;Ricourt;62;2;64
76;Occitanie;32;1;08;343;Riguepeu;189;7;196
76;Occitanie;32;3;01;344;Riscle ;1831;100;1931
76;Occitanie;32;2;14;345;La Romieu;571;15;586
76;Occitanie;32;1;08;346;Roquebrune;213;5;218
76;Occitanie;32;1;10;347;Roquefort;289;7;296
76;Occitanie;32;1;10;348;Roquelaure;567;23;590
76;Occitanie;32;2;11;349;Roquelaure-Saint-Aubin;111;4;115
76;Occitanie;32;2;07;350;Roquepine;33;2;35
76;Occitanie;32;1;08;351;Roques;105;1;106
76;Occitanie;32;1;08;352;Rozès;119;4;123
76;Occitanie;32;1;17;353;Sabaillan;147;7;154
76;Occitanie;32;3;01;354;Sabazan;137;1;138
76;Occitanie;32;3;15;355;Sadeillan;87;2;89
76;Occitanie;32;1;17;356;Saint-André;127;1;128
76;Occitanie;32;2;14;358;Saint-Antoine;192;4;196
76;Occitanie;32;2;11;359;Saint-Antonin;155;5;160
76;Occitanie;32;1;08;360;Saint-Arailles;137;3;140
76;Occitanie;32;3;03;361;Saint-Arroman;137;8;145
76;Occitanie;32;3;16;362;Saint-Aunix-Lengros;142;3;145
76;Occitanie;32;2;14;364;Saint-Avit-Frandat;97;3;100
76;Occitanie;32;3;03;365;Saint-Blancard;338;6;344
76;Occitanie;32;2;11;366;Saint-Brès;75;1;76
76;Occitanie;32;1;05;467;Saint-Caprais;140;4;144
76;Occitanie;32;3;16;367;Saint-Christaud;65;2;67
76;Occitanie;32;2;09;370;Saint-Clar;1031;66;1097
76;Occitanie;32;2;09;371;Saint-Créac;82;1;83
76;Occitanie;32;2;11;372;Saint-Cricq;292;4;296
76;Occitanie;32;1;17;374;Saint-Élix-d'Astarac;181;6;187
76;Occitanie;32;3;15;375;Saint-Élix-Theux;100;5;105
76;Occitanie;32;2;11;377;Saint-Georges;180;1;181
76;Occitanie;32;3;01;378;Saint-Germé;497;6;503
76;Occitanie;32;2;11;379;Saint-Germier;211;7;218
76;Occitanie;32;2;12;380;Saint-Griède;139;10;149
76;Occitanie;32;3;04;381;Saint-Jean-le-Comtal;412;20;432
76;Occitanie;32;1;08;382;Saint-Jean-Poutge;315;14;329
76;Occitanie;32;3;16;383;Saint-Justin;128;6;134
76;Occitanie;32;1;10;384;Saint-Lary;277;6;283
76;Occitanie;32;2;09;385;Saint-Léonard;183;1;184
76;Occitanie;32;1;17;386;Saint-Lizier-du-Planté;141;1;142
76;Occitanie;32;1;17;387;Saint-Loube;98;2;100
76;Occitanie;32;3;15;389;Saint-Martin;459;20;479
76;Occitanie;32;2;12;390;Saint-Martin-d'Armagnac;244;5;249
76;Occitanie;32;2;14;391;Saint-Martin-de-Goyne;125;7;132
76;Occitanie;32;1;03;392;Saint-Martin-Gimois;90;1;91
76;Occitanie;32;3;15;393;Saint-Maur;139;5;144
76;Occitanie;32;3;15;394;Saint-Médard;332;5;337
76;Occitanie;32;2;14;396;Saint-Mézard;229;3;232
76;Occitanie;32;3;15;397;Saint-Michel;249;14;263
76;Occitanie;32;3;01;398;Saint-Mont;320;10;330
76;Occitanie;32;2;11;399;Saint-Orens;81;3;84
76;Occitanie;32;2;07;400;Saint-Orens-Pouy-Petit;203;8;211
76;Occitanie;32;3;15;401;Saint-Ost;90;1;91
76;Occitanie;32;1;08;402;Saint-Paul-de-Baïse;104;3;107
76;Occitanie;32;1;08;403;Saint-Pierre-d'Aubézies;63;1;64
76;Occitanie;32;2;07;404;Saint-Puy;593;15;608
76;Occitanie;32;1;11;406;Saint-Sauvy;347;10;357
76;Occitanie;32;1;17;407;Saint-Soulan;159;4;163
76;Occitanie;32;2;11;357;Sainte-Anne;120;1;121
76;Occitanie;32;3;15;363;Sainte-Aurence-Cazaux;98;4;102
76;Occitanie;32;1;10;368;Sainte-Christie;546;11;557
76;Occitanie;32;2;12;369;Sainte-Christie-d'Armagnac;376;12;388
76;Occitanie;32;3;15;373;Sainte-Dode;207;10;217
76;Occitanie;32;2;11;376;Sainte-Gemme;116;3;119
76;Occitanie;32;1;11;388;Sainte-Marie;436;7;443
76;Occitanie;32;2;14;395;Sainte-Mère;212;4;216
76;Occitanie;32;2;09;405;Sainte-Radegonde;180;6;186
76;Occitanie;32;2;12;408;Salles-d'Armagnac;133;4;137
76;Occitanie;32;3;03;409;Samaran;90;0;90
76;Occitanie;32;1;17;410;Samatan;2311;102;2413
76;Occitanie;32;3;06;411;Sansan;101;3;104
76;Occitanie;32;1;03;412;Saramon;834;14;848
76;Occitanie;32;3;03;413;Sarcos;79;2;81
76;Occitanie;32;3;01;414;Sarragachies;234;6;240
76;Occitanie;32;3;15;415;Sarraguzan;88;1;89
76;Occitanie;32;2;11;416;Sarrant;365;15;380
76;Occitanie;32;2;09;417;La Sauvetat;386;12;398
76;Occitanie;32;1;17;418;Sauveterre;274;63;337
76;Occitanie;32;3;15;419;Sauviac;108;3;111
76;Occitanie;32;1;17;420;Sauvimont;66;2;68
76;Occitanie;32;1;17;421;Savignac-Mona;139;1;140
76;Occitanie;32;3;16;422;Scieurac-et-Flourès;42;1;43
76;Occitanie;32;2;08;423;Séailles;51;2;53
76;Occitanie;32;3;01;424;Ségos;225;8;233
76;Occitanie;32;1;13;425;Ségoufielle;1172;28;1200
76;Occitanie;32;3;03;426;Seissan;1087;10;1097
76;Occitanie;32;3;16;427;Sembouès;61;1;62
76;Occitanie;32;1;03;428;Sémézies-Cachan;66;4;70
76;Occitanie;32;2;14;429;Sempesserre;296;5;301
76;Occitanie;32;3;03;430;Sère;79;0;79
76;Occitanie;32;2;11;431;Sérempuy;37;4;41
76;Occitanie;32;1;17;432;Seysses-Savès;241;2;243
76;Occitanie;32;1;17;433;Simorre;711;17;728
76;Occitanie;32;2;12;434;Sion;100;3;103
76;Occitanie;32;2;11;435;Sirac;168;9;177
76;Occitanie;32;2;11;436;Solomiac;479;6;485
76;Occitanie;32;2;12;437;Sorbets;227;6;233
76;Occitanie;32;3;03;438;Tachoires;99;0;99
76;Occitanie;32;3;01;439;Tarsac;169;2;171
76;Occitanie;32;3;16;440;Tasque;252;6;258
76;Occitanie;32;2;09;441;Taybosc;62;0;62
76;Occitanie;32;3;01;443;Termes-d'Armagnac;190;3;193
76;Occitanie;32;2;14;442;Terraube;375;4;379
76;Occitanie;32;2;11;444;Thoux;256;7;263
76;Occitanie;32;3;16;445;Tieste-Uragnoux;162;5;167
76;Occitanie;32;3;16;446;Tillac;283;6;289
76;Occitanie;32;1;03;447;Tirent-Pontéjac;90;1;91
76;Occitanie;32;2;11;448;Touget;509;16;525
76;Occitanie;32;2;12;449;Toujouse;260;2;262
76;Occitanie;32;3;16;450;Tourdun;123;4;127
76;Occitanie;32;1;17;451;Tournan;182;2;184
76;Occitanie;32;2;09;452;Tournecoupe;260;8;268
76;Occitanie;32;1;10;453;Tourrenquets;113;6;119
76;Occitanie;32;3;03;454;Traversères;70;3;73
76;Occitanie;32;3;16;455;Troncens;183;5;188
76;Occitanie;32;1;08;456;Tudelle;56;0;56
76;Occitanie;32;2;09;457;Urdens;287;13;300
76;Occitanie;32;2;12;458;Urgosse;236;3;239
76;Occitanie;32;2;07;459;Valence-sur-Baïse;1127;20;1147
76;Occitanie;32;3;01;460;Vergoignan;307;8;315
76;Occitanie;32;3;01;461;Verlus;109;3;112
76;Occitanie;32;1;08;462;Vic-Fezensac;3509;60;3569
76;Occitanie;32;3;01;463;Viella;511;11;522
76;Occitanie;32;3;15;464;Villecomtal-sur-Arros;848;20;868
76;Occitanie;32;1;17;465;Villefranche;125;5;130
76;Occitanie;32;3;15;466;Viozan;114;2;116
75;Nouvelle-Aquitaine;33;5;21;001;Abzac;1949;26;1975
75;Nouvelle-Aquitaine;33;3;27;002;Aillas;830;14;844
75;Nouvelle-Aquitaine;33;2;26;003;Ambarès-et-Lagrave;16563;156;16719
75;Nouvelle-Aquitaine;33;2;26;004;Ambès;3070;19;3089
75;Nouvelle-Aquitaine;33;6;01;005;Andernos-les-Bains;12096;275;12371
75;Nouvelle-Aquitaine;33;1;13;006;Anglade;935;12;947
75;Nouvelle-Aquitaine;33;3;15;007;Arbanats;1311;7;1318
75;Nouvelle-Aquitaine;33;6;32;009;Arcachon;11567;258;11825
75;Nouvelle-Aquitaine;33;4;30;010;Arcins;509;7;516
75;Nouvelle-Aquitaine;33;6;01;011;Arès;6349;122;6471
75;Nouvelle-Aquitaine;33;4;30;012;Arsac;3634;47;3681
75;Nouvelle-Aquitaine;33;5;21;014;Les Artigues-de-Lussac;1114;21;1135
75;Nouvelle-Aquitaine;33;2;17;013;Artigues-près-Bordeaux;8648;81;8729
75;Nouvelle-Aquitaine;33;5;16;015;Arveyres;1983;41;2024
75;Nouvelle-Aquitaine;33;5;16;016;Asques;451;9;460
75;Nouvelle-Aquitaine;33;3;29;017;Aubiac;270;11;281
75;Nouvelle-Aquitaine;33;6;01;019;Audenge;8336;116;8452
75;Nouvelle-Aquitaine;33;3;27;020;Auriolles;142;0;142
75;Nouvelle-Aquitaine;33;3;27;021;Auros;1025;14;1039
75;Nouvelle-Aquitaine;33;4;30;022;Avensan;3003;40;3043
75;Nouvelle-Aquitaine;33;2;08;023;Ayguemorte-les-Graves;1294;16;1310
75;Nouvelle-Aquitaine;33;3;27;024;Bagas;297;9;306
75;Nouvelle-Aquitaine;33;3;12;025;Baigneaux;446;4;450
75;Nouvelle-Aquitaine;33;3;15;026;Balizac;501;5;506
75;Nouvelle-Aquitaine;33;3;27;027;Barie;292;9;301
75;Nouvelle-Aquitaine;33;5;10;028;Baron;1164;16;1180
75;Nouvelle-Aquitaine;33;6;15;029;Le Barp;5556;81;5637
75;Nouvelle-Aquitaine;33;3;15;030;Barsac;2067;22;2089
75;Nouvelle-Aquitaine;33;3;27;031;Bassanne;125;5;130
75;Nouvelle-Aquitaine;33;2;17;032;Bassens;7404;60;7464
75;Nouvelle-Aquitaine;33;2;11;033;Baurech;898;7;905
75;Nouvelle-Aquitaine;33;5;21;034;Bayas;457;4;461
75;Nouvelle-Aquitaine;33;1;13;035;Bayon-sur-Gironde;713;2;715
75;Nouvelle-Aquitaine;33;3;29;036;Bazas;4798;256;5054
75;Nouvelle-Aquitaine;33;2;08;037;Beautiran;2301;39;2340
75;Nouvelle-Aquitaine;33;4;22;038;Bégadan;912;8;920
75;Nouvelle-Aquitaine;33;2;96;039;Bègles;29669;345;30014
75;Nouvelle-Aquitaine;33;3;12;040;Béguey;1194;13;1207
75;Nouvelle-Aquitaine;33;6;15;042;Belin-Béliet;5633;92;5725
75;Nouvelle-Aquitaine;33;3;12;043;Bellebat;269;1;270
75;Nouvelle-Aquitaine;33;3;12;044;Bellefond;223;6;229
75;Nouvelle-Aquitaine;33;5;10;045;Belvès-de-Castillon;332;8;340
75;Nouvelle-Aquitaine;33;3;29;046;Bernos-Beaulac;1114;29;1143
75;Nouvelle-Aquitaine;33;1;13;047;Berson;1807;31;1838
75;Nouvelle-Aquitaine;33;3;27;048;Berthez;260;7;267
75;Nouvelle-Aquitaine;33;2;26;049;Beychac-et-Caillau;2268;24;2292
75;Nouvelle-Aquitaine;33;3;29;050;Bieujac;629;8;637
75;Nouvelle-Aquitaine;33;6;01;051;Biganos;10921;122;11043
75;Nouvelle-Aquitaine;33;5;16;052;Les Billaux;1169;36;1205
75;Nouvelle-Aquitaine;33;3;29;053;Birac;230;1;231
75;Nouvelle-Aquitaine;33;3;27;054;Blaignac;287;5;292
75;Nouvelle-Aquitaine;33;4;22;055;Blaignan-Prignac ;466;4;470
75;Nouvelle-Aquitaine;33;2;25;056;Blanquefort;15510;605;16115
75;Nouvelle-Aquitaine;33;3;27;057;Blasimon;906;20;926
75;Nouvelle-Aquitaine;33;1;13;058;Blaye;4821;112;4933
75;Nouvelle-Aquitaine;33;2;12;059;Blésignac;301;6;307
75;Nouvelle-Aquitaine;33;3;29;060;Bommes;460;67;527
75;Nouvelle-Aquitaine;33;2;11;061;Bonnetan;968;18;986
75;Nouvelle-Aquitaine;33;5;21;062;Bonzac;745;12;757
75;Nouvelle-Aquitaine;33;2;97;063;Bordeaux;257068;3284;260352
75;Nouvelle-Aquitaine;33;5;10;064;Bossugan;39;0;39
75;Nouvelle-Aquitaine;33;2;09;065;Bouliac;3662;71;3733
75;Nouvelle-Aquitaine;33;3;27;066;Bourdelles;90;1;91
75;Nouvelle-Aquitaine;33;1;13;067;Bourg;2259;38;2297
75;Nouvelle-Aquitaine;33;3;29;068;Bourideys;86;3;89
75;Nouvelle-Aquitaine;33;2;07;069;Le Bouscat;23924;278;24202
75;Nouvelle-Aquitaine;33;4;30;070;Brach;744;2;746
75;Nouvelle-Aquitaine;33;5;10;071;Branne;1298;17;1315
75;Nouvelle-Aquitaine;33;3;27;072;Brannens;242;4;246
75;Nouvelle-Aquitaine;33;1;13;073;Braud-et-Saint-Louis;1570;29;1599
75;Nouvelle-Aquitaine;33;2;08;213;La Brède;4367;490;4857
75;Nouvelle-Aquitaine;33;3;27;074;Brouqueyran;198;8;206
75;Nouvelle-Aquitaine;33;2;07;075;Bruges;18316;174;18490
75;Nouvelle-Aquitaine;33;3;15;076;Budos;797;14;811
75;Nouvelle-Aquitaine;33;2;08;077;Cabanac-et-Villagrains;2416;26;2442
75;Nouvelle-Aquitaine;33;5;10;078;Cabara;510;12;522
75;Nouvelle-Aquitaine;33;5;16;079;Cadarsac;357;7;364
75;Nouvelle-Aquitaine;33;2;08;080;Cadaujac;6217;68;6285
75;Nouvelle-Aquitaine;33;3;12;081;Cadillac;2818;28;2846
75;Nouvelle-Aquitaine;33;5;16;082;Cadillac-en-Fronsadais;1277;15;1292
75;Nouvelle-Aquitaine;33;2;11;083;Camarsac;1010;13;1023
75;Nouvelle-Aquitaine;33;2;11;084;Cambes;1681;17;1698
75;Nouvelle-Aquitaine;33;2;11;085;Camblanes-et-Meynac;2915;142;3057
75;Nouvelle-Aquitaine;33;5;10;086;Camiac-et-Saint-Denis;362;5;367
75;Nouvelle-Aquitaine;33;3;27;087;Camiran;413;5;418
75;Nouvelle-Aquitaine;33;5;21;088;Camps-sur-l'Isle;601;10;611
75;Nouvelle-Aquitaine;33;1;13;089;Campugnan;501;6;507
75;Nouvelle-Aquitaine;33;2;23;090;Canéjan;5860;70;5930
75;Nouvelle-Aquitaine;33;3;12;093;Capian;737;16;753
75;Nouvelle-Aquitaine;33;5;27;094;Caplong;223;7;230
75;Nouvelle-Aquitaine;33;3;29;095;Captieux;1287;21;1308
75;Nouvelle-Aquitaine;33;2;26;096;Carbon-Blanc;8172;81;8253
75;Nouvelle-Aquitaine;33;4;30;097;Carcans;2415;36;2451
75;Nouvelle-Aquitaine;33;3;12;098;Cardan;503;5;508
75;Nouvelle-Aquitaine;33;2;11;099;Carignan-de-Bordeaux;3971;41;4012
75;Nouvelle-Aquitaine;33;1;13;100;Cars;1198;21;1219
75;Nouvelle-Aquitaine;33;1;13;101;Cartelègue;1228;21;1249
75;Nouvelle-Aquitaine;33;3;27;102;Casseuil;391;4;395
75;Nouvelle-Aquitaine;33;3;27;103;Castelmoron-d'Albret;53;0;53
75;Nouvelle-Aquitaine;33;4;30;104;Castelnau-de-Médoc;4788;64;4852
75;Nouvelle-Aquitaine;33;3;27;105;Castelviel;218;12;230
75;Nouvelle-Aquitaine;33;3;29;106;Castets et Castillon ;1458;19;1477
75;Nouvelle-Aquitaine;33;5;10;108;Castillon-la-Bataille;3181;35;3216
75;Nouvelle-Aquitaine;33;2;08;109;Castres-Gironde;2392;19;2411
75;Nouvelle-Aquitaine;33;3;12;111;Caudrot;1148;15;1163
75;Nouvelle-Aquitaine;33;3;27;112;Caumont;146;2;148
75;Nouvelle-Aquitaine;33;3;29;113;Cauvignac;162;3;165
75;Nouvelle-Aquitaine;33;1;20;114;Cavignac;2148;15;2163
75;Nouvelle-Aquitaine;33;3;29;115;Cazalis;234;1;235
75;Nouvelle-Aquitaine;33;3;29;116;Cazats;418;5;423
75;Nouvelle-Aquitaine;33;3;27;117;Cazaugitat;234;3;237
75;Nouvelle-Aquitaine;33;2;11;118;Cénac;1995;34;2029
75;Nouvelle-Aquitaine;33;2;09;119;Cenon;25292;226;25518
75;Nouvelle-Aquitaine;33;3;15;120;Cérons;2114;20;2134
75;Nouvelle-Aquitaine;33;3;12;121;Cessac;192;2;194
75;Nouvelle-Aquitaine;33;2;23;122;Cestas;16936;276;17212
75;Nouvelle-Aquitaine;33;1;20;123;Cézac;2612;33;2645
75;Nouvelle-Aquitaine;33;5;21;124;Chamadelle;730;15;745
75;Nouvelle-Aquitaine;33;4;22;125;Cissac-Médoc;2170;27;2197
75;Nouvelle-Aquitaine;33;1;20;126;Civrac-de-Blaye;861;21;882
75;Nouvelle-Aquitaine;33;4;22;128;Civrac-en-Médoc;675;15;690
75;Nouvelle-Aquitaine;33;5;10;127;Civrac-sur-Dordogne;223;5;228
75;Nouvelle-Aquitaine;33;3;27;129;Cleyrac;158;0;158
75;Nouvelle-Aquitaine;33;3;27;130;Coimères;1034;27;1061
75;Nouvelle-Aquitaine;33;3;12;131;Coirac;206;2;208
75;Nouvelle-Aquitaine;33;1;13;132;Comps;547;8;555
75;Nouvelle-Aquitaine;33;5;10;133;Coubeyrac;71;1;72
75;Nouvelle-Aquitaine;33;4;22;134;Couquèques;276;6;282
75;Nouvelle-Aquitaine;33;3;12;135;Courpiac;125;2;127
75;Nouvelle-Aquitaine;33;3;27;136;Cours-de-Monségur;283;4;287
75;Nouvelle-Aquitaine;33;3;29;137;Cours-les-Bains;220;4;224
75;Nouvelle-Aquitaine;33;5;21;138;Coutras;8582;135;8717
75;Nouvelle-Aquitaine;33;3;27;139;Coutures;98;4;102
75;Nouvelle-Aquitaine;33;2;11;140;Créon;4764;102;4866
75;Nouvelle-Aquitaine;33;2;11;141;Croignon;666;8;674
75;Nouvelle-Aquitaine;33;1;20;142;Cubnezais;1575;16;1591
75;Nouvelle-Aquitaine;33;1;20;143;Cubzac-les-Ponts;2490;26;2516
75;Nouvelle-Aquitaine;33;3;29;144;Cudos;797;147;944
75;Nouvelle-Aquitaine;33;2;11;145;Cursan;654;18;672
75;Nouvelle-Aquitaine;33;4;30;146;Cussac-Fort-Médoc;2294;27;2321
75;Nouvelle-Aquitaine;33;5;10;147;Daignac;470;6;476
75;Nouvelle-Aquitaine;33;5;10;148;Dardenac;87;5;92
75;Nouvelle-Aquitaine;33;3;27;149;Daubèze;154;1;155
75;Nouvelle-Aquitaine;33;3;27;150;Dieulivol;341;2;343
75;Nouvelle-Aquitaine;33;1;20;151;Donnezac;910;18;928
75;Nouvelle-Aquitaine;33;3;12;152;Donzac;118;5;123
75;Nouvelle-Aquitaine;33;5;10;153;Doulezon;266;4;270
75;Nouvelle-Aquitaine;33;5;21;154;Les Églisottes-et-Chalaures;2147;106;2253
75;Nouvelle-Aquitaine;33;3;29;155;Escaudes;155;4;159
75;Nouvelle-Aquitaine;33;3;12;156;Escoussans;293;8;301
75;Nouvelle-Aquitaine;33;5;10;157;Espiet;784;15;799
75;Nouvelle-Aquitaine;33;3;27;158;Les Esseintes;239;8;247
75;Nouvelle-Aquitaine;33;1;13;159;Étauliers;1484;14;1498
75;Nouvelle-Aquitaine;33;5;27;160;Eynesse;587;17;604
75;Nouvelle-Aquitaine;33;1;13;161;Eyrans;767;6;773
75;Nouvelle-Aquitaine;33;2;25;162;Eysines;24109;265;24374
75;Nouvelle-Aquitaine;33;3;12;163;Faleyras;432;6;438
75;Nouvelle-Aquitaine;33;3;29;164;Fargues;1650;33;1683
75;Nouvelle-Aquitaine;33;2;11;165;Fargues-Saint-Hilaire;3005;32;3037
75;Nouvelle-Aquitaine;33;5;21;166;Le Fieu;514;4;518
75;Nouvelle-Aquitaine;33;5;10;168;Flaujagues;589;9;598
75;Nouvelle-Aquitaine;33;2;09;167;Floirac;17882;95;17977
75;Nouvelle-Aquitaine;33;3;27;169;Floudès;109;4;113
75;Nouvelle-Aquitaine;33;3;27;170;Fontet;793;16;809
75;Nouvelle-Aquitaine;33;3;27;171;Fossès-et-Baleyssac;225;3;228
75;Nouvelle-Aquitaine;33;1;13;172;Fours;301;13;314
75;Nouvelle-Aquitaine;33;5;21;173;Francs;189;7;196
75;Nouvelle-Aquitaine;33;5;16;174;Fronsac;1148;34;1182
75;Nouvelle-Aquitaine;33;3;12;175;Frontenac;736;10;746
75;Nouvelle-Aquitaine;33;3;12;176;Gabarnac;348;7;355
75;Nouvelle-Aquitaine;33;4;22;177;Gaillan-en-Médoc;2334;42;2376
75;Nouvelle-Aquitaine;33;3;29;178;Gajac;376;3;379
75;Nouvelle-Aquitaine;33;5;16;179;Galgon;3001;54;3055
75;Nouvelle-Aquitaine;33;3;29;180;Gans;188;8;196
75;Nouvelle-Aquitaine;33;5;10;181;Gardegan-et-Tourtirac;280;4;284
75;Nouvelle-Aquitaine;33;1;13;182;Gauriac;737;16;753
75;Nouvelle-Aquitaine;33;1;20;183;Gauriaguet;1333;15;1348
75;Nouvelle-Aquitaine;33;1;20;184;Générac;537;11;548
75;Nouvelle-Aquitaine;33;5;10;185;Génissac;1967;36;2003
75;Nouvelle-Aquitaine;33;5;10;186;Gensac;740;10;750
75;Nouvelle-Aquitaine;33;3;27;187;Gironde-sur-Dropt;1288;24;1312
75;Nouvelle-Aquitaine;33;3;29;188;Giscos;181;3;184
75;Nouvelle-Aquitaine;33;3;12;189;Gornac;432;10;442
75;Nouvelle-Aquitaine;33;3;29;190;Goualade;90;1;91
75;Nouvelle-Aquitaine;33;5;21;191;Gours;579;4;583
75;Nouvelle-Aquitaine;33;2;24;192;Gradignan;25435;343;25778
75;Nouvelle-Aquitaine;33;4;22;193;Grayan-et-l'Hôpital;1428;22;1450
75;Nouvelle-Aquitaine;33;5;10;194;Grézillac;696;15;711
75;Nouvelle-Aquitaine;33;3;29;195;Grignols;1204;8;1212
75;Nouvelle-Aquitaine;33;5;10;196;Guillac;159;4;163
75;Nouvelle-Aquitaine;33;3;15;197;Guillos;451;6;457
75;Nouvelle-Aquitaine;33;5;21;198;Guîtres;1585;35;1620
75;Nouvelle-Aquitaine;33;6;14;199;Gujan-Mestras;21543;448;21991
75;Nouvelle-Aquitaine;33;2;18;200;Le Haillan;11342;185;11527
75;Nouvelle-Aquitaine;33;2;12;201;Haux;830;20;850
75;Nouvelle-Aquitaine;33;3;15;202;Hostens;1383;18;1401
75;Nouvelle-Aquitaine;33;4;30;203;Hourtin;3659;65;3724
75;Nouvelle-Aquitaine;33;3;27;204;Hure;528;7;535
75;Nouvelle-Aquitaine;33;3;15;205;Illats;1392;21;1413
75;Nouvelle-Aquitaine;33;2;08;206;Isle-Saint-Georges;523;3;526
75;Nouvelle-Aquitaine;33;5;16;207;Izon;5878;65;5943
75;Nouvelle-Aquitaine;33;4;22;208;Jau-Dignac-et-Loirac;960;10;970
75;Nouvelle-Aquitaine;33;5;10;209;Jugazan;290;7;297
75;Nouvelle-Aquitaine;33;5;10;210;Juillac;231;4;235
75;Nouvelle-Aquitaine;33;4;30;211;Labarde;593;2;595
75;Nouvelle-Aquitaine;33;3;29;212;Labescau;123;1;124
75;Nouvelle-Aquitaine;33;4;30;214;Lacanau;5082;72;5154
75;Nouvelle-Aquitaine;33;3;12;215;Ladaux;195;6;201
75;Nouvelle-Aquitaine;33;3;27;216;Lados;171;5;176
75;Nouvelle-Aquitaine;33;5;21;218;Lagorce;1665;16;1681
75;Nouvelle-Aquitaine;33;5;16;222;Lalande-de-Pomerol;656;15;671
75;Nouvelle-Aquitaine;33;4;30;220;Lamarque;1315;12;1327
75;Nouvelle-Aquitaine;33;3;27;221;Lamothe-Landerron;1199;25;1224
75;Nouvelle-Aquitaine;33;5;16;219;La Lande-de-Fronsac;2476;24;2500
75;Nouvelle-Aquitaine;33;3;27;223;Landerrouat;213;3;216
75;Nouvelle-Aquitaine;33;3;27;224;Landerrouet-sur-Ségur;98;0;98
75;Nouvelle-Aquitaine;33;3;15;225;Landiras;2197;37;2234
75;Nouvelle-Aquitaine;33;3;12;226;Langoiran;2140;31;2171
75;Nouvelle-Aquitaine;33;3;29;227;Langon;7374;146;7520
75;Nouvelle-Aquitaine;33;1;13;228;Lansac;720;11;731
75;Nouvelle-Aquitaine;33;6;01;229;Lanton;7098;136;7234
75;Nouvelle-Aquitaine;33;5;21;230;Lapouyade;496;10;506
75;Nouvelle-Aquitaine;33;3;12;231;Laroque;283;4;287
75;Nouvelle-Aquitaine;33;3;29;232;Lartigue;39;0;39
75;Nouvelle-Aquitaine;33;1;20;233;Laruscade;2800;21;2821
75;Nouvelle-Aquitaine;33;2;11;234;Latresne;3513;146;3659
75;Nouvelle-Aquitaine;33;3;29;235;Lavazan;225;2;227
75;Nouvelle-Aquitaine;33;6;01;236;Lège-Cap-Ferret;8374;171;8545
75;Nouvelle-Aquitaine;33;3;29;237;Léogeats;809;20;829
75;Nouvelle-Aquitaine;33;2;08;238;Léognan;10471;173;10644
75;Nouvelle-Aquitaine;33;3;29;239;Lerm-et-Musset;477;5;482
75;Nouvelle-Aquitaine;33;4;22;240;Lesparre-Médoc;5804;98;5902
75;Nouvelle-Aquitaine;33;3;12;241;Lestiac-sur-Garonne;574;8;582
75;Nouvelle-Aquitaine;33;5;27;242;Les Lèves-et-Thoumeyragues;549;10;559
75;Nouvelle-Aquitaine;33;5;16;243;Libourne;24511;552;25063
75;Nouvelle-Aquitaine;33;3;29;244;Lignan-de-Bazas;420;8;428
75;Nouvelle-Aquitaine;33;2;11;245;Lignan-de-Bordeaux;816;15;831
75;Nouvelle-Aquitaine;33;5;27;246;Ligueux;158;6;164
75;Nouvelle-Aquitaine;33;3;27;247;Listrac-de-Durèze;172;3;175
75;Nouvelle-Aquitaine;33;4;30;248;Listrac-Médoc;2774;39;2813
75;Nouvelle-Aquitaine;33;2;17;249;Lormont;23128;321;23449
75;Nouvelle-Aquitaine;33;3;27;250;Loubens;306;8;314
75;Nouvelle-Aquitaine;33;3;15;251;Louchats;734;9;743
75;Nouvelle-Aquitaine;33;2;11;252;Loupes;814;12;826
75;Nouvelle-Aquitaine;33;3;12;253;Loupiac;1113;10;1123
75;Nouvelle-Aquitaine;33;3;27;254;Loupiac-de-la-Réole;503;8;511
75;Nouvelle-Aquitaine;33;3;29;255;Lucmau;242;3;245
75;Nouvelle-Aquitaine;33;2;25;256;Ludon-Médoc;4934;43;4977
75;Nouvelle-Aquitaine;33;5;10;257;Lugaignac;485;6;491
75;Nouvelle-Aquitaine;33;3;12;258;Lugasson;299;7;306
75;Nouvelle-Aquitaine;33;5;16;259;Lugon-et-l'Île-du-Carnay;1314;24;1338
75;Nouvelle-Aquitaine;33;6;15;260;Lugos;948;21;969
75;Nouvelle-Aquitaine;33;5;21;261;Lussac;1258;38;1296
75;Nouvelle-Aquitaine;33;2;30;262;Macau;4318;25;4343
75;Nouvelle-Aquitaine;33;2;11;263;Madirac;261;4;265
75;Nouvelle-Aquitaine;33;5;21;264;Maransin;1005;11;1016
75;Nouvelle-Aquitaine;33;1;20;266;Marcenais;792;19;811
75;Nouvelle-Aquitaine;33;6;14;555;Marcheprime;4860;79;4939
75;Nouvelle-Aquitaine;33;4;30;268;Margaux-Cantenac;2920;32;2952
75;Nouvelle-Aquitaine;33;5;27;269;Margueron;392;4;396
75;Nouvelle-Aquitaine;33;3;29;270;Marimbault;184;8;192
75;Nouvelle-Aquitaine;33;3;29;271;Marions;215;2;217
75;Nouvelle-Aquitaine;33;1;20;272;Marsas;1213;22;1235
75;Nouvelle-Aquitaine;33;2;19;273;Martignas-sur-Jalle;7498;128;7626
75;Nouvelle-Aquitaine;33;2;08;274;Martillac;3187;39;3226
75;Nouvelle-Aquitaine;33;3;12;275;Martres;110;1;111
75;Nouvelle-Aquitaine;33;3;29;276;Masseilles;142;5;147
75;Nouvelle-Aquitaine;33;3;27;277;Massugas;227;6;233
75;Nouvelle-Aquitaine;33;3;27;278;Mauriac;240;6;246
75;Nouvelle-Aquitaine;33;3;29;279;Mazères;763;10;773
75;Nouvelle-Aquitaine;33;1;13;280;Mazion;531;4;535
75;Nouvelle-Aquitaine;33;2;98;281;Mérignac;70813;712;71525
75;Nouvelle-Aquitaine;33;3;27;282;Mérignas;344;4;348
75;Nouvelle-Aquitaine;33;3;27;283;Mesterrieux;227;3;230
75;Nouvelle-Aquitaine;33;6;14;284;Mios;10398;125;10523
75;Nouvelle-Aquitaine;33;1;13;285;Mombrier;424;8;432
75;Nouvelle-Aquitaine;33;3;27;287;Mongauzy;599;5;604
75;Nouvelle-Aquitaine;33;3;12;288;Monprimblanc;294;4;298
75;Nouvelle-Aquitaine;33;3;27;289;Monségur;1601;71;1672
75;Nouvelle-Aquitaine;33;5;21;290;Montagne;1524;135;1659
75;Nouvelle-Aquitaine;33;3;27;291;Montagoudin;179;3;182
75;Nouvelle-Aquitaine;33;3;12;292;Montignac;138;7;145
75;Nouvelle-Aquitaine;33;2;17;293;Montussan;3288;49;3337
75;Nouvelle-Aquitaine;33;3;27;294;Morizès;547;8;555
75;Nouvelle-Aquitaine;33;5;16;295;Mouillac;87;9;96
75;Nouvelle-Aquitaine;33;5;10;296;Mouliets-et-Villemartin;1047;15;1062
75;Nouvelle-Aquitaine;33;4;30;297;Moulis-en-Médoc;1853;34;1887
75;Nouvelle-Aquitaine;33;5;10;298;Moulon;1002;19;1021
75;Nouvelle-Aquitaine;33;3;12;299;Mourens;384;8;392
75;Nouvelle-Aquitaine;33;4;22;300;Naujac-sur-Mer;1087;23;1110
75;Nouvelle-Aquitaine;33;5;10;301;Naujan-et-Postiac;595;6;601
75;Nouvelle-Aquitaine;33;5;21;302;Néac;365;12;377
75;Nouvelle-Aquitaine;33;5;10;303;Nérigean;841;8;849
75;Nouvelle-Aquitaine;33;3;27;304;Neuffons;145;4;149
75;Nouvelle-Aquitaine;33;3;29;305;Le Nizan;514;5;519
75;Nouvelle-Aquitaine;33;3;27;306;Noaillac;483;6;489
75;Nouvelle-Aquitaine;33;3;29;307;Noaillan;1682;36;1718
75;Nouvelle-Aquitaine;33;3;12;308;Omet;303;2;305
75;Nouvelle-Aquitaine;33;4;22;309;Ordonnac;501;6;507
75;Nouvelle-Aquitaine;33;3;15;310;Origne;182;2;184
75;Nouvelle-Aquitaine;33;3;12;311;Paillet;1209;24;1233
75;Nouvelle-Aquitaine;33;2;25;312;Parempuyre;8963;82;9045
75;Nouvelle-Aquitaine;33;4;22;314;Pauillac;4911;83;4994
75;Nouvelle-Aquitaine;33;5;21;315;Les Peintures;1591;21;1612
75;Nouvelle-Aquitaine;33;3;27;316;Pellegrue;1034;13;1047
75;Nouvelle-Aquitaine;33;5;20;317;Périssac;1196;16;1212
75;Nouvelle-Aquitaine;33;2;99;318;Pessac;64374;759;65133
75;Nouvelle-Aquitaine;33;5;10;319;Pessac-sur-Dordogne;449;9;458
75;Nouvelle-Aquitaine;33;5;21;320;Petit-Palais-et-Cornemps;723;11;734
75;Nouvelle-Aquitaine;33;1;20;321;Peujard;2160;28;2188
75;Nouvelle-Aquitaine;33;2;25;322;Le Pian-Médoc;6739;139;6878
75;Nouvelle-Aquitaine;33;3;12;323;Le Pian-sur-Garonne;880;18;898
75;Nouvelle-Aquitaine;33;5;27;324;Pineuilh;4432;111;4543
75;Nouvelle-Aquitaine;33;1;13;325;Plassac;910;21;931
75;Nouvelle-Aquitaine;33;1;13;326;Pleine-Selve;218;5;223
75;Nouvelle-Aquitaine;33;3;15;327;Podensac;3187;49;3236
75;Nouvelle-Aquitaine;33;5;16;328;Pomerol;593;11;604
75;Nouvelle-Aquitaine;33;3;29;329;Pompéjac;264;3;267
75;Nouvelle-Aquitaine;33;2;11;330;Pompignac;3073;53;3126
75;Nouvelle-Aquitaine;33;3;27;331;Pondaurat;466;14;480
75;Nouvelle-Aquitaine;33;5;21;332;Porchères;866;11;877
75;Nouvelle-Aquitaine;33;4;30;333;Le Porge;3243;46;3289
75;Nouvelle-Aquitaine;33;3;12;008;Porte-de-Benauge ;497;8;505
75;Nouvelle-Aquitaine;33;3;15;334;Portets;2728;34;2762
75;Nouvelle-Aquitaine;33;2;11;335;Le Pout;610;8;618
75;Nouvelle-Aquitaine;33;3;29;336;Préchac;1007;13;1020
75;Nouvelle-Aquitaine;33;3;15;337;Preignac;2150;33;2183
75;Nouvelle-Aquitaine;33;1;13;339;Prignac-et-Marcamps;1384;29;1413
75;Nouvelle-Aquitaine;33;1;13;341;Pugnac;2285;32;2317
75;Nouvelle-Aquitaine;33;5;21;342;Puisseguin;840;21;861
75;Nouvelle-Aquitaine;33;5;10;344;Pujols;531;6;537
75;Nouvelle-Aquitaine;33;3;15;343;Pujols-sur-Ciron;795;16;811
75;Nouvelle-Aquitaine;33;3;27;345;Le Puy;406;4;410
75;Nouvelle-Aquitaine;33;3;27;346;Puybarban;426;11;437
75;Nouvelle-Aquitaine;33;5;21;347;Puynormand;303;9;312
75;Nouvelle-Aquitaine;33;4;22;348;Queyrac;1375;15;1390
75;Nouvelle-Aquitaine;33;2;11;349;Quinsac;2213;22;2235
75;Nouvelle-Aquitaine;33;5;10;350;Rauzan;1223;25;1248
75;Nouvelle-Aquitaine;33;1;13;351;Reignac;1591;25;1616
75;Nouvelle-Aquitaine;33;3;27;352;La Réole;4355;82;4437
75;Nouvelle-Aquitaine;33;3;27;353;Rimons;194;4;198
75;Nouvelle-Aquitaine;33;5;27;354;Riocaud;186;5;191
75;Nouvelle-Aquitaine;33;3;12;355;Rions;1540;37;1577
75;Nouvelle-Aquitaine;33;5;16;356;La Rivière;427;1;428
75;Nouvelle-Aquitaine;33;3;29;357;Roaillan;1721;26;1747
75;Nouvelle-Aquitaine;33;3;12;358;Romagne;464;8;472
75;Nouvelle-Aquitaine;33;3;27;359;Roquebrune;282;3;285
75;Nouvelle-Aquitaine;33;5;27;360;La Roquille;318;3;321
75;Nouvelle-Aquitaine;33;3;27;361;Ruch;599;10;609
75;Nouvelle-Aquitaine;33;5;21;362;Sablons;1307;15;1322
75;Nouvelle-Aquitaine;33;2;11;363;Sadirac;4371;69;4440
75;Nouvelle-Aquitaine;33;5;16;364;Saillans;394;7;401
75;Nouvelle-Aquitaine;33;5;16;365;Saint-Aignan;200;9;209
75;Nouvelle-Aquitaine;33;1;20;366;Saint-André-de-Cubzac;12051;178;12229
75;Nouvelle-Aquitaine;33;3;12;367;Saint-André-du-Bois;433;4;437
75;Nouvelle-Aquitaine;33;5;27;369;Saint-André-et-Appelles;682;12;694
75;Nouvelle-Aquitaine;33;1;13;370;Saint-Androny;548;8;556
75;Nouvelle-Aquitaine;33;3;27;372;Saint-Antoine-du-Queyret;58;2;60
75;Nouvelle-Aquitaine;33;5;21;373;Saint-Antoine-sur-l'Isle;582;10;592
75;Nouvelle-Aquitaine;33;1;13;374;Saint-Aubin-de-Blaye;870;19;889
75;Nouvelle-Aquitaine;33;5;10;375;Saint-Aubin-de-Branne;359;8;367
75;Nouvelle-Aquitaine;33;2;28;376;Saint-Aubin-de-Médoc;7415;211;7626
75;Nouvelle-Aquitaine;33;5;27;377;Saint-Avit-de-Soulège;78;3;81
75;Nouvelle-Aquitaine;33;5;27;378;Saint-Avit-Saint-Nazaire;1474;22;1496
75;Nouvelle-Aquitaine;33;3;27;379;Saint-Brice;315;2;317
75;Nouvelle-Aquitaine;33;2;11;381;Saint-Caprais-de-Bordeaux;3288;33;3321
75;Nouvelle-Aquitaine;33;1;20;382;Saint-Christoly-de-Blaye;1939;30;1969
75;Nouvelle-Aquitaine;33;4;22;383;Saint-Christoly-Médoc;279;3;282
75;Nouvelle-Aquitaine;33;5;21;385;Saint-Christophe-de-Double;692;5;697
75;Nouvelle-Aquitaine;33;5;21;384;Saint-Christophe-des-Bardes;430;7;437
75;Nouvelle-Aquitaine;33;5;21;386;Saint-Cibard;187;6;193
75;Nouvelle-Aquitaine;33;5;21;387;Saint-Ciers-d'Abzac;1463;24;1487
75;Nouvelle-Aquitaine;33;1;13;388;Saint-Ciers-de-Canesse;803;17;820
75;Nouvelle-Aquitaine;33;1;13;389;Saint-Ciers-sur-Gironde;3010;42;3052
75;Nouvelle-Aquitaine;33;3;29;391;Saint-Côme;321;4;325
75;Nouvelle-Aquitaine;33;5;21;393;Saint-Denis-de-Pile;5658;68;5726
75;Nouvelle-Aquitaine;33;5;10;394;Saint-Émilion;1866;47;1913
75;Nouvelle-Aquitaine;33;4;22;395;Saint-Estèphe;1600;50;1650
75;Nouvelle-Aquitaine;33;5;10;396;Saint-Étienne-de-Lisse;213;4;217
75;Nouvelle-Aquitaine;33;3;27;398;Saint-Exupéry;168;2;170
75;Nouvelle-Aquitaine;33;3;27;399;Saint-Félix-de-Foncaude;289;7;296
75;Nouvelle-Aquitaine;33;3;27;400;Saint-Ferme;344;5;349
75;Nouvelle-Aquitaine;33;1;13;405;Saint-Genès-de-Blaye;485;12;497
75;Nouvelle-Aquitaine;33;5;10;406;Saint-Genès-de-Castillon;386;7;393
75;Nouvelle-Aquitaine;33;5;20;407;Saint-Genès-de-Fronsac;822;17;839
75;Nouvelle-Aquitaine;33;2;11;408;Saint-Genès-de-Lombaud;387;17;404
75;Nouvelle-Aquitaine;33;3;12;409;Saint-Genis-du-Bois;87;1;88
75;Nouvelle-Aquitaine;33;4;22;412;Saint-Germain-d'Esteuil;1247;19;1266
75;Nouvelle-Aquitaine;33;3;12;411;Saint-Germain-de-Grave;160;3;163
75;Nouvelle-Aquitaine;33;5;16;414;Saint-Germain-de-la-Rivière;389;4;393
75;Nouvelle-Aquitaine;33;5;10;413;Saint-Germain-du-Puch;2186;36;2222
75;Nouvelle-Aquitaine;33;1;20;415;Saint-Gervais;1892;20;1912
75;Nouvelle-Aquitaine;33;1;20;416;Saint-Girons-d'Aiguevives;943;19;962
75;Nouvelle-Aquitaine;33;3;27;418;Saint-Hilaire-de-la-Noaille;377;7;384
75;Nouvelle-Aquitaine;33;3;27;419;Saint-Hilaire-du-Bois;78;0;78
75;Nouvelle-Aquitaine;33;5;10;420;Saint-Hippolyte;131;1;132
75;Nouvelle-Aquitaine;33;2;19;422;Saint-Jean-d'Illac;8678;158;8836
75;Nouvelle-Aquitaine;33;5;10;421;Saint-Jean-de-Blaignac;450;7;457
75;Nouvelle-Aquitaine;33;4;22;423;Saint-Julien-Beychevelle;603;0;603
75;Nouvelle-Aquitaine;33;1;20;425;Saint-Laurent-d'Arce;1463;26;1489
75;Nouvelle-Aquitaine;33;5;10;426;Saint-Laurent-des-Combes;257;1;258
75;Nouvelle-Aquitaine;33;3;12;427;Saint-Laurent-du-Bois;247;5;252
75;Nouvelle-Aquitaine;33;3;12;428;Saint-Laurent-du-Plan;88;0;88
75;Nouvelle-Aquitaine;33;4;30;424;Saint-Laurent-Médoc;4767;86;4853
75;Nouvelle-Aquitaine;33;3;15;429;Saint-Léger-de-Balson;332;5;337
75;Nouvelle-Aquitaine;33;2;12;431;Saint-Léon;340;4;344
75;Nouvelle-Aquitaine;33;3;29;432;Saint-Loubert;231;2;233
75;Nouvelle-Aquitaine;33;2;26;433;Saint-Loubès;9770;106;9876
75;Nouvelle-Aquitaine;33;2;26;434;Saint-Louis-de-Montferrand;2149;15;2164
75;Nouvelle-Aquitaine;33;3;12;435;Saint-Macaire;2079;95;2174
75;Nouvelle-Aquitaine;33;6;15;436;Saint-Magne;1010;20;1030
75;Nouvelle-Aquitaine;33;5;10;437;Saint-Magne-de-Castillon;2011;11;2022
75;Nouvelle-Aquitaine;33;3;12;438;Saint-Maixant;1945;48;1993
75;Nouvelle-Aquitaine;33;1;20;439;Saint-Mariens;1611;19;1630
75;Nouvelle-Aquitaine;33;3;12;440;Saint-Martial;241;5;246
75;Nouvelle-Aquitaine;33;5;21;442;Saint-Martin-de-Laye;544;5;549
75;Nouvelle-Aquitaine;33;3;27;443;Saint-Martin-de-Lerm;149;3;152
75;Nouvelle-Aquitaine;33;3;12;444;Saint-Martin-de-Sescas;575;10;585
75;Nouvelle-Aquitaine;33;5;21;445;Saint-Martin-du-Bois;853;17;870
75;Nouvelle-Aquitaine;33;3;27;446;Saint-Martin-du-Puy;175;1;176
75;Nouvelle-Aquitaine;33;1;13;441;Saint-Martin-Lacaussade;1150;98;1248
75;Nouvelle-Aquitaine;33;2;08;448;Saint-Médard-d'Eyrans;3040;39;3079
75;Nouvelle-Aquitaine;33;5;21;447;Saint-Médard-de-Guizières;2385;22;2407
75;Nouvelle-Aquitaine;33;2;28;449;Saint-Médard-en-Jalles;31536;516;32052
75;Nouvelle-Aquitaine;33;3;29;450;Saint-Michel-de-Castelnau;243;3;246
75;Nouvelle-Aquitaine;33;5;16;451;Saint-Michel-de-Fronsac;527;4;531
75;Nouvelle-Aquitaine;33;3;27;453;Saint-Michel-de-Lapujade;228;4;232
75;Nouvelle-Aquitaine;33;3;15;452;Saint-Michel-de-Rieufret;814;13;827
75;Nouvelle-Aquitaine;33;2;08;454;Saint-Morillon;1718;21;1739
75;Nouvelle-Aquitaine;33;1;13;456;Saint-Palais;500;9;509
75;Nouvelle-Aquitaine;33;3;29;457;Saint-Pardon-de-Conques;589;10;599
75;Nouvelle-Aquitaine;33;1;13;458;Saint-Paul;956;17;973
75;Nouvelle-Aquitaine;33;5;10;459;Saint-Pey-d'Armens;190;3;193
75;Nouvelle-Aquitaine;33;5;10;460;Saint-Pey-de-Castets;616;12;628
75;Nouvelle-Aquitaine;33;5;10;461;Saint-Philippe-d'Aiguille;374;5;379
75;Nouvelle-Aquitaine;33;5;27;462;Saint-Philippe-du-Seignal;483;10;493
75;Nouvelle-Aquitaine;33;3;12;463;Saint-Pierre-d'Aurillac;1312;20;1332
75;Nouvelle-Aquitaine;33;3;12;464;Saint-Pierre-de-Bat;298;6;304
75;Nouvelle-Aquitaine;33;3;29;465;Saint-Pierre-de-Mons;1213;21;1234
75;Nouvelle-Aquitaine;33;5;10;466;Saint-Quentin-de-Baron;2499;32;2531
75;Nouvelle-Aquitaine;33;5;27;467;Saint-Quentin-de-Caplong;239;4;243
75;Nouvelle-Aquitaine;33;5;16;470;Saint-Romain-la-Virvée;872;24;896
75;Nouvelle-Aquitaine;33;4;22;471;Saint-Sauveur;1296;24;1320
75;Nouvelle-Aquitaine;33;5;21;472;Saint-Sauveur-de-Puynormand;354;6;360
75;Nouvelle-Aquitaine;33;1;20;473;Saint-Savin;3222;37;3259
75;Nouvelle-Aquitaine;33;2;08;474;Saint-Selve;3201;39;3240
75;Nouvelle-Aquitaine;33;1;13;475;Saint-Seurin-de-Bourg;406;6;412
75;Nouvelle-Aquitaine;33;4;22;476;Saint-Seurin-de-Cadourne;708;12;720
75;Nouvelle-Aquitaine;33;1;13;477;Saint-Seurin-de-Cursac;770;17;787
75;Nouvelle-Aquitaine;33;5;21;478;Saint-Seurin-sur-l'Isle;3147;21;3168
75;Nouvelle-Aquitaine;33;3;27;479;Saint-Sève;254;2;256
75;Nouvelle-Aquitaine;33;5;10;480;Saint-Sulpice-de-Faleyrens;1330;30;1360
75;Nouvelle-Aquitaine;33;3;27;481;Saint-Sulpice-de-Guilleragues;230;3;233
75;Nouvelle-Aquitaine;33;3;27;482;Saint-Sulpice-de-Pommiers;238;3;241
75;Nouvelle-Aquitaine;33;2;26;483;Saint-Sulpice-et-Cameyrac;4643;65;4708
75;Nouvelle-Aquitaine;33;3;15;484;Saint-Symphorien;1834;32;1866
75;Nouvelle-Aquitaine;33;1;13;486;Saint-Trojan;343;9;352
75;Nouvelle-Aquitaine;33;2;26;487;Saint-Vincent-de-Paul;1002;8;1010
75;Nouvelle-Aquitaine;33;5;10;488;Saint-Vincent-de-Pertignas;373;13;386
75;Nouvelle-Aquitaine;33;1;20;489;Saint-Vivien-de-Blaye;354;5;359
75;Nouvelle-Aquitaine;33;4;22;490;Saint-Vivien-de-Médoc;1789;24;1813
75;Nouvelle-Aquitaine;33;3;27;491;Saint-Vivien-de-Monségur;375;5;380
75;Nouvelle-Aquitaine;33;1;20;492;Saint-Yzan-de-Soudiac;2398;23;2421
75;Nouvelle-Aquitaine;33;4;22;493;Saint-Yzans-de-Médoc;361;28;389
75;Nouvelle-Aquitaine;33;5;10;390;Sainte-Colombe;422;9;431
75;Nouvelle-Aquitaine;33;3;12;392;Sainte-Croix-du-Mont;883;17;900
75;Nouvelle-Aquitaine;33;2;26;397;Sainte-Eulalie;4733;80;4813
75;Nouvelle-Aquitaine;33;5;10;401;Sainte-Florence;150;2;152
75;Nouvelle-Aquitaine;33;5;27;402;Sainte-Foy-la-Grande;2577;30;2607
75;Nouvelle-Aquitaine;33;3;12;403;Sainte-Foy-la-Longue;127;2;129
75;Nouvelle-Aquitaine;33;3;27;404;Sainte-Gemme;187;4;191
75;Nouvelle-Aquitaine;33;4;30;417;Sainte-Hélène;2826;44;2870
75;Nouvelle-Aquitaine;33;5;10;468;Sainte-Radegonde;446;9;455
75;Nouvelle-Aquitaine;33;5;10;485;Sainte-Terre;1896;32;1928
75;Nouvelle-Aquitaine;33;4;30;494;Salaunes;1131;10;1141
75;Nouvelle-Aquitaine;33;2;11;496;Sallebœuf;2560;39;2599
75;Nouvelle-Aquitaine;33;6;15;498;Salles;7216;136;7352
75;Nouvelle-Aquitaine;33;5;10;499;Les Salles-de-Castillon;348;9;357
75;Nouvelle-Aquitaine;33;1;13;500;Samonac;422;9;431
75;Nouvelle-Aquitaine;33;2;08;501;Saucats;3156;56;3212
75;Nouvelle-Aquitaine;33;1;20;502;Saugon;480;5;485
75;Nouvelle-Aquitaine;33;4;30;503;Saumos;526;8;534
75;Nouvelle-Aquitaine;33;3;29;504;Sauternes;796;9;805
75;Nouvelle-Aquitaine;33;2;12;505;La Sauve;1519;55;1574
75;Nouvelle-Aquitaine;33;3;27;506;Sauveterre-de-Guyenne;1820;22;1842
75;Nouvelle-Aquitaine;33;3;29;507;Sauviac;327;11;338
75;Nouvelle-Aquitaine;33;3;27;508;Savignac;630;13;643
75;Nouvelle-Aquitaine;33;5;21;509;Savignac-de-l'Isle;500;9;509
75;Nouvelle-Aquitaine;33;3;12;510;Semens;214;1;215
75;Nouvelle-Aquitaine;33;3;29;511;Sendets;339;4;343
75;Nouvelle-Aquitaine;33;3;27;512;Sigalens;371;8;379
75;Nouvelle-Aquitaine;33;3;29;513;Sillas;121;2;123
75;Nouvelle-Aquitaine;33;4;22;514;Soulac-sur-Mer;2819;25;2844
75;Nouvelle-Aquitaine;33;3;12;515;Soulignac;430;8;438
75;Nouvelle-Aquitaine;33;3;27;516;Soussac;194;5;199
75;Nouvelle-Aquitaine;33;4;30;517;Soussans;1643;16;1659
75;Nouvelle-Aquitaine;33;2;12;518;Tabanac;1083;23;1106
75;Nouvelle-Aquitaine;33;2;28;519;Le Taillan-Médoc;10118;145;10263
75;Nouvelle-Aquitaine;33;3;27;520;Taillecavat;289;3;292
75;Nouvelle-Aquitaine;33;4;22;521;Talais;753;7;760
75;Nouvelle-Aquitaine;33;2;31;522;Talence;42701;969;43670
75;Nouvelle-Aquitaine;33;3;12;523;Targon;2066;24;2090
75;Nouvelle-Aquitaine;33;5;16;524;Tarnès;331;7;338
75;Nouvelle-Aquitaine;33;1;13;525;Tauriac;1287;21;1308
75;Nouvelle-Aquitaine;33;5;21;526;Tayac;133;3;136
75;Nouvelle-Aquitaine;33;6;14;527;Le Teich;8205;173;8378
75;Nouvelle-Aquitaine;33;4;30;528;Le Temple;624;7;631
75;Nouvelle-Aquitaine;33;6;32;529;La Teste-de-Buch;26248;378;26626
75;Nouvelle-Aquitaine;33;1;13;530;Teuillac;882;9;891
75;Nouvelle-Aquitaine;33;5;10;531;Tizac-de-Curton;340;5;345
75;Nouvelle-Aquitaine;33;5;21;532;Tizac-de-Lapouyade;474;9;483
75;Nouvelle-Aquitaine;33;3;29;533;Toulenne;2730;28;2758
75;Nouvelle-Aquitaine;33;2;12;534;Le Tourne;805;11;816
75;Nouvelle-Aquitaine;33;2;11;535;Tresses;4821;51;4872
75;Nouvelle-Aquitaine;33;3;15;536;Le Tuzan;268;5;273
75;Nouvelle-Aquitaine;33;3;29;537;Uzeste;450;10;460
75;Nouvelle-Aquitaine;33;1;13;380;Val-de-Livenne ;1756;23;1779
75;Nouvelle-Aquitaine;33;1;20;018;Val de Virvée;3535;41;3576
75;Nouvelle-Aquitaine;33;4;22;538;Valeyrac;543;10;553
75;Nouvelle-Aquitaine;33;5;16;539;Vayres;4053;52;4105
75;Nouvelle-Aquitaine;33;4;22;540;Vendays-Montalivet;2426;38;2464
75;Nouvelle-Aquitaine;33;4;22;541;Vensac;1003;17;1020
75;Nouvelle-Aquitaine;33;5;16;542;Vérac;931;14;945
75;Nouvelle-Aquitaine;33;3;12;543;Verdelais;1026;9;1035
75;Nouvelle-Aquitaine;33;4;22;544;Le Verdon-sur-Mer;1331;11;1342
75;Nouvelle-Aquitaine;33;4;22;545;Vertheuil;1300;22;1322
75;Nouvelle-Aquitaine;33;5;10;546;Vignonet;500;12;512
75;Nouvelle-Aquitaine;33;3;29;547;Villandraut;1089;25;1114
75;Nouvelle-Aquitaine;33;5;16;548;Villegouge;1256;24;1280
75;Nouvelle-Aquitaine;33;2;33;550;Villenave-d'Ornon;35278;202;35480
75;Nouvelle-Aquitaine;33;3;12;549;Villenave-de-Rions;332;5;337
75;Nouvelle-Aquitaine;33;1;13;551;Villeneuve;396;6;402
75;Nouvelle-Aquitaine;33;3;15;552;Virelade;1077;13;1090
75;Nouvelle-Aquitaine;33;1;20;553;Virsac;1102;5;1107
75;Nouvelle-Aquitaine;33;2;17;554;Yvrac;2818;23;2841
76;Occitanie;34;1;21;001;Abeilhan;1750;23;1773
76;Occitanie;34;1;14;002;Adissan;1241;25;1266
76;Occitanie;34;1;01;003;Agde;29090;394;29484
76;Occitanie;34;1;24;004;Agel;242;4;246
76;Occitanie;34;2;11;005;Agonès;275;9;284
76;Occitanie;34;1;24;006;Aigne;269;7;276
76;Occitanie;34;1;24;007;Aigues-Vives;469;5;474
76;Occitanie;34;1;06;008;Les Aires;602;11;613
76;Occitanie;34;1;21;009;Alignan-du-Vent;1745;28;1773
76;Occitanie;34;2;09;010;Aniane;2915;39;2954
76;Occitanie;34;2;09;011;Arboras;116;4;120
76;Occitanie;34;2;09;012;Argelliers;993;25;1018
76;Occitanie;34;2;06;013;Aspiran;1655;28;1683
76;Occitanie;34;2;23;014;Assas;1505;43;1548
76;Occitanie;34;1;24;015;Assignan;161;3;164
76;Occitanie;34;2;09;016;Aumelas;529;17;546
76;Occitanie;34;1;14;017;Aumes;488;16;504
76;Occitanie;34;1;05;018;Autignac;912;15;927
76;Occitanie;34;1;06;019;Avène;280;8;288
76;Occitanie;34;1;24;020;Azillanet;363;12;375
76;Occitanie;34;1;24;021;Babeau-Bouldoux;296;6;302
76;Occitanie;34;3;07;022;Baillargues;7708;101;7809
76;Occitanie;34;3;08;024;Balaruc-le-Vieux;2631;41;2672
76;Occitanie;34;3;08;023;Balaruc-les-Bains;6867;90;6957
76;Occitanie;34;1;04;025;Bassan;2124;34;2158
76;Occitanie;34;1;24;026;Beaufort;219;4;223
76;Occitanie;34;3;07;027;Beaulieu;2057;47;2104
76;Occitanie;34;1;06;028;Bédarieux;5771;231;6002
76;Occitanie;34;2;09;029;Bélarga;658;10;668
76;Occitanie;34;1;24;030;Berlou;207;0;207
76;Occitanie;34;1;01;031;Bessan;5119;74;5193
76;Occitanie;34;1;98;032;Béziers;77599;1224;78823
76;Occitanie;34;3;12;033;Boisseron;2030;40;2070
76;Occitanie;34;1;24;034;Boisset;39;1;40
76;Occitanie;34;2;09;035;La Boissière;1021;19;1040
76;Occitanie;34;2;11;036;Le Bosc;1353;24;1377
76;Occitanie;34;1;04;037;Boujan-sur-Libron;3387;56;3443
76;Occitanie;34;1;06;038;Le Bousquet-d'Orb;1585;24;1609
76;Occitanie;34;3;14;039;Bouzigues;1650;24;1674
76;Occitanie;34;1;06;040;Brenas;54;0;54
76;Occitanie;34;2;06;041;Brignac;912;16;928
76;Occitanie;34;2;11;042;Brissac;609;14;623
76;Occitanie;34;2;23;043;Buzignargues;350;5;355
76;Occitanie;34;1;05;044;Cabrerolles;338;10;348
76;Occitanie;34;2;14;045;Cabrières;500;16;516
76;Occitanie;34;1;24;046;Cambon-et-Salvergues;49;0;49
76;Occitanie;34;2;09;047;Campagnan;689;10;699
76;Occitanie;34;3;12;048;Campagne;313;5;318
76;Occitanie;34;1;06;049;Camplong;232;4;236
76;Occitanie;34;3;13;050;Candillargues;1797;24;1821
76;Occitanie;34;2;06;051;Canet;3494;46;3540
76;Occitanie;34;1;24;052;Capestang;3273;59;3332
76;Occitanie;34;1;06;053;Carlencas-et-Levas;131;0;131
76;Occitanie;34;1;24;054;Cassagnoles;103;1;104
76;Occitanie;34;1;24;055;Castanet-le-Haut;211;3;214
76;Occitanie;34;1;21;056;Castelnau-de-Guers;1190;23;1213
76;Occitanie;34;3;20;057;Castelnau-le-Lez;21838;364;22202
76;Occitanie;34;3;07;058;Castries;6250;102;6352
76;Occitanie;34;1;24;059;La Caunette;310;6;316
76;Occitanie;34;2;11;060;Causse-de-la-Selle;394;5;399
76;Occitanie;34;1;05;061;Causses-et-Veyran;611;10;621
76;Occitanie;34;1;05;062;Caussiniojouls;141;1;142
76;Occitanie;34;1;21;063;Caux;2546;47;2593
76;Occitanie;34;2;11;064;Le Caylar;452;13;465
76;Occitanie;34;1;24;065;Cazedarnes;604;11;615
76;Occitanie;34;2;23;066;Cazevieille;200;3;203
76;Occitanie;34;2;11;067;Cazilhac;1527;40;1567
76;Occitanie;34;1;14;068;Cazouls-d'Hérault;410;9;419
76;Occitanie;34;1;05;069;Cazouls-lès-Béziers;5023;94;5117
76;Occitanie;34;1;24;070;Cébazan;621;12;633
76;Occitanie;34;1;06;071;Ceilhes-et-Rocozels;326;5;331
76;Occitanie;34;2;11;072;Celles;30;1;31
76;Occitanie;34;1;04;073;Cers;2564;50;2614
76;Occitanie;34;1;24;074;Cessenon-sur-Orb;2313;48;2361
76;Occitanie;34;1;24;075;Cesseras;405;8;413
76;Occitanie;34;2;06;076;Ceyras;1382;26;1408
76;Occitanie;34;3;20;077;Clapiers;5431;101;5532
76;Occitanie;34;2;11;078;Claret;1617;36;1653
76;Occitanie;34;2;06;079;Clermont-l'Hérault;8962;160;9122
76;Occitanie;34;1;24;080;Colombières-sur-Orb;481;14;495
76;Occitanie;34;1;05;081;Colombiers;2584;42;2626
76;Occitanie;34;2;23;082;Combaillaux;1614;38;1652
76;Occitanie;34;1;06;083;Combes;329;3;332
76;Occitanie;34;1;03;084;Corneilhan;1721;31;1752
76;Occitanie;34;1;21;085;Coulobres;357;4;361
76;Occitanie;34;1;24;086;Courniou;612;13;625
76;Occitanie;34;3;22;087;Cournonsec;3431;30;3461
76;Occitanie;34;3;22;088;Cournonterral;6270;76;6346
76;Occitanie;34;1;24;089;Creissan;1336;26;1362
76;Occitanie;34;3;07;090;Le Crès;9316;133;9449
76;Occitanie;34;2;11;091;Le Cros;55;0;55
76;Occitanie;34;1;24;092;Cruzy;977;17;994
76;Occitanie;34;1;06;093;Dio-et-Valquières;147;5;152
76;Occitanie;34;3;12;246;Entre-Vignes ;2128;44;2172
76;Occitanie;34;1;04;094;Espondeilhan;1071;23;1094
76;Occitanie;34;3;22;095;Fabrègues;7142;124;7266
76;Occitanie;34;1;05;096;Faugères;530;9;539
76;Occitanie;34;1;24;097;Félines-Minervois;480;6;486
76;Occitanie;34;1;24;098;Ferrals-les-Montagnes;161;4;165
76;Occitanie;34;2;11;099;Ferrières-les-Verreries;49;1;50
76;Occitanie;34;1;24;100;Ferrières-Poussarou;57;5;62
76;Occitanie;34;1;21;101;Florensac;5051;78;5129
76;Occitanie;34;2;11;102;Fontanès;347;9;356
76;Occitanie;34;2;14;103;Fontès;1039;19;1058
76;Occitanie;34;1;05;104;Fos;116;0;116
76;Occitanie;34;1;05;105;Fouzilhon;248;3;251
76;Occitanie;34;2;11;106;Fozières;173;9;182
76;Occitanie;34;1;24;107;Fraisse-sur-Agout;341;3;344
76;Occitanie;34;3;08;108;Frontignan;22731;224;22955
76;Occitanie;34;1;05;109;Gabian;840;19;859
76;Occitanie;34;3;12;110;Galargues;734;26;760
76;Occitanie;34;2;11;111;Ganges;4027;101;4128
76;Occitanie;34;3;12;112;Garrigues;192;3;195
76;Occitanie;34;3;08;113;Gigean;6450;79;6529
76;Occitanie;34;2;09;114;Gignac;6340;107;6447
76;Occitanie;34;2;11;115;Gorniès;122;1;123
76;Occitanie;34;3;15;116;Grabels;8603;97;8700
76;Occitanie;34;1;06;117;Graissessac;632;9;641
76;Occitanie;34;3;13;344;La Grande-Motte;8755;105;8860
76;Occitanie;34;2;23;118;Guzargues;505;12;517
76;Occitanie;34;1;06;119;Hérépian;1522;26;1548
76;Occitanie;34;3;20;120;Jacou;6800;102;6902
76;Occitanie;34;1;06;121;Joncels;299;14;313
76;Occitanie;34;2;09;122;Jonquières;503;6;509
76;Occitanie;34;3;10;123;Juvignac;11363;102;11465
76;Occitanie;34;2;06;124;Lacoste;317;10;327
76;Occitanie;34;2;09;125;Lagamas;111;4;115
76;Occitanie;34;1;06;126;Lamalou-les-Bains;2508;17;2525
76;Occitanie;34;3;13;127;Lansargues;3106;43;3149
76;Occitanie;34;2;11;128;Laroque;1629;31;1660
76;Occitanie;34;3;10;129;Lattes;16710;218;16928
76;Occitanie;34;1;05;130;Laurens;1737;29;1766
76;Occitanie;34;2;11;131;Lauret;612;19;631
76;Occitanie;34;2;11;132;Lauroux;206;2;208
76;Occitanie;34;2;11;133;Lavalette;59;0;59
76;Occitanie;34;3;10;134;Lavérune;3282;53;3335
76;Occitanie;34;1;02;135;Lespignan;3279;53;3332
76;Occitanie;34;1;14;136;Lézignan-la-Cèbe;1556;29;1585
76;Occitanie;34;2;06;137;Liausson;147;7;154
76;Occitanie;34;2;14;138;Lieuran-Cabrières;330;13;343
76;Occitanie;34;1;04;139;Lieuran-lès-Béziers;1391;40;1431
76;Occitanie;34;1;03;140;Lignan-sur-Orb;3209;85;3294
76;Occitanie;34;1;24;141;La Livinière;521;8;529
76;Occitanie;34;2;11;142;Lodève;7459;244;7703
76;Occitanie;34;3;14;143;Loupian;2176;38;2214
76;Occitanie;34;1;06;144;Lunas;663;13;676
76;Occitanie;34;3;12;145;Lunel;26273;249;26522
76;Occitanie;34;3;12;146;Lunel-Viel;4184;43;4227
76;Occitanie;34;1;05;147;Magalas;3371;51;3422
76;Occitanie;34;1;05;148;Maraussan;4514;83;4597
76;Occitanie;34;1;05;149;Margon;710;2;712
76;Occitanie;34;3;01;150;Marseillan;7784;105;7889
76;Occitanie;34;3;12;151;Marsillargues;6322;77;6399
76;Occitanie;34;2;11;152;Mas-de-Londres;671;10;681
76;Occitanie;34;2;23;153;Les Matelles;2002;40;2042
76;Occitanie;34;3;13;154;Mauguio;16735;196;16931
76;Occitanie;34;1;05;155;Maureilhan;2177;46;2223
76;Occitanie;34;2;06;156;Mérifons;44;3;47
76;Occitanie;34;3;14;157;Mèze;12012;165;12177
76;Occitanie;34;1;24;158;Minerve;112;1;113
76;Occitanie;34;3;08;159;Mireval;3282;49;3331
76;Occitanie;34;1;24;160;Mons;605;15;620
76;Occitanie;34;1;05;161;Montady;3939;73;4012
76;Occitanie;34;1;14;162;Montagnac;4330;59;4389
76;Occitanie;34;2;09;163;Montarnaud;3904;46;3950
76;Occitanie;34;3;07;164;Montaud;1007;11;1018
76;Occitanie;34;3;14;165;Montbazin;2928;59;2987
76;Occitanie;34;1;21;166;Montblanc;2863;51;2914
76;Occitanie;34;1;24;167;Montels;253;4;257
76;Occitanie;34;1;05;168;Montesquieu;73;0;73
76;Occitanie;34;3;20;169;Montferrier-sur-Lez;3840;160;4000
76;Occitanie;34;1;24;170;Montouliers;211;5;216
76;Occitanie;34;2;11;171;Montoulieu;162;4;166
76;Occitanie;34;3;99;172;Montpellier;290053;3357;293410
76;Occitanie;34;2;09;173;Montpeyroux;1347;24;1371
76;Occitanie;34;2;11;174;Moulès-et-Baucels;872;26;898
76;Occitanie;34;2;06;175;Mourèze;199;5;204
76;Occitanie;34;3;13;176;Mudaison;2624;27;2651
76;Occitanie;34;2;23;177;Murles;315;10;325
76;Occitanie;34;1;05;178;Murviel-lès-Béziers;3102;53;3155
76;Occitanie;34;3;22;179;Murviel-lès-Montpellier;1873;30;1903
76;Occitanie;34;2;06;180;Nébian;1418;22;1440
76;Occitanie;34;1;05;181;Neffiès;1047;25;1072
76;Occitanie;34;1;21;182;Nézignan-l'Évêque;1825;29;1854
76;Occitanie;34;1;02;183;Nissan-lez-Enserune;4007;61;4068
76;Occitanie;34;1;14;184;Nizas;673;15;688
76;Occitanie;34;2;11;185;Notre-Dame-de-Londres;493;10;503
76;Occitanie;34;2;06;186;Octon;525;12;537
76;Occitanie;34;1;24;187;Olargues;680;14;694
76;Occitanie;34;2;11;188;Olmet-et-Villecun;182;4;186
76;Occitanie;34;1;24;189;Olonzac;1729;19;1748
76;Occitanie;34;1;24;190;Oupia;240;7;247
76;Occitanie;34;1;05;191;Pailhès;570;12;582
76;Occitanie;34;3;13;192;Palavas-les-Flots;5903;41;5944
76;Occitanie;34;1;24;193;Pardailhan;180;6;186
76;Occitanie;34;2;06;194;Paulhan;3977;52;4029
76;Occitanie;34;2;11;195;Pégairolles-de-Buèges;55;1;56
76;Occitanie;34;2;11;196;Pégairolles-de-l'Escalette;156;5;161
76;Occitanie;34;2;14;197;Péret;1026;16;1042
76;Occitanie;34;3;10;198;Pérols;9000;122;9122
76;Occitanie;34;1;21;199;Pézenas;8148;286;8434
76;Occitanie;34;1;06;200;Pézènes-les-Mines;239;10;249
76;Occitanie;34;1;24;201;Pierrerue;292;7;299
76;Occitanie;34;3;22;202;Pignan;7341;100;7441
76;Occitanie;34;1;21;203;Pinet;1825;22;1847
76;Occitanie;34;2;09;204;Plaissan;1284;16;1300
76;Occitanie;34;2;11;205;Les Plans;283;10;293
76;Occitanie;34;1;24;206;Poilhes;548;11;559
76;Occitanie;34;1;21;207;Pomérols;2242;44;2286
76;Occitanie;34;2;09;208;Popian;351;15;366
76;Occitanie;34;1;01;209;Portiragnes;3115;64;3179
76;Occitanie;34;2;09;210;Le Pouget;2068;45;2113
76;Occitanie;34;1;06;211;Le Poujol-sur-Orb;1045;31;1076
76;Occitanie;34;2;11;212;Poujols;170;6;176
76;Occitanie;34;3;14;213;Poussan;5983;77;6060
76;Occitanie;34;1;05;214;Pouzolles;1171;18;1189
76;Occitanie;34;2;09;215;Pouzols;963;22;985
76;Occitanie;34;1;06;216;Le Pradal;332;9;341
76;Occitanie;34;3;23;217;Prades-le-Lez;5581;105;5686
76;Occitanie;34;1;24;218;Prades-sur-Vernazobre;309;8;317
76;Occitanie;34;1;24;219;Prémian;512;9;521
76;Occitanie;34;2;11;220;Le Puech;246;5;251
76;Occitanie;34;2;09;221;Puéchabon;492;11;503
76;Occitanie;34;2;09;222;Puilacher;597;12;609
76;Occitanie;34;1;05;223;Puimisson;1129;23;1152
76;Occitanie;34;1;21;224;Puissalicon;1346;23;1369
76;Occitanie;34;1;24;225;Puisserguier;2974;49;3023
76;Occitanie;34;1;24;226;Quarante;1781;26;1807
76;Occitanie;34;3;07;227;Restinclières;1998;28;2026
76;Occitanie;34;1;24;228;Rieussec;72;4;76
76;Occitanie;34;1;24;229;Riols;753;27;780
76;Occitanie;34;2;11;230;Les Rives;145;4;149
76;Occitanie;34;2;11;231;Romiguières;21;2;23
76;Occitanie;34;1;24;232;Roquebrun;604;11;615
76;Occitanie;34;2;11;233;Roqueredonde;209;3;212
76;Occitanie;34;1;05;234;Roquessels;100;1;101
76;Occitanie;34;1;24;235;Rosis;280;5;285
76;Occitanie;34;2;11;236;Rouet;68;0;68
76;Occitanie;34;1;05;237;Roujan;2169;29;2198
76;Occitanie;34;2;11;238;Saint-André-de-Buèges;38;1;39
76;Occitanie;34;2;09;239;Saint-André-de-Sangonis;6063;104;6167
76;Occitanie;34;3;13;240;Saint-Aunès;3557;31;3588
76;Occitanie;34;2;09;241;Saint-Bauzille-de-la-Sylve;842;13;855
76;Occitanie;34;2;23;242;Saint-Bauzille-de-Montmel;1031;23;1054
76;Occitanie;34;2;11;243;Saint-Bauzille-de-Putois;1989;31;2020
76;Occitanie;34;3;07;244;Saint-Brès;3006;40;3046
76;Occitanie;34;1;24;245;Saint-Chinian;1688;34;1722
76;Occitanie;34;2;23;247;Saint-Clément-de-Rivière;4923;242;5165
76;Occitanie;34;3;07;249;Saint-Drézéry;2630;56;2686
76;Occitanie;34;1;24;250;Saint-Étienne-d'Albagnan;305;7;312
76;Occitanie;34;2;11;251;Saint-Étienne-de-Gourgas;516;17;533
76;Occitanie;34;1;06;252;Saint-Étienne-Estréchoux;254;5;259
76;Occitanie;34;2;11;253;Saint-Félix-de-l'Héras;35;1;36
76;Occitanie;34;2;06;254;Saint-Félix-de-Lodez;1168;32;1200
76;Occitanie;34;2;23;255;Saint-Gély-du-Fesc;9996;260;10256
76;Occitanie;34;1;05;258;Saint-Geniès-de-Fontedit;1631;29;1660
76;Occitanie;34;1;06;257;Saint-Geniès-de-Varensal;212;2;214
76;Occitanie;34;3;07;256;Saint-Geniès-des-Mourgues;1967;33;2000
76;Occitanie;34;3;22;259;Saint-Georges-d'Orques;5476;66;5542
76;Occitanie;34;1;06;260;Saint-Gervais-sur-Mare;862;15;877
76;Occitanie;34;2;09;261;Saint-Guilhem-le-Désert;249;8;257
76;Occitanie;34;2;09;262;Saint-Guiraud;236;0;236
76;Occitanie;34;2;23;263;Saint-Hilaire-de-Beauvoir;426;3;429
76;Occitanie;34;2;11;264;Saint-Jean-de-Buèges;204;0;204
76;Occitanie;34;2;23;265;Saint-Jean-de-Cornies;737;22;759
76;Occitanie;34;2;23;266;Saint-Jean-de-Cuculles;492;7;499
76;Occitanie;34;2;09;267;Saint-Jean-de-Fos;1721;34;1755
76;Occitanie;34;2;11;268;Saint-Jean-de-la-Blaquière;629;16;645
76;Occitanie;34;1;24;269;Saint-Jean-de-Minervois;148;6;154
76;Occitanie;34;3;10;270;Saint-Jean-de-Védas;10452;193;10645
76;Occitanie;34;1;24;271;Saint-Julien;220;3;223
76;Occitanie;34;3;12;272;Saint-Just;3266;29;3295
76;Occitanie;34;1;24;273;Saint-Martin-de-l'Arçon;141;5;146
76;Occitanie;34;2;11;274;Saint-Martin-de-Londres;2761;26;2787
76;Occitanie;34;2;23;276;Saint-Mathieu-de-Tréviers;4836;95;4931
76;Occitanie;34;2;11;277;Saint-Maurice-Navacelles;189;6;195
76;Occitanie;34;2;11;278;Saint-Michel;51;1;52
76;Occitanie;34;1;05;279;Saint-Nazaire-de-Ladarez;339;3;342
76;Occitanie;34;3;12;280;Saint-Nazaire-de-Pézan;621;7;628
76;Occitanie;34;2;09;281;Saint-Pargoire;2294;36;2330
76;Occitanie;34;2;09;282;Saint-Paul-et-Valmalle;1185;18;1203
76;Occitanie;34;2;11;283;Saint-Pierre-de-la-Fage;132;1;133
76;Occitanie;34;1;14;285;Saint-Pons-de-Mauchiens;648;11;659
76;Occitanie;34;1;24;284;Saint-Pons-de-Thomières;1839;179;2018
76;Occitanie;34;2;11;286;Saint-Privat;403;12;415
76;Occitanie;34;2;09;287;Saint-Saturnin-de-Lucian;271;7;278
76;Occitanie;34;3;12;288;Saint-Sériès;984;21;1005
76;Occitanie;34;1;21;289;Saint-Thibéry;2740;35;2775
76;Occitanie;34;1;24;291;Saint-Vincent-d'Olargues;359;23;382
76;Occitanie;34;2;23;290;Saint-Vincent-de-Barbeyrargues;692;10;702
76;Occitanie;34;2;23;248;Sainte-Croix-de-Quintillargues;922;17;939
76;Occitanie;34;2;06;292;Salasc;300;6;306
76;Occitanie;34;1;24;293;La Salvetat-sur-Agout;1136;20;1156
76;Occitanie;34;3;12;294;Saturargues;989;19;1008
76;Occitanie;34;3;22;295;Saussan;1610;33;1643
76;Occitanie;34;3;12;296;Saussines;1018;22;1040
76;Occitanie;34;2;11;297;Sauteyrargues;408;8;416
76;Occitanie;34;1;04;298;Sauvian;5419;96;5515
76;Occitanie;34;1;02;299;Sérignan;7053;151;7204
76;Occitanie;34;1;04;300;Servian;5126;90;5216
76;Occitanie;34;3;25;301;Sète;43686;598;44284
76;Occitanie;34;1;24;302;Siran;740;8;748
76;Occitanie;34;2;11;303;Sorbs;36;1;37
76;Occitanie;34;2;11;304;Soubès;921;12;933
76;Occitanie;34;1;24;305;Le Soulié;129;0;129
76;Occitanie;34;2;11;306;Soumont;180;2;182
76;Occitanie;34;3;07;307;Sussargues;2776;57;2833
76;Occitanie;34;1;06;308;Taussac-la-Billière;451;13;464
76;Occitanie;34;2;23;309;Teyran;4585;105;4690
76;Occitanie;34;1;05;310;Thézan-lès-Béziers;3008;74;3082
76;Occitanie;34;1;06;312;La Tour-sur-Orb;1281;28;1309
76;Occitanie;34;1;21;311;Tourbes;1664;156;1820
76;Occitanie;34;2;09;313;Tressan;668;23;691
76;Occitanie;34;2;23;314;Le Triadou;519;12;531
76;Occitanie;34;2;14;315;Usclas-d'Hérault;425;5;430
76;Occitanie;34;2;11;316;Usclas-du-Bosc;222;2;224
76;Occitanie;34;2;11;317;La Vacquerie-et-Saint-Martin-de-Castries;189;7;196
76;Occitanie;34;2;11;318;Vacquières;710;12;722
76;Occitanie;34;1;05;319;Vailhan;155;4;159
76;Occitanie;34;2;23;320;Vailhauquès;2546;54;2600
76;Occitanie;34;3;13;321;Valergues;2065;29;2094
76;Occitanie;34;2;11;322;Valflaunès;765;24;789
76;Occitanie;34;2;06;323;Valmascle;42;0;42
76;Occitanie;34;1;02;324;Valras-Plage;4223;58;4281
76;Occitanie;34;1;21;325;Valros;1641;32;1673
76;Occitanie;34;1;24;326;Vélieux;88;0;88
76;Occitanie;34;3;07;327;Vendargues;6287;82;6369
76;Occitanie;34;2;09;328;Vendémian;1089;27;1116
76;Occitanie;34;1;02;329;Vendres;2712;81;2793
76;Occitanie;34;1;24;331;Verreries-de-Moussans;96;2;98
76;Occitanie;34;1;01;332;Vias;5735;65;5800
76;Occitanie;34;3;08;333;Vic-la-Gardiole;3317;28;3345
76;Occitanie;34;1;24;334;Vieussan;269;0;269
76;Occitanie;34;1;06;335;Villemagne-l'Argentière;419;12;431
76;Occitanie;34;1;04;336;Villeneuve-lès-Béziers;4155;54;4209
76;Occitanie;34;3;22;337;Villeneuve-lès-Maguelone;10178;120;10298
76;Occitanie;34;2;06;338;Villeneuvette;70;3;73
76;Occitanie;34;1;24;339;Villespassans;173;2;175
76;Occitanie;34;3;12;340;Villetelle;1442;42;1484
76;Occitanie;34;3;14;341;Villeveyrac;3828;68;3896
76;Occitanie;34;2;11;342;Viols-en-Laval;203;4;207
76;Occitanie;34;2;11;343;Viols-le-Fort;1220;28;1248
53;Bretagne;35;3;13;001;Acigné;6814;163;6977
53;Bretagne;35;1;12;002;Amanlis;1733;36;1769
53;Bretagne;35;3;01;003;Andouillé-Neuville;916;9;925
53;Bretagne;35;1;10;005;Arbrissel;310;12;322
53;Bretagne;35;1;10;006;Argentré-du-Plessis;4447;127;4574
53;Bretagne;35;3;01;007;Aubigné;481;2;483
53;Bretagne;35;1;10;008;Availles-sur-Seiche;683;18;701
53;Bretagne;35;4;07;009;Baguer-Morvan;1705;27;1732
53;Bretagne;35;4;07;010;Baguer-Pican;1698;16;1714
53;Bretagne;35;2;02;012;Bain-de-Bretagne;7331;167;7498
53;Bretagne;35;2;17;013;Bains-sur-Oust;3491;146;3637
53;Bretagne;35;1;10;014;Bais;2430;32;2462
53;Bretagne;35;1;27;015;Balazé;2225;48;2273
53;Bretagne;35;2;11;016;Baulon;2179;61;2240
53;Bretagne;35;4;06;017;La Baussaine;667;10;677
53;Bretagne;35;1;09;018;La Bazouge-du-Désert;1074;21;1095
53;Bretagne;35;1;01;019;Bazouges-la-Pérouse;1832;27;1859
53;Bretagne;35;1;09;021;Beaucé;1366;36;1402
53;Bretagne;35;3;15;022;Bécherel;679;15;694
53;Bretagne;35;3;16;023;Bédée;4363;72;4435
53;Bretagne;35;3;03;024;Betton;11968;253;12221
53;Bretagne;35;1;08;025;Billé;1055;15;1070
53;Bretagne;35;3;15;026;Bléruais;105;6;111
53;Bretagne;35;3;15;027;Boisgervilly;1686;32;1718
53;Bretagne;35;1;05;028;Boistrudan;708;14;722
53;Bretagne;35;4;06;029;Bonnemain;1553;25;1578
53;Bretagne;35;2;02;030;La Bosse-de-Bretagne;663;16;679
53;Bretagne;35;3;13;031;La Bouëxière;4486;106;4592
53;Bretagne;35;2;11;033;Bourg-des-Comptes;3282;69;3351
53;Bretagne;35;3;12;032;Bourgbarré;4277;59;4336
53;Bretagne;35;4;07;034;La Boussac;1199;24;1223
53;Bretagne;35;2;11;035;Bovel;602;11;613
53;Bretagne;35;3;24;037;Bréal-sous-Montfort;6262;80;6342
53;Bretagne;35;1;27;038;Bréal-sous-Vitré;639;21;660
53;Bretagne;35;3;13;039;Brécé;2083;44;2127
53;Bretagne;35;3;16;040;Breteil;3620;77;3697
53;Bretagne;35;1;12;041;Brie;978;17;995
53;Bretagne;35;1;10;042;Brielles;673;30;703
53;Bretagne;35;4;07;044;Broualan;375;10;385
53;Bretagne;35;2;17;045;Bruc-sur-Aff;866;19;885
53;Bretagne;35;2;11;046;Les Brulais;547;8;555
53;Bretagne;35;3;04;047;Bruz;18516;456;18972
53;Bretagne;35;4;25;049;Cancale;5147;90;5237
53;Bretagne;35;4;06;050;Cardroc;586;9;595
53;Bretagne;35;3;03;051;Cesson-Sévigné;17312;541;17853
53;Bretagne;35;1;27;052;Champeaux;507;15;522
53;Bretagne;35;2;02;054;Chanteloup;1800;44;1844
53;Bretagne;35;3;20;055;Chantepie;10458;197;10655
53;Bretagne;35;4;06;056;La Chapelle-aux-Filtzméens;819;19;838
53;Bretagne;35;2;11;057;La Chapelle-Bouëxic;1495;26;1521
53;Bretagne;35;3;15;058;La Chapelle-Chaussée;1283;15;1298
53;Bretagne;35;2;17;064;La Chapelle-de-Brain;981;20;1001
53;Bretagne;35;3;03;059;La Chapelle-des-Fougeretz;4735;97;4832
53;Bretagne;35;3;15;060;La Chapelle du Lou du Lac;1005;19;1024
53;Bretagne;35;1;27;061;La Chapelle-Erbrée;700;17;717
53;Bretagne;35;1;09;062;La Chapelle-Janson;1459;27;1486
53;Bretagne;35;1;08;063;La Chapelle-Saint-Aubert;446;6;452
53;Bretagne;35;3;24;065;La Chapelle-Thouarault;2195;43;2238
53;Bretagne;35;3;04;066;Chartres-de-Bretagne;8023;131;8154
53;Bretagne;35;3;13;067;Chasné-sur-Illet;1567;27;1594
53;Bretagne;35;1;05;068;Châteaubourg;7240;153;7393
53;Bretagne;35;3;05;069;Châteaugiron;10125;259;10384
53;Bretagne;35;4;07;070;Châteauneuf-d'Ille-et-Vilaine;1715;25;1740
53;Bretagne;35;1;01;071;Le Châtellier;435;6;441
53;Bretagne;35;1;27;072;Châtillon-en-Vendelais;1682;35;1717
53;Bretagne;35;1;01;075;Chauvigné;826;19;845
53;Bretagne;35;3;24;076;Chavagne;4187;80;4267
53;Bretagne;35;1;10;077;Chelun;349;11;360
53;Bretagne;35;4;07;078;Cherrueix;1097;22;1119
53;Bretagne;35;3;03;079;Chevaigné;2295;57;2352
53;Bretagne;35;3;24;080;Cintré;2344;60;2404
53;Bretagne;35;3;14;081;Clayes;906;29;935
53;Bretagne;35;1;10;082;Coësmes;1466;35;1501
53;Bretagne;35;2;11;084;Comblessac;690;11;701
53;Bretagne;35;4;06;085;Combourg;5945;143;6088
53;Bretagne;35;1;08;086;Combourtillé;610;9;619
53;Bretagne;35;1;27;087;Cornillé;965;32;997
53;Bretagne;35;3;12;088;Corps-Nuds;3369;56;3425
53;Bretagne;35;2;02;089;La Couyère;462;12;474
53;Bretagne;35;2;02;090;Crevin;2858;39;2897
53;Bretagne;35;3;15;091;Le Crouais;587;6;593
53;Bretagne;35;4;06;092;Cuguen;837;14;851
53;Bretagne;35;4;26;093;Dinard;10148;526;10674
53;Bretagne;35;4;06;094;Dingé;1633;24;1657
53;Bretagne;35;4;07;095;Dol-de-Bretagne;5714;313;6027
53;Bretagne;35;1;05;096;Domagné;2344;54;2398
53;Bretagne;35;1;10;097;Domalain;2021;51;2072
53;Bretagne;35;2;02;098;La Dominelais;1386;27;1413
53;Bretagne;35;3;05;099;Domloup;3605;64;3669
53;Bretagne;35;3;13;101;Dourdain;1177;20;1197
53;Bretagne;35;1;10;102;Drouges;514;10;524
53;Bretagne;35;1;10;103;Eancé;411;10;421
53;Bretagne;35;4;07;104;Epiniac;1422;25;1447
53;Bretagne;35;1;27;105;Erbrée;1706;54;1760
53;Bretagne;35;2;02;106;Ercé-en-Lamée;1501;14;1515
53;Bretagne;35;3;13;107;Ercé-près-Liffré;1863;33;1896
53;Bretagne;35;1;10;108;Essé;1077;23;1100
53;Bretagne;35;1;10;109;Étrelles;2569;58;2627
53;Bretagne;35;3;01;110;Feins;996;19;1015
53;Bretagne;35;1;09;111;Le Ferré;698;6;704
53;Bretagne;35;1;09;112;Fleurigné;952;26;978
53;Bretagne;35;1;10;114;Forges-la-Forêt;263;6;269
53;Bretagne;35;1;97;115;Fougères;20528;658;21186
53;Bretagne;35;4;07;116;La Fresnais;2554;57;2611
53;Bretagne;35;3;15;117;Gaël;1618;22;1640
53;Bretagne;35;3;01;118;Gahard;1497;23;1520
53;Bretagne;35;1;10;119;Gennes-sur-Seiche;948;21;969
53;Bretagne;35;3;14;120;Gévezé;5411;106;5517
53;Bretagne;35;3;08;121;Gosné;1987;37;2024
53;Bretagne;35;4;25;122;La Gouesnière;1919;46;1965
53;Bretagne;35;2;11;123;Goven;4324;90;4414
53;Bretagne;35;2;02;124;Grand-Fougeray;2436;38;2474
53;Bretagne;35;1;10;125;La Guerche-de-Bretagne;4233;147;4380
53;Bretagne;35;2;11;126;Guichen;8646;201;8847
53;Bretagne;35;2;11;127;Guignen;3944;96;4040
53;Bretagne;35;3;14;128;Guipel;1696;39;1735
53;Bretagne;35;2;17;176;Guipry-Messac;7034;145;7179
53;Bretagne;35;4;14;130;Hédé-Bazouges;2243;53;2296
53;Bretagne;35;3;24;131;L' Hermitage;4533;80;4613
53;Bretagne;35;4;07;132;Hirel;1390;35;1425
53;Bretagne;35;3;16;133;Iffendic;4528;92;4620
53;Bretagne;35;4;06;134;Les Iffs;273;12;285
53;Bretagne;35;3;15;135;Irodouër;2262;37;2299
53;Bretagne;35;1;12;136;Janzé;8329;156;8485
53;Bretagne;35;1;08;137;Javené;2073;68;2141
53;Bretagne;35;1;09;138;Laignelet;1166;27;1193
53;Bretagne;35;3;04;139;Laillé;5069;147;5216
53;Bretagne;35;2;02;140;Lalleu;565;10;575
53;Bretagne;35;1;27;141;Landavran;694;21;715
53;Bretagne;35;1;09;142;Landéan;1194;22;1216
53;Bretagne;35;3;15;143;Landujan;911;29;940
53;Bretagne;35;3;15;144;Langan;1010;19;1029
53;Bretagne;35;2;17;145;Langon;1401;25;1426
53;Bretagne;35;3;14;146;Langouet;601;2;603
53;Bretagne;35;4;06;148;Lanrigan;154;0;154
53;Bretagne;35;2;11;149;Lassy;1729;38;1767
53;Bretagne;35;1;08;150;Lécousse;3241;94;3335
53;Bretagne;35;2;17;151;Lieuron;786;15;801
53;Bretagne;35;3;13;152;Liffré;7768;134;7902
53;Bretagne;35;4;07;153;Lillemer;362;11;373
53;Bretagne;35;3;08;154;Livré-sur-Changeon;1709;41;1750
53;Bretagne;35;2;17;155;Lohéac;653;15;668
53;Bretagne;35;4;06;156;Longaulnay;614;10;624
53;Bretagne;35;1;09;157;Le Loroux;647;15;662
53;Bretagne;35;4;06;159;Lourmais;328;3;331
53;Bretagne;35;2;11;160;Loutehel;253;5;258
53;Bretagne;35;1;05;161;Louvigné-de-Bais;1908;36;1944
53;Bretagne;35;1;09;162;Louvigné-du-Désert;3346;59;3405
53;Bretagne;35;1;  ;163;Luitré-Dompierre ;1831;29;1860
53;Bretagne;35;1;01;257;Maen Roch;4921;96;5017
53;Bretagne;35;1;01;164;Marcillé-Raoul;751;11;762
53;Bretagne;35;1;10;165;Marcillé-Robert;954;21;975
53;Bretagne;35;1;27;166;Marpiré;1041;16;1057
53;Bretagne;35;1;10;167;Martigné-Ferchaud;2593;66;2659
53;Bretagne;35;3;16;169;Maxent;1464;17;1481
53;Bretagne;35;1;27;170;Mecé;607;16;623
53;Bretagne;35;3;15;171;Médréac;1826;48;1874
53;Bretagne;35;4;06;172;Meillac;1881;30;1911
53;Bretagne;35;3;14;173;Melesse;6803;104;6907
53;Bretagne;35;1;09;174;Mellé;650;12;662
53;Bretagne;35;2;11;175;Mernel;1023;16;1039
53;Bretagne;35;4;06;308;Mesnil-Roc'h ;4323;76;4399
53;Bretagne;35;3;14;177;La Mézière;4932;120;5052
53;Bretagne;35;3;08;178;Mézières-sur-Couesnon;1778;32;1810
53;Bretagne;35;4;07;179;Miniac-Morvan;4040;78;4118
53;Bretagne;35;3;15;180;Miniac-sous-Bécherel;784;16;800
53;Bretagne;35;4;26;181;Le Minihic-sur-Rance;1466;34;1500
53;Bretagne;35;1;27;183;Mondevert;820;21;841
53;Bretagne;35;4;07;186;Mont-Dol;1076;31;1107
53;Bretagne;35;3;15;184;Montauban-de-Bretagne ;5946;243;6189
53;Bretagne;35;1;27;185;Montautour;265;1;266
53;Bretagne;35;3;16;187;Monterfil;1329;45;1374
53;Bretagne;35;3;16;188;Montfort-sur-Meu;6691;172;6863
53;Bretagne;35;3;03;189;Montgermont;3440;61;3501
53;Bretagne;35;1;09;190;Monthault;258;8;266
53;Bretagne;35;1;27;192;Montreuil-des-Landes;236;5;241
53;Bretagne;35;3;14;193;Montreuil-le-Gast;1943;43;1986
53;Bretagne;35;1;27;194;Montreuil-sous-Pérouse;1011;32;1043
53;Bretagne;35;3;01;195;Montreuil-sur-Ille;2389;35;2424
53;Bretagne;35;3;24;196;Mordelles;7356;141;7497
53;Bretagne;35;3;01;197;Mouazé;1661;19;1680
53;Bretagne;35;1;10;198;Moulins;714;25;739
53;Bretagne;35;1;10;199;Moussé;339;9;348
53;Bretagne;35;1;10;200;Moutiers;927;16;943
53;Bretagne;35;3;15;201;Muel;887;7;894
53;Bretagne;35;2;02;202;La Noë-Blanche;1012;9;1021
53;Bretagne;35;3;16;203;La Nouaye;353;5;358
53;Bretagne;35;3;12;204;Nouvoitou;3173;57;3230
53;Bretagne;35;3;04;206;Noyal-Châtillon-sur-Seiche;6885;125;7010
53;Bretagne;35;1;01;205;Noyal-sous-Bazouges;382;8;390
53;Bretagne;35;3;05;207;Noyal-sur-Vilaine;6070;148;6218
53;Bretagne;35;3;12;208;Orgères;4993;119;5112
53;Bretagne;35;3;23;210;Pacé;11825;326;12151
53;Bretagne;35;3;16;211;Paimpont;1755;39;1794
53;Bretagne;35;2;02;212;Pancé;1180;31;1211
53;Bretagne;35;1;08;214;Parcé;650;1;651
53;Bretagne;35;1;09;215;Parigné;1338;43;1381
53;Bretagne;35;3;14;216;Parthenay-de-Bretagne;1766;29;1795
53;Bretagne;35;1;10;217;Le Pertre;1385;29;1414
53;Bretagne;35;2;02;218;Le Petit-Fougeray;888;20;908
53;Bretagne;35;2;17;219;Pipriac;3779;75;3854
53;Bretagne;35;3;05;220;Piré-Chancé;2967;53;3020
53;Bretagne;35;2;02;221;Pléchâtel;2828;54;2882
53;Bretagne;35;4;07;222;Pleine-Fougères;1977;33;2010
53;Bretagne;35;3;16;223;Plélan-le-Grand;3986;87;4073
53;Bretagne;35;4;07;224;Plerguer;2756;51;2807
53;Bretagne;35;4;06;225;Plesder;786;15;801
53;Bretagne;35;4;06;226;Pleugueneuc;1914;27;1941
53;Bretagne;35;3;16;227;Pleumeleuc;3418;50;3468
53;Bretagne;35;4;26;228;Pleurtuit;6910;122;7032
53;Bretagne;35;1;27;229;Pocé-les-Bois;1303;51;1354
53;Bretagne;35;1;09;230;Poilley;374;4;378
53;Bretagne;35;2;02;231;Poligné;1199;31;1230
53;Bretagne;35;3;04;363;Pont-Péan;4437;106;4543
53;Bretagne;35;1;01;191;Les Portes du Coglais;2354;49;2403
53;Bretagne;35;1;27;232;Princé;386;7;393
53;Bretagne;35;4;06;233;Québriac;1574;37;1611
53;Bretagne;35;3;15;234;Quédillac;1190;17;1207
53;Bretagne;35;1;10;235;Rannée;1086;47;1133
53;Bretagne;35;2;17;236;Redon;9151;771;9922
53;Bretagne;35;2;17;237;Renac;1028;22;1050
53;Bretagne;35;3;98;238;Rennes;217728;4170;221898
53;Bretagne;35;1;10;239;Retiers;4402;95;4497
53;Bretagne;35;3;24;240;Le Rheu;8914;292;9206
53;Bretagne;35;4;26;241;La Richardais;2349;83;2432
53;Bretagne;35;1;01;242;Rimou;341;4;345
53;Bretagne;35;1;08;282;Rives-du-Couesnon ;2871;52;2923
53;Bretagne;35;1;08;243;Romagné;2438;54;2492
53;Bretagne;35;1;01;244;Romazy;251;3;254
53;Bretagne;35;3;15;245;Romillé;3942;72;4014
53;Bretagne;35;4;07;246;Roz-Landrieux;1349;27;1376
53;Bretagne;35;4;07;247;Roz-sur-Couesnon;1000;12;1012
53;Bretagne;35;4;07;248;Sains;471;8;479
53;Bretagne;35;3;12;250;Saint-Armel;2094;37;2131
53;Bretagne;35;3;01;251;Saint-Aubin-d'Aubigné;3859;82;3941
53;Bretagne;35;1;27;252;Saint-Aubin-des-Landes;935;35;970
53;Bretagne;35;3;08;253;Saint-Aubin-du-Cormier;3901;160;4061
53;Bretagne;35;4;07;255;Saint-Benoît-des-Ondes;986;30;1016
53;Bretagne;35;4;26;256;Saint-Briac-sur-Mer;2132;62;2194
53;Bretagne;35;4;06;258;Saint-Brieuc-des-Iffs;335;9;344
53;Bretagne;35;4;07;259;Saint-Broladre;1136;22;1158
53;Bretagne;35;1;08;261;Saint-Christophe-de-Valains;230;2;232
53;Bretagne;35;1;27;260;Saint-Christophe-des-Bois;562;6;568
53;Bretagne;35;4;25;263;Saint-Coulomb;2788;87;2875
53;Bretagne;35;1;05;264;Saint-Didier;2043;45;2088
53;Bretagne;35;4;06;265;Saint-Domineuc;2548;49;2597
53;Bretagne;35;3;12;266;Saint-Erblon;3195;70;3265
53;Bretagne;35;2;17;268;Saint-Ganton;428;8;436
53;Bretagne;35;4;07;270;Saint-Georges-de-Gréhaigne;367;4;371
53;Bretagne;35;1;09;271;Saint-Georges-de-Reintembault;1494;26;1520
53;Bretagne;35;1;10;272;Saint-Germain-du-Pinel;933;22;955
53;Bretagne;35;1;01;273;Saint-Germain-en-Coglès;2053;31;2084
53;Bretagne;35;3;14;274;Saint-Germain-sur-Ille;923;14;937
53;Bretagne;35;3;14;275;Saint-Gilles;5093;84;5177
53;Bretagne;35;3;14;276;Saint-Gondran;552;11;563
53;Bretagne;35;3;16;277;Saint-Gonlay;365;6;371
53;Bretagne;35;3;03;278;Saint-Grégoire;9765;370;10135
53;Bretagne;35;4;07;279;Saint-Guinoux;1209;28;1237
53;Bretagne;35;1;01;280;Saint-Hilaire-des-Landes;1032;20;1052
53;Bretagne;35;3;22;281;Saint-Jacques-de-la-Lande;13533;154;13687
53;Bretagne;35;1;05;283;Saint-Jean-sur-Vilaine;1300;23;1323
53;Bretagne;35;4;26;284;Saint-Jouan-des-Guérets;2669;70;2739
53;Bretagne;35;2;17;285;Saint-Just;1062;23;1085
53;Bretagne;35;4;06;286;Saint-Léger-des-Prés;274;10;284
53;Bretagne;35;4;26;287;Saint-Lunaire;2396;86;2482
53;Bretagne;35;1;27;300;Saint-M'Hervé;1347;39;1386
53;Bretagne;35;4;99;288;Saint-Malo;46478;1339;47817
53;Bretagne;35;2;17;289;Saint-Malo-de-Phily;1079;18;1097
53;Bretagne;35;3;15;290;Saint-Malon-sur-Mel;582;11;593
53;Bretagne;35;1;01;292;Saint-Marc-le-Blanc;1661;39;1700
53;Bretagne;35;4;07;291;Saint-Marcan;442;9;451
53;Bretagne;35;3;15;295;Saint-Maugan;537;11;548
53;Bretagne;35;3;14;296;Saint-Médard-sur-Ille;1306;23;1329
53;Bretagne;35;3;15;297;Saint-Méen-le-Grand;4622;169;4791
53;Bretagne;35;4;25;299;Saint-Méloir-des-Ondes;4211;106;4317
53;Bretagne;35;3;15;302;Saint-Onen-la-Chapelle;1129;24;1153
53;Bretagne;35;1;08;304;Saint-Ouen-des-Alleux;1305;28;1333
53;Bretagne;35;3;16;305;Saint-Péran;414;8;422
53;Bretagne;35;4;07;306;Saint-Père-Marc-en-Poulet;2315;162;2477
53;Bretagne;35;3;15;307;Saint-Pern;1040;19;1059
53;Bretagne;35;1;01;309;Saint-Rémy-du-Plain;821;13;834
53;Bretagne;35;1;08;310;Saint-Sauveur-des-Landes;1521;27;1548
53;Bretagne;35;2;11;311;Saint-Séglin;574;4;578
53;Bretagne;35;2;11;312;Saint-Senoux;1842;48;1890
53;Bretagne;35;4;07;314;Saint-Suliac;925;49;974
53;Bretagne;35;2;02;316;Saint-Sulpice-des-Landes;818;9;827
53;Bretagne;35;3;13;315;Saint-Sulpice-la-Forêt;1378;40;1418
53;Bretagne;35;3;14;317;Saint-Symphorien;594;61;655
53;Bretagne;35;4;06;318;Saint-Thual;931;21;952
53;Bretagne;35;3;16;319;Saint-Thurial;2099;43;2142
53;Bretagne;35;3;15;320;Saint-Uniac;540;4;544
53;Bretagne;35;2;02;249;Sainte-Anne-sur-Vilaine;1028;14;1042
53;Bretagne;35;1;10;262;Sainte-Colombe;351;6;357
53;Bretagne;35;2;17;294;Sainte-Marie;2257;65;2322
53;Bretagne;35;2;02;321;Saulnières;782;10;792
53;Bretagne;35;2;02;322;Le Sel-de-Bretagne;1107;27;1134
53;Bretagne;35;1;09;324;La Selle-en-Luitré;615;17;632
53;Bretagne;35;1;10;325;La Selle-Guerchaise;154;6;160
53;Bretagne;35;3;01;326;Sens-de-Bretagne;2560;41;2601
53;Bretagne;35;3;05;327;Servon-sur-Vilaine;3740;87;3827
53;Bretagne;35;2;17;328;Sixt-sur-Aff;2144;43;2187
53;Bretagne;35;4;07;329;Sougéal;558;11;569
53;Bretagne;35;1;27;330;Taillis;996;26;1022
53;Bretagne;35;3;16;331;Talensac;2492;51;2543
53;Bretagne;35;2;02;332;Teillay;1067;11;1078
53;Bretagne;35;1;10;333;Le Theil-de-Bretagne;1717;33;1750
53;Bretagne;35;3;13;334;Thorigné-Fouillard;8519;210;8729
53;Bretagne;35;1;10;335;Thourie;819;21;840
53;Bretagne;35;1;01;336;Le Tiercent;179;3;182
53;Bretagne;35;4;06;337;Tinténiac;3704;191;3895
53;Bretagne;35;1;10;338;Torcé;1205;28;1233
53;Bretagne;35;4;07;339;Trans-la-Forêt;587;4;591
53;Bretagne;35;3;16;340;Treffendel;1279;23;1302
53;Bretagne;35;4;06;342;Trémeheuc;345;12;357
53;Bretagne;35;2;02;343;Tresbœuf;1246;20;1266
53;Bretagne;35;4;06;345;Trévérien;888;23;911
53;Bretagne;35;4;06;346;Trimer;211;4;215
53;Bretagne;35;4;07;362;Le Tronchet;1167;9;1176
53;Bretagne;35;1;01;004;Val-Couesnon ;4158;89;4247
53;Bretagne;35;2;11;168;Val d'Anast;3965;81;4046
53;Bretagne;35;1;27;347;Val-d'Izé;2584;57;2641
53;Bretagne;35;1;10;350;Vergéal;801;24;825
53;Bretagne;35;3;24;351;Le Verger;1439;24;1463
53;Bretagne;35;3;12;352;Vern-sur-Seiche;8049;144;8193
53;Bretagne;35;3;24;353;Vezin-le-Coquet;5987;109;6096
53;Bretagne;35;4;07;354;Vieux-Viel;314;2;316
53;Bretagne;35;3;01;355;Vieux-Vy-sur-Couesnon;1226;6;1232
53;Bretagne;35;3;14;356;Vignoc;1950;24;1974
53;Bretagne;35;1;09;357;Villamée;310;5;315
53;Bretagne;35;4;07;358;La Ville-ès-Nonais;1222;32;1254
53;Bretagne;35;1;10;359;Visseiche;830;17;847
53;Bretagne;35;1;27;360;Vitré;18267;548;18815
53;Bretagne;35;4;07;361;Le Vivier-sur-Mer;1046;7;1053
24;Centre-Val de Loire;36;3;11;001;Aigurande;1426;27;1453
24;Centre-Val de Loire;36;4;10;002;Aize;117;0;117
24;Centre-Val de Loire;36;4;01;003;Ambrault;893;23;916
24;Centre-Val de Loire;36;4;13;004;Anjouin;327;8;335
24;Centre-Val de Loire;36;2;01;005;Ardentes;3829;81;3910
24;Centre-Val de Loire;36;2;02;006;Argenton-sur-Creuse;4902;213;5115
24;Centre-Val de Loire;36;2;04;007;Argy;603;9;612
24;Centre-Val de Loire;36;2;04;008;Arpheuilles;222;9;231
24;Centre-Val de Loire;36;2;01;009;Arthon;1234;45;1279
24;Centre-Val de Loire;36;1;03;010;Azay-le-Ferron;863;18;881
24;Centre-Val de Loire;36;2;02;158;Badecon-le-Pin;759;9;768
24;Centre-Val de Loire;36;4;13;011;Bagneux;174;2;176
24;Centre-Val de Loire;36;2;02;012;Baraize;357;0;357
24;Centre-Val de Loire;36;2;10;013;Baudres;432;5;437
24;Centre-Val de Loire;36;2;02;014;Bazaiges;200;6;206
24;Centre-Val de Loire;36;1;12;015;Beaulieu;54;1;55
24;Centre-Val de Loire;36;1;12;016;Bélâbre;957;22;979
24;Centre-Val de Loire;36;3;08;017;La Berthenoux;383;5;388
24;Centre-Val de Loire;36;1;03;018;Le Blanc;6319;222;6541
24;Centre-Val de Loire;36;4;08;019;Bommiers;308;5;313
24;Centre-Val de Loire;36;1;12;020;Bonneuil;76;1;77
24;Centre-Val de Loire;36;4;09;021;Les Bordes;893;20;913
24;Centre-Val de Loire;36;2;02;022;Bouesse;425;9;434
24;Centre-Val de Loire;36;2;10;023;Bouges-le-Château;263;5;268
24;Centre-Val de Loire;36;2;10;024;Bretagne;138;1;139
24;Centre-Val de Loire;36;3;08;025;Briantes;606;11;617
24;Centre-Val de Loire;36;2;10;026;Brion;589;8;597
24;Centre-Val de Loire;36;4;08;027;Brives;254;6;260
24;Centre-Val de Loire;36;3;11;028;La Buxerette;112;2;114
24;Centre-Val de Loire;36;4;10;029;Buxeuil;224;3;227
24;Centre-Val de Loire;36;3;11;030;Buxières-d'Aillac;250;4;254
24;Centre-Val de Loire;36;2;04;031;Buzançais;4528;75;4603
24;Centre-Val de Loire;36;2;02;032;Ceaulmont;724;22;746
24;Centre-Val de Loire;36;2;02;033;Celon;403;4;407
24;Centre-Val de Loire;36;4;13;034;Chabris;2759;40;2799
24;Centre-Val de Loire;36;1;12;035;Chaillac;1089;13;1102
24;Centre-Val de Loire;36;1;12;036;Chalais;144;1;145
24;Centre-Val de Loire;36;4;10;037;La Champenoise;276;6;282
24;Centre-Val de Loire;36;3;08;038;Champillet;145;2;147
24;Centre-Val de Loire;36;2;04;040;La Chapelle-Orthemale;106;0;106
24;Centre-Val de Loire;36;4;10;041;La Chapelle-Saint-Laurian;144;1;145
24;Centre-Val de Loire;36;2;02;042;Chasseneuil;704;11;715
24;Centre-Val de Loire;36;3;11;043;Chassignolles;573;23;596
24;Centre-Val de Loire;36;2;99;044;Châteauroux;43442;1554;44996
24;Centre-Val de Loire;36;2;04;045;Châtillon-sur-Indre;2464;45;2509
24;Centre-Val de Loire;36;3;08;046;La Châtre;4040;118;4158
24;Centre-Val de Loire;36;1;12;047;La Châtre-Langlin;508;8;516
24;Centre-Val de Loire;36;2;02;048;Chavin;270;9;279
24;Centre-Val de Loire;36;1;12;049;Chazelet;125;2;127
24;Centre-Val de Loire;36;2;04;050;Chezelles;467;7;474
24;Centre-Val de Loire;36;1;12;051;Chitray;184;5;189
24;Centre-Val de Loire;36;4;09;052;Chouday;151;2;153
24;Centre-Val de Loire;36;1;03;053;Ciron;559;14;573
24;Centre-Val de Loire;36;2;04;054;Cléré-du-Bois;239;7;246
24;Centre-Val de Loire;36;2;04;055;Clion;1014;19;1033
24;Centre-Val de Loire;36;3;11;056;Cluis;990;15;1005
24;Centre-Val de Loire;36;2;10;057;Coings;873;22;895
24;Centre-Val de Loire;36;1;03;058;Concremiers;647;17;664
24;Centre-Val de Loire;36;4;08;059;Condé;237;8;245
24;Centre-Val de Loire;36;3;11;060;Crevant;710;14;724
24;Centre-Val de Loire;36;3;11;061;Crozon-sur-Vauvre;336;9;345
24;Centre-Val de Loire;36;2;02;062;Cuzion;440;6;446
24;Centre-Val de Loire;36;2;05;063;Déols;7559;148;7707
24;Centre-Val de Loire;36;2;01;064;Diors;749;16;765
24;Centre-Val de Loire;36;4;10;065;Diou;261;5;266
24;Centre-Val de Loire;36;1;03;066;Douadic;443;14;457
24;Centre-Val de Loire;36;4;13;068;Dun-le-Poëlier;424;7;431
24;Centre-Val de Loire;36;1;12;067;Dunet;100;3;103
24;Centre-Val de Loire;36;2;13;069;Écueillé;1238;23;1261
24;Centre-Val de Loire;36;2;02;070;Éguzon-Chantôme;1365;38;1403
24;Centre-Val de Loire;36;2;01;071;Étrechet;1010;20;1030
24;Centre-Val de Loire;36;3;08;073;Feusines;214;5;219
24;Centre-Val de Loire;36;2;04;074;Fléré-la-Rivière;544;9;553
24;Centre-Val de Loire;36;4;10;075;Fontenay;89;1;90
24;Centre-Val de Loire;36;1;03;076;Fontgombault;249;3;252
24;Centre-Val de Loire;36;2;13;077;Fontguenand;242;3;245
24;Centre-Val de Loire;36;3;11;078;Fougerolles;353;5;358
24;Centre-Val de Loire;36;2;10;079;Francillon;78;1;79
24;Centre-Val de Loire;36;2;13;080;Frédille;72;2;74
24;Centre-Val de Loire;36;2;02;081;Gargilesse-Dampierre;283;8;291
24;Centre-Val de Loire;36;2;13;082;Gehée;253;1;254
24;Centre-Val de Loire;36;4;10;083;Giroux;116;4;120
24;Centre-Val de Loire;36;3;11;084;Gournay;287;2;289
24;Centre-Val de Loire;36;4;10;085;Guilly;245;6;251
24;Centre-Val de Loire;36;2;13;086;Heugnes;390;8;398
24;Centre-Val de Loire;36;1;03;087;Ingrandes;314;5;319
24;Centre-Val de Loire;36;4;09;088;Issoudun;11690;292;11982
24;Centre-Val de Loire;36;2;01;089;Jeu-les-Bois;397;6;403
24;Centre-Val de Loire;36;2;13;090;Jeu-Maloches;123;2;125
24;Centre-Val de Loire;36;3;08;091;Lacs;654;18;672
24;Centre-Val de Loire;36;2;13;092;Langé;278;8;286
24;Centre-Val de Loire;36;2;10;093;Levroux ;2931;37;2968
24;Centre-Val de Loire;36;1;12;094;Lignac;453;7;460
24;Centre-Val de Loire;36;3;08;095;Lignerolles;103;2;105
24;Centre-Val de Loire;36;1;03;096;Lingé;221;4;225
24;Centre-Val de Loire;36;4;10;097;Liniez;324;9;333
24;Centre-Val de Loire;36;4;10;098;Lizeray;83;3;86
24;Centre-Val de Loire;36;3;11;099;Lourdoueix-Saint-Michel;307;4;311
24;Centre-Val de Loire;36;3;08;100;Lourouer-Saint-Laurent;266;6;272
24;Centre-Val de Loire;36;2;12;101;Luant;1520;39;1559
24;Centre-Val de Loire;36;1;03;104;Lurais;241;2;243
24;Centre-Val de Loire;36;1;03;105;Lureuil;260;3;263
24;Centre-Val de Loire;36;1;12;106;Luzeret;154;1;155
24;Centre-Val de Loire;36;4;10;102;Luçay-le-Libre;101;2;103
24;Centre-Val de Loire;36;2;13;103;Luçay-le-Mâle;1355;17;1372
24;Centre-Val de Loire;36;2;13;107;Lye;716;12;728
24;Centre-Val de Loire;36;3;11;108;Lys-Saint-Georges;218;2;220
24;Centre-Val de Loire;36;3;11;109;Le Magny;1070;19;1089
24;Centre-Val de Loire;36;3;11;110;Maillet;261;6;267
24;Centre-Val de Loire;36;3;11;111;Malicornay;194;3;197
24;Centre-Val de Loire;36;2;01;112;Mâron;751;19;770
24;Centre-Val de Loire;36;1;03;113;Martizay;941;20;961
24;Centre-Val de Loire;36;1;12;114;Mauvières;302;8;310
24;Centre-Val de Loire;36;4;13;115;Menetou-sur-Nahon;123;2;125
24;Centre-Val de Loire;36;4;10;116;Ménétréols-sous-Vatan;118;1;119
24;Centre-Val de Loire;36;2;02;117;Le Menoux;431;7;438
24;Centre-Val de Loire;36;2;12;118;Méobecq;376;3;379
24;Centre-Val de Loire;36;1;03;119;Mérigny;539;13;552
24;Centre-Val de Loire;36;3;11;120;Mers-sur-Indre;660;13;673
24;Centre-Val de Loire;36;4;08;121;Meunet-Planches;173;6;179
24;Centre-Val de Loire;36;4;10;122;Meunet-sur-Vatan;196;2;198
24;Centre-Val de Loire;36;1;03;123;Mézières-en-Brenne;996;20;1016
24;Centre-Val de Loire;36;1;12;124;Migné;275;11;286
24;Centre-Val de Loire;36;4;09;125;Migny;124;5;129
24;Centre-Val de Loire;36;3;11;126;Montchevrier;448;5;453
24;Centre-Val de Loire;36;3;11;127;Montgivray;1586;37;1623
24;Centre-Val de Loire;36;2;01;128;Montierchaume;1667;167;1834
24;Centre-Val de Loire;36;3;11;129;Montipouret;556;15;571
24;Centre-Val de Loire;36;3;08;130;Montlevicq;111;2;113
24;Centre-Val de Loire;36;2;02;131;Mosnay;474;7;481
24;Centre-Val de Loire;36;3;08;132;La Motte-Feuilly;60;3;63
24;Centre-Val de Loire;36;3;11;133;Mouhers;223;6;229
24;Centre-Val de Loire;36;1;12;134;Mouhet;408;12;420
24;Centre-Val de Loire;36;2;10;135;Moulins-sur-Céphons;294;6;300
24;Centre-Val de Loire;36;2;04;136;Murs;128;3;131
24;Centre-Val de Loire;36;1;03;137;Néons-sur-Creuse;367;16;383
24;Centre-Val de Loire;36;3;08;138;Néret;189;7;196
24;Centre-Val de Loire;36;2;12;139;Neuillay-les-Bois;653;16;669
24;Centre-Val de Loire;36;4;08;140;Neuvy-Pailloux;1185;21;1206
24;Centre-Val de Loire;36;3;11;141;Neuvy-Saint-Sépulchre;1652;38;1690
24;Centre-Val de Loire;36;2;04;142;Niherne;1586;31;1617
24;Centre-Val de Loire;36;3;08;143;Nohant-Vic;449;13;462
24;Centre-Val de Loire;36;1;12;144;Nuret-le-Ferron;300;7;307
24;Centre-Val de Loire;36;1;03;145;Obterre;182;3;185
24;Centre-Val de Loire;36;3;11;146;Orsennes;742;10;752
24;Centre-Val de Loire;36;4;13;147;Orville;138;3;141
24;Centre-Val de Loire;36;1;12;148;Oulches;409;3;412
24;Centre-Val de Loire;36;2;04;149;Palluau-sur-Indre;790;12;802
24;Centre-Val de Loire;36;1;12;150;Parnac;498;9;507
24;Centre-Val de Loire;36;4;10;152;Paudy;446;3;449
24;Centre-Val de Loire;36;1;03;153;Paulnay;331;7;338
24;Centre-Val de Loire;36;2;02;154;Le Pêchereau;1861;38;1899
24;Centre-Val de Loire;36;2;13;155;Pellevoisin;784;55;839
24;Centre-Val de Loire;36;3;08;156;Pérassay;364;2;366
24;Centre-Val de Loire;36;1;12;157;La Pérouille;454;13;467
24;Centre-Val de Loire;36;2;01;159;Le Poinçonnet;5831;173;6004
24;Centre-Val de Loire;36;2;02;160;Pommiers;218;5;223
24;Centre-Val de Loire;36;2;02;161;Le Pont-Chrétien-Chabenet;928;10;938
24;Centre-Val de Loire;36;4;13;162;Poulaines;835;19;854
24;Centre-Val de Loire;36;3;08;163;Pouligny-Notre-Dame;694;12;706
24;Centre-Val de Loire;36;3;08;164;Pouligny-Saint-Martin;224;3;227
24;Centre-Val de Loire;36;1;03;165;Pouligny-Saint-Pierre;1053;28;1081
24;Centre-Val de Loire;36;2;13;166;Préaux;163;4;167
24;Centre-Val de Loire;36;1;03;167;Preuilly-la-Ville;159;3;162
24;Centre-Val de Loire;36;1;12;168;Prissac;591;15;606
24;Centre-Val de Loire;36;4;08;169;Pruniers;512;10;522
24;Centre-Val de Loire;36;4;10;170;Reboursin;106;0;106
24;Centre-Val de Loire;36;4;10;171;Reuilly;2018;38;2056
24;Centre-Val de Loire;36;1;12;172;Rivarennes;547;11;558
24;Centre-Val de Loire;36;1;03;173;Rosnay;520;13;533
24;Centre-Val de Loire;36;1;12;174;Roussines;361;11;372
24;Centre-Val de Loire;36;2;10;175;Rouvres-les-Bois;281;2;283
24;Centre-Val de Loire;36;1;03;176;Ruffec;588;8;596
24;Centre-Val de Loire;36;1;12;177;Sacierges-Saint-Martin;322;6;328
24;Centre-Val de Loire;36;1;03;178;Saint-Aigny;280;12;292
24;Centre-Val de Loire;36;4;10;179;Saint-Aoustrille;229;0;229
24;Centre-Val de Loire;36;3;08;180;Saint-Août;830;18;848
24;Centre-Val de Loire;36;4;08;181;Saint-Aubin;174;3;177
24;Centre-Val de Loire;36;1;12;182;Saint-Benoît-du-Sault;597;18;615
24;Centre-Val de Loire;36;3;08;184;Saint-Chartier;502;8;510
24;Centre-Val de Loire;36;4;13;185;Saint-Christophe-en-Bazelle;368;3;371
24;Centre-Val de Loire;36;3;08;186;Saint-Christophe-en-Boucherie;257;3;260
24;Centre-Val de Loire;36;1;12;187;Saint-Civran;136;2;138
24;Centre-Val de Loire;36;2;04;188;Saint-Cyran-du-Jambot;192;156;348
24;Centre-Val de Loire;36;3;11;189;Saint-Denis-de-Jouhet;969;13;982
24;Centre-Val de Loire;36;4;10;191;Saint-Florentin;532;7;539
24;Centre-Val de Loire;36;1;12;192;Saint-Gaultier;1811;24;1835
24;Centre-Val de Loire;36;2;04;194;Saint-Genou;961;16;977
24;Centre-Val de Loire;36;4;09;195;Saint-Georges-sur-Arnon;574;14;588
24;Centre-Val de Loire;36;1;12;196;Saint-Gilles;105;3;108
24;Centre-Val de Loire;36;1;12;197;Saint-Hilaire-sur-Benaize;297;8;305
24;Centre-Val de Loire;36;2;04;198;Saint-Lactencin;415;14;429
24;Centre-Val de Loire;36;2;02;200;Saint-Marcel;1506;24;1530
24;Centre-Val de Loire;36;2;89;202;Saint-Maur;3654;76;3730
24;Centre-Val de Loire;36;2;04;203;Saint-Médard;50;0;50
24;Centre-Val de Loire;36;1;03;204;Saint-Michel-en-Brenne;323;7;330
24;Centre-Val de Loire;36;4;10;205;Saint-Pierre-de-Jards;116;4;120
24;Centre-Val de Loire;36;3;11;207;Saint-Plantaire;613;13;626
24;Centre-Val de Loire;36;4;10;209;Saint-Valentin;274;13;287
24;Centre-Val de Loire;36;4;01;190;Sainte-Fauste;272;1;273
24;Centre-Val de Loire;36;1;03;193;Sainte-Gemme;258;8;266
24;Centre-Val de Loire;36;4;10;199;Sainte-Lizaigne;1161;24;1185
24;Centre-Val de Loire;36;3;08;208;Sainte-Sévère-sur-Indre;770;14;784
24;Centre-Val de Loire;36;3;11;210;Sarzay;301;11;312
24;Centre-Val de Loire;36;2;01;211;Sassierges-Saint-Germain;467;8;475
24;Centre-Val de Loire;36;1;03;212;Saulnay;156;2;158
24;Centre-Val de Loire;36;1;03;213;Sauzelles;250;4;254
24;Centre-Val de Loire;36;3;08;214;Sazeray;300;10;310
24;Centre-Val de Loire;36;4;09;215;Ségry;500;13;513
24;Centre-Val de Loire;36;2;13;216;Selles-sur-Nahon;68;1;69
24;Centre-Val de Loire;36;4;13;217;Sembleçay;99;3;102
24;Centre-Val de Loire;36;2;04;218;Sougé;144;6;150
24;Centre-Val de Loire;36;2;02;219;Tendu;650;7;657
24;Centre-Val de Loire;36;1;12;220;Thenay;893;18;911
24;Centre-Val de Loire;36;3;08;221;Thevet-Saint-Julien;385;8;393
24;Centre-Val de Loire;36;4;08;222;Thizay;233;7;240
24;Centre-Val de Loire;36;1;12;223;Tilly;137;4;141
24;Centre-Val de Loire;36;1;03;224;Tournon-Saint-Martin;1145;25;1170
24;Centre-Val de Loire;36;2;04;225;Le Tranger;178;1;179
24;Centre-Val de Loire;36;3;11;226;Tranzault;352;1;353
24;Centre-Val de Loire;36;3;08;227;Urciers;249;2;251
24;Centre-Val de Loire;36;4;13;229;Val-Fouzon;976;10;986
24;Centre-Val de Loire;36;2;13;228;Valençay;2351;107;2458
24;Centre-Val de Loire;36;4;10;230;Vatan;1956;39;1995
24;Centre-Val de Loire;36;2;02;231;Velles;973;20;993
24;Centre-Val de Loire;36;2;12;232;Vendœuvres;1057;16;1073
24;Centre-Val de Loire;36;2;13;233;La Vernelle;744;8;752
24;Centre-Val de Loire;36;3;08;234;Verneuil-sur-Igneraie;318;6;324
24;Centre-Val de Loire;36;2;13;235;Veuil;377;8;385
24;Centre-Val de Loire;36;3;08;236;Vicq-Exemplet;320;4;324
24;Centre-Val de Loire;36;2;13;237;Vicq-sur-Nahon;722;19;741
24;Centre-Val de Loire;36;3;08;238;Vigoulant;101;3;104
24;Centre-Val de Loire;36;1;12;239;Vigoux;461;6;467
24;Centre-Val de Loire;36;3;08;240;Vijon;301;4;305
24;Centre-Val de Loire;36;2;04;241;Villedieu-sur-Indre;2694;47;2741
24;Centre-Val de Loire;36;2;10;242;Villegongis;110;1;111
24;Centre-Val de Loire;36;2;13;243;Villegouin;325;4;329
24;Centre-Val de Loire;36;2;13;244;Villentrois-Faverolles-en-Berry ;877;6;883
24;Centre-Val de Loire;36;1;03;246;Villiers;169;2;171
24;Centre-Val de Loire;36;2;10;247;Vineuil;1229;22;1251
24;Centre-Val de Loire;36;4;01;248;Vouillon;232;3;235
24;Centre-Val de Loire;37;3;06;001;Abilly;1152;17;1169
24;Centre-Val de Loire;37;1;08;002;Ambillou;1750;29;1779
24;Centre-Val de Loire;37;3;01;003;Amboise;12693;378;13071
24;Centre-Val de Loire;37;1;13;004;Anché;418;11;429
24;Centre-Val de Loire;37;1;13;005;Antogny-le-Tillac;509;5;514
24;Centre-Val de Loire;37;2;11;006;Artannes-sur-Indre;2639;51;2690
24;Centre-Val de Loire;37;1;13;007;Assay;166;4;170
24;Centre-Val de Loire;37;3;03;008;Athée-sur-Cher;2686;39;2725
24;Centre-Val de Loire;37;3;04;009;Autrèche;432;4;436
24;Centre-Val de Loire;37;3;04;010;Auzouer-en-Touraine;2218;70;2288
24;Centre-Val de Loire;37;1;05;011;Avoine;1804;37;1841
24;Centre-Val de Loire;37;1;13;012;Avon-les-Roches;554;3;557
24;Centre-Val de Loire;37;1;08;013;Avrillé-les-Ponceaux;474;10;484
24;Centre-Val de Loire;37;2;05;014;Azay-le-Rideau;3493;99;3592
24;Centre-Val de Loire;37;2;03;015;Azay-sur-Cher;3090;68;3158
24;Centre-Val de Loire;37;3;09;016;Azay-sur-Indre;376;15;391
24;Centre-Val de Loire;37;2;02;018;Ballan-Miré;8052;139;8191
24;Centre-Val de Loire;37;3;06;019;Barrou;464;10;474
24;Centre-Val de Loire;37;3;09;020;Beaulieu-lès-Loches;1764;33;1797
24;Centre-Val de Loire;37;1;05;022;Beaumont-en-Véron;2692;95;2787
24;Centre-Val de Loire;37;1;04;021;Beaumont-Louestault ;1712;18;1730
24;Centre-Val de Loire;37;3;09;023;Beaumont-Village;247;4;251
24;Centre-Val de Loire;37;1;08;024;Benais;911;27;938
24;Centre-Val de Loire;37;2;02;025;Berthenay;700;6;706
24;Centre-Val de Loire;37;3;06;026;Betz-le-Château;554;4;558
24;Centre-Val de Loire;37;3;03;027;Bléré;5250;65;5315
24;Centre-Val de Loire;37;3;06;028;Bossay-sur-Claise;752;23;775
24;Centre-Val de Loire;37;3;06;029;Bossée;329;5;334
24;Centre-Val de Loire;37;3;04;030;Le Boulay;794;7;801
24;Centre-Val de Loire;37;1;08;031;Bourgueil;3906;77;3983
24;Centre-Val de Loire;37;3;06;032;Bournan;272;7;279
24;Centre-Val de Loire;37;3;06;033;Boussay;215;5;220
24;Centre-Val de Loire;37;1;13;034;Braslou;303;7;310
24;Centre-Val de Loire;37;1;13;035;Braye-sous-Faye;296;6;302
24;Centre-Val de Loire;37;1;08;036;Braye-sur-Maulne;181;1;182
24;Centre-Val de Loire;37;1;08;037;Brèches;221;5;226
24;Centre-Val de Loire;37;2;05;038;Bréhémont;759;8;767
24;Centre-Val de Loire;37;3;09;039;Bridoré;505;13;518
24;Centre-Val de Loire;37;1;13;040;Brizay;271;9;280
24;Centre-Val de Loire;37;1;04;041;Bueil-en-Touraine;321;5;326
24;Centre-Val de Loire;37;1;05;042;Candes-Saint-Martin;185;3;188
24;Centre-Val de Loire;37;3;01;043;Cangey;1057;24;1081
24;Centre-Val de Loire;37;3;06;044;La Celle-Guenand;371;5;376
24;Centre-Val de Loire;37;3;06;045;La Celle-Saint-Avant;1069;15;1084
24;Centre-Val de Loire;37;3;03;046;Céré-la-Ronde;448;8;456
24;Centre-Val de Loire;37;1;04;047;Cerelles;1207;26;1233
24;Centre-Val de Loire;37;3;06;048;Chambon;320;5;325
24;Centre-Val de Loire;37;3;09;049;Chambourg-sur-Indre;1257;25;1282
24;Centre-Val de Loire;37;2;10;050;Chambray-lès-Tours;11738;263;12001
24;Centre-Val de Loire;37;1;13;051;Champigny-sur-Veude;839;8;847
24;Centre-Val de Loire;37;3;09;053;Chanceaux-près-Loches;124;7;131
24;Centre-Val de Loire;37;2;19;054;Chanceaux-sur-Choisille;3513;47;3560
24;Centre-Val de Loire;37;1;08;055;Channay-sur-Lathan;827;16;843
24;Centre-Val de Loire;37;2;19;052;Chançay;1140;18;1158
24;Centre-Val de Loire;37;2;05;056;La Chapelle-aux-Naux;570;10;580
24;Centre-Val de Loire;37;3;06;057;La Chapelle-Blanche-Saint-Martin;683;14;697
24;Centre-Val de Loire;37;1;08;058;La Chapelle-sur-Loire;1440;26;1466
24;Centre-Val de Loire;37;1;04;059;Charentilly;1282;30;1312
24;Centre-Val de Loire;37;3;01;060;Chargé;1307;20;1327
24;Centre-Val de Loire;37;3;06;061;Charnizay;501;16;517
24;Centre-Val de Loire;37;1;08;062;Château-la-Vallière;1751;18;1769
24;Centre-Val de Loire;37;3;04;063;Château-Renault;4944;79;5023
24;Centre-Val de Loire;37;3;06;064;Chaumussay;226;7;233
24;Centre-Val de Loire;37;1;13;065;Chaveignes;551;5;556
24;Centre-Val de Loire;37;3;09;066;Chédigny;557;5;562
24;Centre-Val de Loire;37;2;05;067;Cheillé;1799;21;1820
24;Centre-Val de Loire;37;1;04;068;Chemillé-sur-Dême;727;10;737
24;Centre-Val de Loire;37;3;09;069;Chemillé-sur-Indrois;228;8;236
24;Centre-Val de Loire;37;3;03;070;Chenonceaux;350;5;355
24;Centre-Val de Loire;37;1;13;071;Chezelles;134;2;136
24;Centre-Val de Loire;37;1;05;072;Chinon;8145;338;8483
24;Centre-Val de Loire;37;3;03;073;Chisseaux;584;14;598
24;Centre-Val de Loire;37;1;08;074;Chouzé-sur-Loire;2083;24;2107
24;Centre-Val de Loire;37;3;03;075;Cigogné;452;5;457
24;Centre-Val de Loire;37;1;05;076;Cinais;411;11;422
24;Centre-Val de Loire;37;1;08;077;Cinq-Mars-la-Pile;3621;49;3670
24;Centre-Val de Loire;37;3;06;078;Ciran;410;8;418
24;Centre-Val de Loire;37;3;03;079;Civray-de-Touraine;1801;58;1859
24;Centre-Val de Loire;37;3;06;080;Civray-sur-Esves;203;4;207
24;Centre-Val de Loire;37;1;08;081;Cléré-les-Pins;1405;20;1425
24;Centre-Val de Loire;37;1;08;082;Continvoir;437;4;441
24;Centre-Val de Loire;37;3;03;083;Cormery;1784;26;1810
24;Centre-Val de Loire;37;1;08;232;Coteaux-sur-Loire;1913;39;1952
24;Centre-Val de Loire;37;1;08;084;Couesmes;519;6;525
24;Centre-Val de Loire;37;1;08;086;Courcelles-de-Touraine;496;8;504
24;Centre-Val de Loire;37;1;13;087;Courcoué;249;9;258
24;Centre-Val de Loire;37;3;03;085;Courçay;804;23;827
24;Centre-Val de Loire;37;1;05;088;Couziers;111;1;112
24;Centre-Val de Loire;37;1;13;089;Cravant-les-Côteaux;662;18;680
24;Centre-Val de Loire;37;1;13;090;Crissay-sur-Manse;104;2;106
24;Centre-Val de Loire;37;3;03;091;La Croix-en-Touraine;2348;59;2407
24;Centre-Val de Loire;37;3;04;092;Crotelles;678;14;692
24;Centre-Val de Loire;37;1;13;093;Crouzilles;522;6;528
24;Centre-Val de Loire;37;3;06;094;Cussay;565;16;581
24;Centre-Val de Loire;37;3;04;095;Dame-Marie-les-Bois;350;7;357
24;Centre-Val de Loire;37;3;06;115;Descartes;3427;62;3489
24;Centre-Val de Loire;37;3;03;096;Dierre;615;10;625
24;Centre-Val de Loire;37;3;09;097;Dolus-le-Sec;671;23;694
24;Centre-Val de Loire;37;3;06;098;Draché;745;19;764
24;Centre-Val de Loire;37;2;02;099;Druye;940;12;952
24;Centre-Val de Loire;37;3;03;100;Épeigné-les-Bois;410;4;414
24;Centre-Val de Loire;37;1;04;101;Épeigné-sur-Dême;158;2;160
24;Centre-Val de Loire;37;3;06;103;Esves-le-Moutier;144;2;146
24;Centre-Val de Loire;37;2;11;104;Esvres;6057;110;6167
24;Centre-Val de Loire;37;1;13;105;Faye-la-Vineuse;254;6;260
24;Centre-Val de Loire;37;3;04;106;La Ferrière;315;4;319
24;Centre-Val de Loire;37;3;06;107;Ferrière-Larçon;244;5;249
24;Centre-Val de Loire;37;3;09;108;Ferrière-sur-Beaulieu;725;14;739
24;Centre-Val de Loire;37;2;12;109;Fondettes;10357;522;10879
24;Centre-Val de Loire;37;3;03;110;Francueil;1380;34;1414
24;Centre-Val de Loire;37;3;09;111;Genillé;1515;31;1546
24;Centre-Val de Loire;37;1;08;112;Gizeux;381;7;388
24;Centre-Val de Loire;37;3;06;113;Le Grand-Pressigny;896;19;915
24;Centre-Val de Loire;37;3;06;114;La Guerche;177;1;178
24;Centre-Val de Loire;37;3;04;116;Les Hermites;561;16;577
24;Centre-Val de Loire;37;1;08;117;Hommes;881;10;891
24;Centre-Val de Loire;37;1;05;118;Huismes;1440;35;1475
24;Centre-Val de Loire;37;1;13;119;L' Île-Bouchard;1541;38;1579
24;Centre-Val de Loire;37;1;13;121;Jaulnay;255;4;259
24;Centre-Val de Loire;37;2;07;122;Joué-lès-Tours;38250;411;38661
24;Centre-Val de Loire;37;1;08;123;Langeais;4560;66;4626
24;Centre-Val de Loire;37;2;10;124;Larçay;2486;40;2526
24;Centre-Val de Loire;37;1;13;125;Lémeré;523;2;525
24;Centre-Val de Loire;37;1;05;126;Lerné;311;8;319
24;Centre-Val de Loire;37;3;09;127;Le Liège;351;9;360
24;Centre-Val de Loire;37;2;05;128;Lignières-de-Touraine;1287;23;1310
24;Centre-Val de Loire;37;1;13;129;Ligré;1061;21;1082
24;Centre-Val de Loire;37;3;06;130;Ligueil;2159;33;2192
24;Centre-Val de Loire;37;3;01;131;Limeray;1293;22;1315
24;Centre-Val de Loire;37;3;09;133;Loché-sur-Indrois;479;9;488
24;Centre-Val de Loire;37;3;09;132;Loches;6232;546;6778
24;Centre-Val de Loire;37;3;06;134;Louans;663;14;677
24;Centre-Val de Loire;37;3;06;136;Le Louroux;528;3;531
24;Centre-Val de Loire;37;1;08;137;Lublé;143;3;146
24;Centre-Val de Loire;37;3;01;138;Lussault-sur-Loire;815;16;831
24;Centre-Val de Loire;37;2;12;139;Luynes;5099;144;5243
24;Centre-Val de Loire;37;1;13;140;Luzé;245;5;250
24;Centre-Val de Loire;37;3;03;141;Luzillé;974;18;992
24;Centre-Val de Loire;37;1;13;142;Maillé;573;4;577
24;Centre-Val de Loire;37;3;06;143;Manthelan;1348;28;1376
24;Centre-Val de Loire;37;3;06;145;Marcé-sur-Esves;241;1;242
24;Centre-Val de Loire;37;1;08;146;Marcilly-sur-Maulne;225;3;228
24;Centre-Val de Loire;37;1;13;147;Marcilly-sur-Vienne;560;10;570
24;Centre-Val de Loire;37;1;13;148;Marigny-Marmande;599;6;605
24;Centre-Val de Loire;37;1;04;149;Marray;478;7;485
24;Centre-Val de Loire;37;1;05;144;Marçay;520;6;526
24;Centre-Val de Loire;37;1;08;150;Mazières-de-Touraine;1363;12;1375
24;Centre-Val de Loire;37;2;12;151;La Membrolle-sur-Choisille;3312;62;3374
24;Centre-Val de Loire;37;2;19;152;Mettray;2068;71;2139
24;Centre-Val de Loire;37;2;19;153;Monnaie;4473;51;4524
24;Centre-Val de Loire;37;2;11;154;Montbazon;4428;89;4517
24;Centre-Val de Loire;37;3;04;155;Monthodon;634;8;642
24;Centre-Val de Loire;37;2;10;156;Montlouis-sur-Loire;10825;149;10974
24;Centre-Val de Loire;37;3;09;157;Montrésor;332;4;336
24;Centre-Val de Loire;37;3;01;158;Montreuil-en-Touraine;786;11;797
24;Centre-Val de Loire;37;2;11;159;Monts;7835;143;7978
24;Centre-Val de Loire;37;3;04;160;Morand;342;6;348
24;Centre-Val de Loire;37;3;01;161;Mosnes;812;12;824
24;Centre-Val de Loire;37;3;06;162;Mouzay;471;17;488
24;Centre-Val de Loire;37;3;01;163;Nazelles-Négron;3490;56;3546
24;Centre-Val de Loire;37;1;13;165;Neuil;442;5;447
24;Centre-Val de Loire;37;3;01;166;Neuillé-le-Lierre;801;7;808
24;Centre-Val de Loire;37;1;04;167;Neuillé-Pont-Pierre;2022;36;2058
24;Centre-Val de Loire;37;3;06;168;Neuilly-le-Brignon;295;9;304
24;Centre-Val de Loire;37;3;04;169;Neuville-sur-Brenne;913;27;940
24;Centre-Val de Loire;37;1;04;170;Neuvy-le-Roi;1084;57;1141
24;Centre-Val de Loire;37;3;01;171;Noizay;1137;19;1156
24;Centre-Val de Loire;37;2;19;172;Notre-Dame-d'Oé;4165;81;4246
24;Centre-Val de Loire;37;3;09;173;Nouans-les-Fontaines;741;8;749
24;Centre-Val de Loire;37;1;13;174;Nouâtre;818;16;834
24;Centre-Val de Loire;37;3;04;175;Nouzilly;1247;31;1278
24;Centre-Val de Loire;37;1;13;176;Noyant-de-Touraine;1199;55;1254
24;Centre-Val de Loire;37;3;09;177;Orbigny;716;15;731
24;Centre-Val de Loire;37;1;13;178;Panzoult;605;4;609
24;Centre-Val de Loire;37;2;19;179;Parçay-Meslay;2422;31;2453
24;Centre-Val de Loire;37;1;13;180;Parçay-sur-Vienne;643;6;649
24;Centre-Val de Loire;37;3;06;181;Paulmy;233;10;243
24;Centre-Val de Loire;37;1;04;182;Pernay;1364;14;1378
24;Centre-Val de Loire;37;3;09;183;Perrusson;1474;27;1501
24;Centre-Val de Loire;37;3;06;184;Le Petit-Pressigny;338;7;345
24;Centre-Val de Loire;37;3;01;185;Pocé-sur-Cisse;1657;72;1729
24;Centre-Val de Loire;37;2;11;186;Pont-de-Ruan;1202;13;1215
24;Centre-Val de Loire;37;1;13;187;Ports;363;7;370
24;Centre-Val de Loire;37;1;13;188;Pouzay;892;6;898
24;Centre-Val de Loire;37;3;06;189;Preuilly-sur-Claise;1004;21;1025
24;Centre-Val de Loire;37;1;13;190;Pussigny;168;3;171
24;Centre-Val de Loire;37;1;13;191;Razines;234;6;240
24;Centre-Val de Loire;37;3;09;192;Reignac-sur-Indre;1265;18;1283
24;Centre-Val de Loire;37;1;08;193;Restigné;1187;27;1214
24;Centre-Val de Loire;37;2;19;194;Reugny;1708;33;1741
24;Centre-Val de Loire;37;2;02;195;La Riche;10331;81;10412
24;Centre-Val de Loire;37;1;13;196;Richelieu;1678;18;1696
24;Centre-Val de Loire;37;2;05;197;Rigny-Ussé;506;13;519
24;Centre-Val de Loire;37;1;08;198;Rillé;309;2;311
24;Centre-Val de Loire;37;1;13;199;Rilly-sur-Vienne;480;9;489
24;Centre-Val de Loire;37;2;05;200;Rivarennes;996;14;1010
24;Centre-Val de Loire;37;1;05;201;Rivière;709;20;729
24;Centre-Val de Loire;37;1;05;202;La Roche-Clermault;522;11;533
24;Centre-Val de Loire;37;2;19;203;Rochecorbon;3129;90;3219
24;Centre-Val de Loire;37;1;04;204;Rouziers-de-Touraine;1320;22;1342
24;Centre-Val de Loire;37;2;05;205;Saché;1396;16;1412
24;Centre-Val de Loire;37;1;04;206;Saint-Antoine-du-Rocher;1717;36;1753
24;Centre-Val de Loire;37;1;04;207;Saint-Aubin-le-Dépeint;327;2;329
24;Centre-Val de Loire;37;2;14;208;Saint-Avertin;14968;295;15263
24;Centre-Val de Loire;37;1;05;210;Saint-Benoît-la-Forêt;850;17;867
24;Centre-Val de Loire;37;2;11;211;Saint-Branchs;2614;32;2646
24;Centre-Val de Loire;37;1;04;213;Saint-Christophe-sur-le-Nais;1119;24;1143
24;Centre-Val de Loire;37;2;12;214;Saint-Cyr-sur-Loire;15991;406;16397
24;Centre-Val de Loire;37;1;13;216;Saint-Épain;1577;28;1605
24;Centre-Val de Loire;37;2;12;217;Saint-Étienne-de-Chigny;1632;19;1651
24;Centre-Val de Loire;37;3;06;218;Saint-Flovier;569;12;581
24;Centre-Val de Loire;37;2;02;219;Saint-Genouph;1047;17;1064
24;Centre-Val de Loire;37;1;05;220;Saint-Germain-sur-Vienne;369;4;373
24;Centre-Val de Loire;37;3;09;221;Saint-Hippolyte;635;8;643
24;Centre-Val de Loire;37;3;09;222;Saint-Jean-Saint-Germain;760;28;788
24;Centre-Val de Loire;37;1;08;223;Saint-Laurent-de-Lin;321;2;323
24;Centre-Val de Loire;37;3;04;224;Saint-Laurent-en-Gâtines;944;15;959
24;Centre-Val de Loire;37;3;03;225;Saint-Martin-le-Beau;3169;57;3226
24;Centre-Val de Loire;37;1;08;228;Saint-Nicolas-de-Bourgueil;1098;14;1112
24;Centre-Val de Loire;37;3;04;229;Saint-Nicolas-des-Motets;254;8;262
24;Centre-Val de Loire;37;3;01;230;Saint-Ouen-les-Vignes;1003;19;1022
24;Centre-Val de Loire;37;1;04;231;Saint-Paterne-Racan;1657;25;1682
24;Centre-Val de Loire;37;2;14;233;Saint-Pierre-des-Corps;15766;250;16016
24;Centre-Val de Loire;37;3;09;234;Saint-Quentin-sur-Indrois;504;15;519
24;Centre-Val de Loire;37;3;01;236;Saint-Règle;608;11;619
24;Centre-Val de Loire;37;1;04;237;Saint-Roch;1252;18;1270
24;Centre-Val de Loire;37;3;09;238;Saint-Senoch;555;8;563
24;Centre-Val de Loire;37;2;13;212;Sainte-Catherine-de-Fierbois;768;11;779
24;Centre-Val de Loire;37;1;13;226;Sainte-Maure-de-Touraine;4142;51;4193
24;Centre-Val de Loire;37;3;04;240;Saunay;705;14;719
24;Centre-Val de Loire;37;1;08;241;Savigné-sur-Lathan;1347;22;1369
24;Centre-Val de Loire;37;1;05;242;Savigny-en-Véron;1567;32;1599
24;Centre-Val de Loire;37;2;02;243;Savonnières;3153;74;3227
24;Centre-Val de Loire;37;1;13;244;Sazilly;243;4;247
24;Centre-Val de Loire;37;1;04;245;Semblançay;2172;45;2217
24;Centre-Val de Loire;37;3;09;246;Sennevières;208;4;212
24;Centre-Val de Loire;37;3;06;247;Sepmes;623;10;633
24;Centre-Val de Loire;37;1;05;248;Seuilly;367;18;385
24;Centre-Val de Loire;37;1;04;249;Sonzay;1379;20;1399
24;Centre-Val de Loire;37;2;11;250;Sorigny;2683;75;2758
24;Centre-Val de Loire;37;1;08;251;Souvigné;872;11;883
24;Centre-Val de Loire;37;3;01;252;Souvigny-de-Touraine;392;6;398
24;Centre-Val de Loire;37;3;03;253;Sublaines;185;6;191
24;Centre-Val de Loire;37;3;09;254;Tauxigny-Saint-Bauld ;1706;29;1735
24;Centre-Val de Loire;37;1;13;255;Tavant;263;1;264
24;Centre-Val de Loire;37;1;13;256;Theneuil;295;3;298
24;Centre-Val de Loire;37;2;05;257;Thilouze;1753;23;1776
24;Centre-Val de Loire;37;1;05;258;Thizay;281;3;284
24;Centre-Val de Loire;37;1;13;260;La Tour-Saint-Gelin;520;8;528
24;Centre-Val de Loire;37;3;06;259;Tournon-Saint-Pierre;460;10;470
24;Centre-Val de Loire;37;2;99;261;Tours;136463;2767;139230
24;Centre-Val de Loire;37;1;13;262;Trogues;303;4;307
24;Centre-Val de Loire;37;2;11;263;Truyes;2440;39;2479
24;Centre-Val de Loire;37;2;05;264;Vallères;1279;19;1298
24;Centre-Val de Loire;37;3;06;265;Varennes;243;5;248
24;Centre-Val de Loire;37;2;11;266;Veigné;6372;117;6489
24;Centre-Val de Loire;37;2;10;267;Véretz;4551;79;4630
24;Centre-Val de Loire;37;1;13;268;Verneuil-le-Château;127;0;127
24;Centre-Val de Loire;37;3;09;269;Verneuil-sur-Indre;478;21;499
24;Centre-Val de Loire;37;2;19;270;Vernou-sur-Brenne;2710;41;2751
24;Centre-Val de Loire;37;2;05;271;Villaines-les-Rochers;1058;9;1067
24;Centre-Val de Loire;37;2;02;272;Villandry;1124;37;1161
24;Centre-Val de Loire;37;2;10;273;La Ville-aux-Dames;5542;71;5613
24;Centre-Val de Loire;37;1;04;274;Villebourg;298;3;301
24;Centre-Val de Loire;37;3;09;275;Villedômain;117;2;119
24;Centre-Val de Loire;37;3;04;276;Villedômer;1334;31;1365
24;Centre-Val de Loire;37;3;09;277;Villeloin-Coulangé;594;3;597
24;Centre-Val de Loire;37;2;11;278;Villeperdue;1049;7;1056
24;Centre-Val de Loire;37;1;08;279;Villiers-au-Bouin;755;7;762
24;Centre-Val de Loire;37;3;06;280;Vou;212;5;217
24;Centre-Val de Loire;37;2;19;281;Vouvray;3246;70;3316
24;Centre-Val de Loire;37;3;06;282;Yzeures-sur-Creuse;1370;27;1397
84;Auvergne-Rhône-Alpes;38;2;03;001;Les Abrets en Dauphiné;6336;105;6441
84;Auvergne-Rhône-Alpes;38;1;13;002;Les Adrets;1025;29;1054
84;Auvergne-Rhône-Alpes;38;3;21;003;Agnin;1127;21;1148
84;Auvergne-Rhône-Alpes;38;1;23;004;L' Albenc;1279;25;1304
84;Auvergne-Rhône-Alpes;38;1;19;005;Allemond;954;18;972
84;Auvergne-Rhône-Alpes;38;1;13;006;Allevard;4062;106;4168
84;Auvergne-Rhône-Alpes;38;1;15;008;Ambel;28;0;28
84;Auvergne-Rhône-Alpes;38;3;21;009;Anjou;1009;23;1032
84;Auvergne-Rhône-Alpes;38;2;04;010;Annoisin-Chatelans;686;18;704
84;Auvergne-Rhône-Alpes;38;2;04;011;Anthon;1073;13;1086
84;Auvergne-Rhône-Alpes;38;2;03;012;Aoste;2880;54;2934
84;Auvergne-Rhône-Alpes;38;2;08;013;Apprieu;3347;90;3437
84;Auvergne-Rhône-Alpes;38;2;17;297;Arandon-Passins;1828;42;1870
84;Auvergne-Rhône-Alpes;38;3;26;015;Artas;1804;38;1842
84;Auvergne-Rhône-Alpes;38;3;28;017;Assieu;1529;35;1564
84;Auvergne-Rhône-Alpes;38;1;23;018;Auberives-en-Royans;369;10;379
84;Auvergne-Rhône-Alpes;38;3;28;019;Auberives-sur-Varèze;1482;29;1511
84;Auvergne-Rhône-Alpes;38;1;19;020;Auris;185;4;189
84;Auvergne-Rhône-Alpes;38;1;07;225;Autrans-Méaudre en Vercors;3030;103;3133
84;Auvergne-Rhône-Alpes;38;2;17;022;Les Avenières Veyrins-Thuellin;7772;158;7930
84;Auvergne-Rhône-Alpes;38;1;15;023;Avignonet;197;5;202
84;Auvergne-Rhône-Alpes;38;2;17;026;La Balme-les-Grottes;1068;12;1080
84;Auvergne-Rhône-Alpes;38;1;13;027;Barraux;1918;56;1974
84;Auvergne-Rhône-Alpes;38;2;24;029;La Bâtie-Montgascon;1932;41;1973
84;Auvergne-Rhône-Alpes;38;1;25;030;Beaucroissant;1713;30;1743
84;Auvergne-Rhône-Alpes;38;1;15;031;Beaufin;20;0;20
84;Auvergne-Rhône-Alpes;38;3;01;032;Beaufort;561;11;572
84;Auvergne-Rhône-Alpes;38;1;23;033;Beaulieu;636;18;654
84;Auvergne-Rhône-Alpes;38;3;21;034;Beaurepaire;4953;83;5036
84;Auvergne-Rhône-Alpes;38;3;01;035;Beauvoir-de-Marc;1111;15;1126
84;Auvergne-Rhône-Alpes;38;1;23;036;Beauvoir-en-Royans;93;2;95
84;Auvergne-Rhône-Alpes;38;3;21;037;Bellegarde-Poussieu;990;14;1004
84;Auvergne-Rhône-Alpes;38;2;08;038;Belmont;598;14;612
84;Auvergne-Rhône-Alpes;38;1;18;039;Bernin;3044;104;3148
84;Auvergne-Rhône-Alpes;38;1;19;040;Besse;133;1;134
84;Auvergne-Rhône-Alpes;38;1;23;041;Bessins;113;3;116
84;Auvergne-Rhône-Alpes;38;2;08;042;Bévenais;1015;20;1035
84;Auvergne-Rhône-Alpes;38;2;08;043;Bilieu;1560;43;1603
84;Auvergne-Rhône-Alpes;38;2;08;044;Biol;1436;41;1477
84;Auvergne-Rhône-Alpes;38;1;16;045;Biviers;2359;96;2455
84;Auvergne-Rhône-Alpes;38;2;08;046;Bizonnes;977;14;991
84;Auvergne-Rhône-Alpes;38;2;08;047;Blandin;148;3;151
84;Auvergne-Rhône-Alpes;38;2;26;048;Bonnefamille;1084;18;1102
84;Auvergne-Rhône-Alpes;38;3;01;049;Bossieu;299;7;306
84;Auvergne-Rhône-Alpes;38;2;17;050;Le Bouchage;626;9;635
84;Auvergne-Rhône-Alpes;38;3;21;051;Bougé-Chambalud;1363;21;1384
84;Auvergne-Rhône-Alpes;38;1;19;052;Le Bourg-d'Oisans;3267;102;3369
84;Auvergne-Rhône-Alpes;38;2;02;053;Bourgoin-Jallieu;28494;602;29096
84;Auvergne-Rhône-Alpes;38;2;17;054;Bouvesse-Quirieu;1523;21;1544
84;Auvergne-Rhône-Alpes;38;2;17;055;Brangues;629;8;637
84;Auvergne-Rhône-Alpes;38;3;01;056;Bressieux;93;2;95
84;Auvergne-Rhône-Alpes;38;1;05;057;Bresson;677;12;689
84;Auvergne-Rhône-Alpes;38;3;01;058;Brézins;2161;36;2197
84;Auvergne-Rhône-Alpes;38;1;20;059;Brié-et-Angonnes;2554;42;2596
84;Auvergne-Rhône-Alpes;38;3;01;060;Brion;142;5;147
84;Auvergne-Rhône-Alpes;38;1;29;061;La Buisse;3189;68;3257
84;Auvergne-Rhône-Alpes;38;1;13;062;La Buissière;700;12;712
84;Auvergne-Rhône-Alpes;38;2;08;063;Burcin;431;14;445
84;Auvergne-Rhône-Alpes;38;2;24;064;Cessieu;3053;69;3122
84;Auvergne-Rhône-Alpes;38;2;08;065;Châbons;2065;49;2114
84;Auvergne-Rhône-Alpes;38;3;21;066;Chalon;177;4;181
84;Auvergne-Rhône-Alpes;38;2;26;067;Chamagnieu;1697;38;1735
84;Auvergne-Rhône-Alpes;38;1;13;070;Le Champ-près-Froges;1186;14;1200
84;Auvergne-Rhône-Alpes;38;1;20;071;Champ-sur-Drac;3090;31;3121
84;Auvergne-Rhône-Alpes;38;1;20;068;Champagnier;1214;30;1244
84;Auvergne-Rhône-Alpes;38;3;01;069;Champier;1419;23;1442
84;Auvergne-Rhône-Alpes;38;1;19;567;Chamrousse;403;5;408
84;Auvergne-Rhône-Alpes;38;3;21;072;Chanas;2711;41;2752
84;Auvergne-Rhône-Alpes;38;1;15;073;Chantepérier ;199;3;202
84;Auvergne-Rhône-Alpes;38;1;23;074;Chantesse;348;6;354
84;Auvergne-Rhône-Alpes;38;1;13;075;Chapareillan;2997;108;3105
84;Auvergne-Rhône-Alpes;38;2;24;076;La Chapelle-de-la-Tour;1846;66;1912
84;Auvergne-Rhône-Alpes;38;3;21;077;La Chapelle-de-Surieu;751;16;767
84;Auvergne-Rhône-Alpes;38;1;13;078;La Chapelle-du-Bard;577;6;583
84;Auvergne-Rhône-Alpes;38;2;03;080;Charancieu;769;20;789
84;Auvergne-Rhône-Alpes;38;3;26;081;Charantonnay;1940;44;1984
84;Auvergne-Rhône-Alpes;38;2;08;082;Charavines;1914;46;1960
84;Auvergne-Rhône-Alpes;38;2;17;083;Charette;454;15;469
84;Auvergne-Rhône-Alpes;38;1;25;084;Charnècles;1405;26;1431
84;Auvergne-Rhône-Alpes;38;2;04;085;Charvieu-Chavagneux;10029;84;10113
84;Auvergne-Rhône-Alpes;38;3;27;087;Chasse-sur-Rhône;6128;56;6184
84;Auvergne-Rhône-Alpes;38;1;23;086;Chasselay;405;8;413
84;Auvergne-Rhône-Alpes;38;2;08;089;Chassignieu;228;5;233
84;Auvergne-Rhône-Alpes;38;1;15;090;Château-Bernard;268;5;273
84;Auvergne-Rhône-Alpes;38;2;02;091;Châteauvilain;748;13;761
84;Auvergne-Rhône-Alpes;38;1;15;456;Châtel-en-Trièves;463;9;472
84;Auvergne-Rhône-Alpes;38;1;23;092;Châtelus;90;3;93
84;Auvergne-Rhône-Alpes;38;3;01;093;Châtenay;443;7;450
84;Auvergne-Rhône-Alpes;38;3;01;094;Châtonnay;2046;43;2089
84;Auvergne-Rhône-Alpes;38;1;23;095;Chatte;2500;175;2675
84;Auvergne-Rhône-Alpes;38;2;04;097;Chavanoz;4777;63;4840
84;Auvergne-Rhône-Alpes;38;2;08;098;Chélieu;694;17;711
84;Auvergne-Rhône-Alpes;38;1;23;099;Chevrières;717;22;739
84;Auvergne-Rhône-Alpes;38;1;13;100;Le Cheylas;2555;43;2598
84;Auvergne-Rhône-Alpes;38;3;28;101;Cheyssieu;1024;16;1040
84;Auvergne-Rhône-Alpes;38;2;14;102;Chèzeneuve;611;20;631
84;Auvergne-Rhône-Alpes;38;1;15;103;Chichilianne;307;2;309
84;Auvergne-Rhône-Alpes;38;2;03;104;Chimilin;1432;32;1464
84;Auvergne-Rhône-Alpes;38;1;08;105;Chirens;2352;45;2397
84;Auvergne-Rhône-Alpes;38;1;15;106;Cholonge;337;9;346
84;Auvergne-Rhône-Alpes;38;3;28;107;Chonas-l'Amballan;1672;51;1723
84;Auvergne-Rhône-Alpes;38;1;23;108;Choranche;121;0;121
84;Auvergne-Rhône-Alpes;38;2;04;109;Chozeau;1052;26;1078
84;Auvergne-Rhône-Alpes;38;3;27;110;Chuzelles;2221;43;2264
84;Auvergne-Rhône-Alpes;38;1;06;111;Claix;7921;217;8138
84;Auvergne-Rhône-Alpes;38;1;19;112;Clavans-en-Haut-Oisans;100;1;101
84;Auvergne-Rhône-Alpes;38;1;15;113;Clelles;541;6;547
84;Auvergne-Rhône-Alpes;38;3;28;114;Clonas-sur-Varèze;1453;33;1486
84;Auvergne-Rhône-Alpes;38;1;15;116;Cognet;41;0;41
84;Auvergne-Rhône-Alpes;38;1;23;117;Cognin-les-Gorges;633;14;647
84;Auvergne-Rhône-Alpes;38;2;08;118;Colombe;1596;43;1639
84;Auvergne-Rhône-Alpes;38;1;18;120;La Combe-de-Lancey;705;17;722
84;Auvergne-Rhône-Alpes;38;2;17;124;Corbelin;2210;46;2256
84;Auvergne-Rhône-Alpes;38;1;16;126;Corenc;4053;129;4182
84;Auvergne-Rhône-Alpes;38;1;15;127;Cornillon-en-Trièves;166;5;171
84;Auvergne-Rhône-Alpes;38;1;15;128;Corps;470;5;475
84;Auvergne-Rhône-Alpes;38;1;07;129;Corrençon-en-Vercors;357;17;374
84;Auvergne-Rhône-Alpes;38;3;01;130;La Côte-Saint-André;4820;281;5101
84;Auvergne-Rhône-Alpes;38;3;28;131;Les Côtes-d'Arey;2023;74;2097
84;Auvergne-Rhône-Alpes;38;1;15;132;Les Côtes-de-Corps;71;0;71
84;Auvergne-Rhône-Alpes;38;1;29;133;Coublevie;5026;397;5423
84;Auvergne-Rhône-Alpes;38;3;21;134;Cour-et-Buis;906;19;925
84;Auvergne-Rhône-Alpes;38;2;17;135;Courtenay;1275;21;1296
84;Auvergne-Rhône-Alpes;38;2;14;136;Crachier;525;16;541
84;Auvergne-Rhône-Alpes;38;1;23;137;Cras;433;13;446
84;Auvergne-Rhône-Alpes;38;2;04;138;Crémieu;3311;63;3374
84;Auvergne-Rhône-Alpes;38;1;13;439;Crêts en Belledonne;3299;53;3352
84;Auvergne-Rhône-Alpes;38;2;17;139;Creys-Mépieu;1499;19;1518
84;Auvergne-Rhône-Alpes;38;1;18;140;Crolles;8260;253;8513
84;Auvergne-Rhône-Alpes;38;3;14;141;Culin;752;15;767
84;Auvergne-Rhône-Alpes;38;1;19;253;Les Deux Alpes;1916;36;1952
84;Auvergne-Rhône-Alpes;38;3;26;144;Diémoz;2748;36;2784
84;Auvergne-Rhône-Alpes;38;2;04;146;Dizimieu;832;26;858
84;Auvergne-Rhône-Alpes;38;2;08;147;Doissin;875;25;900
84;Auvergne-Rhône-Alpes;38;2;24;148;Dolomieu;3176;71;3247
84;Auvergne-Rhône-Alpes;38;2;02;149;Domarin;1674;36;1710
84;Auvergne-Rhône-Alpes;38;1;16;150;Domène;6701;70;6771
84;Auvergne-Rhône-Alpes;38;1;05;151;Échirolles;36961;203;37164
84;Auvergne-Rhône-Alpes;38;2;02;152;Eclose-Badinières;1438;29;1467
84;Auvergne-Rhône-Alpes;38;1;07;153;Engins;457;21;478
84;Auvergne-Rhône-Alpes;38;1;15;154;Entraigues;226;2;228
84;Auvergne-Rhône-Alpes;38;1;03;155;Entre-deux-Guiers;1817;29;1846
84;Auvergne-Rhône-Alpes;38;2;02;156;Les Éparres;979;32;1011
84;Auvergne-Rhône-Alpes;38;3;28;157;Estrablin;3450;72;3522
84;Auvergne-Rhône-Alpes;38;1;05;158;Eybens;9947;119;10066
84;Auvergne-Rhône-Alpes;38;2;08;159;Eydoche;536;13;549
84;Auvergne-Rhône-Alpes;38;3;28;160;Eyzin-Pinet;2272;115;2387
84;Auvergne-Rhône-Alpes;38;3;01;161;Faramans;1041;6;1047
84;Auvergne-Rhône-Alpes;38;2;24;162;Faverges-de-la-Tour;1461;40;1501
84;Auvergne-Rhône-Alpes;38;1;13;166;La Flachère;478;11;489
84;Auvergne-Rhône-Alpes;38;2;08;167;Flachères;532;5;537
84;Auvergne-Rhône-Alpes;38;1;97;169;Fontaine;22906;233;23139
84;Auvergne-Rhône-Alpes;38;1;10;170;Fontanil-Cornillon;2940;33;2973
84;Auvergne-Rhône-Alpes;38;3;01;171;La Forteresse;328;4;332
84;Auvergne-Rhône-Alpes;38;2;14;172;Four;1582;32;1614
84;Auvergne-Rhône-Alpes;38;1;19;173;Le Freney-d'Oisans;249;7;256
84;Auvergne-Rhône-Alpes;38;3;01;174;La Frette;1091;23;1114
84;Auvergne-Rhône-Alpes;38;1;13;175;Froges;3361;59;3420
84;Auvergne-Rhône-Alpes;38;2;26;176;Frontonas;2091;55;2146
84;Auvergne-Rhône-Alpes;38;1;19;177;La Garde;101;0;101
84;Auvergne-Rhône-Alpes;38;1;22;179;Gières;6956;84;7040
84;Auvergne-Rhône-Alpes;38;3;01;180;Gillonnay;1012;38;1050
84;Auvergne-Rhône-Alpes;38;1;13;181;Goncelin;2470;36;2506
84;Auvergne-Rhône-Alpes;38;2;08;182;Le Grand-Lemps;3085;57;3142
84;Auvergne-Rhône-Alpes;38;2;03;183;Granieu;500;9;509
84;Auvergne-Rhône-Alpes;38;3;26;184;Grenay;1596;20;1616
84;Auvergne-Rhône-Alpes;38;1;98;185;Grenoble;157650;2205;159855
84;Auvergne-Rhône-Alpes;38;1;15;186;Gresse-en-Vercors;386;13;399
84;Auvergne-Rhône-Alpes;38;1;20;187;Le Gua;1793;25;1818
84;Auvergne-Rhône-Alpes;38;1;13;163;Haut-Bréda ;393;10;403
84;Auvergne-Rhône-Alpes;38;1;20;188;Herbeys;1361;23;1384
84;Auvergne-Rhône-Alpes;38;3;26;189;Heyrieux;4767;64;4831
84;Auvergne-Rhône-Alpes;38;2;04;190;Hières-sur-Amby;1166;28;1194
84;Auvergne-Rhône-Alpes;38;1;19;191;Huez;1303;34;1337
84;Auvergne-Rhône-Alpes;38;1;13;192;Hurtières;181;6;187
84;Auvergne-Rhône-Alpes;38;2;14;193;L' Isle-d'Abeau;16169;308;16477
84;Auvergne-Rhône-Alpes;38;1;08;194;Izeaux;2139;35;2174
84;Auvergne-Rhône-Alpes;38;1;23;195;Izeron;739;9;748
84;Auvergne-Rhône-Alpes;38;2;04;197;Janneyrias;1818;20;1838
84;Auvergne-Rhône-Alpes;38;3;21;198;Jarcieu;1048;22;1070
84;Auvergne-Rhône-Alpes;38;3;28;199;Jardin;2181;56;2237
84;Auvergne-Rhône-Alpes;38;1;20;200;Jarrie;3763;69;3832
84;Auvergne-Rhône-Alpes;38;1;15;203;Laffrey;457;8;465
84;Auvergne-Rhône-Alpes;38;1;15;204;Lalley;193;5;198
84;Auvergne-Rhône-Alpes;38;1;07;205;Lans-en-Vercors;2664;121;2785
84;Auvergne-Rhône-Alpes;38;1;18;206;Laval;982;36;1018
84;Auvergne-Rhône-Alpes;38;1;15;207;Lavaldens;151;3;154
84;Auvergne-Rhône-Alpes;38;1;15;208;Lavars;149;3;152
84;Auvergne-Rhône-Alpes;38;3;01;209;Lentiol;229;7;236
84;Auvergne-Rhône-Alpes;38;2;04;210;Leyrieu;857;14;871
84;Auvergne-Rhône-Alpes;38;3;01;211;Lieudieu;347;5;352
84;Auvergne-Rhône-Alpes;38;1;19;212;Livet-et-Gavet;1300;8;1308
84;Auvergne-Rhône-Alpes;38;3;08;213;Longechenal;577;12;589
84;Auvergne-Rhône-Alpes;38;1;18;214;Lumbin;2151;72;2223
84;Auvergne-Rhône-Alpes;38;3;27;215;Luzinay;2333;44;2377
84;Auvergne-Rhône-Alpes;38;1;23;216;Malleval-en-Vercors;54;2;56
84;Auvergne-Rhône-Alpes;38;1;15;217;Marcieu;72;2;74
84;Auvergne-Rhône-Alpes;38;3;01;218;Marcilloles;1140;20;1160
84;Auvergne-Rhône-Alpes;38;3;01;219;Marcollin;658;16;674
84;Auvergne-Rhône-Alpes;38;3;01;221;Marnans;144;3;147
84;Auvergne-Rhône-Alpes;38;2;08;222;Massieu;752;17;769
84;Auvergne-Rhône-Alpes;38;2;14;223;Maubec;1765;62;1827
84;Auvergne-Rhône-Alpes;38;1;15;224;Mayres-Savel;94;3;97
84;Auvergne-Rhône-Alpes;38;1;15;226;Mens;1397;75;1472
84;Auvergne-Rhône-Alpes;38;2;03;228;Merlas;483;18;501
84;Auvergne-Rhône-Alpes;38;1;16;229;Meylan;17448;390;17838
84;Auvergne-Rhône-Alpes;38;2;02;230;Meyrié;1024;42;1066
84;Auvergne-Rhône-Alpes;38;3;14;231;Meyrieu-les-Étangs;1023;33;1056
84;Auvergne-Rhône-Alpes;38;3;01;232;Meyssiez;638;12;650
84;Auvergne-Rhône-Alpes;38;1;15;235;Miribel-Lanchâtre;445;8;453
84;Auvergne-Rhône-Alpes;38;1;03;236;Miribel-les-Échelles;1721;38;1759
84;Auvergne-Rhône-Alpes;38;1;19;237;Mizoën;191;4;195
84;Auvergne-Rhône-Alpes;38;3;27;238;Moidieu-Détourbe;1914;42;1956
84;Auvergne-Rhône-Alpes;38;1;25;239;Moirans;7675;159;7834
84;Auvergne-Rhône-Alpes;38;3;21;240;Moissieu-sur-Dolon;723;15;738
84;Auvergne-Rhône-Alpes;38;1;15;241;Monestier-d'Ambel;18;0;18
84;Auvergne-Rhône-Alpes;38;1;15;242;Monestier-de-Clermont;1428;31;1459
84;Auvergne-Rhône-Alpes;38;1;15;243;Le Monestier-du-Percy;252;6;258
84;Auvergne-Rhône-Alpes;38;3;21;244;Monsteroux-Milieu;796;19;815
84;Auvergne-Rhône-Alpes;38;1;10;258;Mont-Saint-Martin;77;4;81
84;Auvergne-Rhône-Alpes;38;1;23;245;Montagne;267;4;271
84;Auvergne-Rhône-Alpes;38;2;24;246;Montagnieu;1094;16;1110
84;Auvergne-Rhône-Alpes;38;2;17;247;Montalieu-Vercieu;3417;55;3472
84;Auvergne-Rhône-Alpes;38;1;25;248;Montaud;533;21;554
84;Auvergne-Rhône-Alpes;38;1;16;249;Montbonnot-Saint-Martin;5306;560;5866
84;Auvergne-Rhône-Alpes;38;2;24;250;Montcarra;551;17;568
84;Auvergne-Rhône-Alpes;38;1;19;252;Montchaboud;337;9;346
84;Auvergne-Rhône-Alpes;38;1;15;254;Monteynard;493;12;505
84;Auvergne-Rhône-Alpes;38;3;01;255;Montfalcon;134;0;134
84;Auvergne-Rhône-Alpes;38;2;08;256;Montferrat;1810;23;1833
84;Auvergne-Rhône-Alpes;38;2;08;257;Montrevel;446;12;458
84;Auvergne-Rhône-Alpes;38;3;21;259;Montseveroux;964;16;980
84;Auvergne-Rhône-Alpes;38;2;04;260;Moras;515;18;533
84;Auvergne-Rhône-Alpes;38;2;17;261;Morestel;4472;98;4570
84;Auvergne-Rhône-Alpes;38;1;23;263;Morette;410;5;415
84;Auvergne-Rhône-Alpes;38;1;19;264;La Morte;134;0;134
84;Auvergne-Rhône-Alpes;38;1;15;265;La Motte-d'Aveillans;1701;21;1722
84;Auvergne-Rhône-Alpes;38;1;15;266;La Motte-Saint-Martin;449;9;458
84;Auvergne-Rhône-Alpes;38;3;01;267;Mottier;742;13;755
84;Auvergne-Rhône-Alpes;38;1;13;268;Le Moutaret;261;3;264
84;Auvergne-Rhône-Alpes;38;1;15;269;La Mure;4930;208;5138
84;Auvergne-Rhône-Alpes;38;1;29;270;La Murette;1860;65;1925
84;Auvergne-Rhône-Alpes;38;1;16;271;Murianette;872;11;883
84;Auvergne-Rhône-Alpes;38;1;23;272;Murinais;401;7;408
84;Auvergne-Rhône-Alpes;38;1;15;273;Nantes-en-Ratier;466;19;485
84;Auvergne-Rhône-Alpes;38;2;02;276;Nivolas-Vermelle;2649;69;2718
84;Auvergne-Rhône-Alpes;38;1;20;277;Notre-Dame-de-Commiers;520;6;526
84;Auvergne-Rhône-Alpes;38;1;23;278;Notre-Dame-de-l'Osier;497;9;506
84;Auvergne-Rhône-Alpes;38;1;19;279;Notre-Dame-de-Mésage;1131;12;1143
84;Auvergne-Rhône-Alpes;38;1;15;280;Notre-Dame-de-Vaulx;515;21;536
84;Auvergne-Rhône-Alpes;38;1;07;281;Noyarey;2216;76;2292
84;Auvergne-Rhône-Alpes;38;2;17;282;Optevoz;858;27;885
84;Auvergne-Rhône-Alpes;38;1;15;283;Oris-en-Rattier;112;3;115
84;Auvergne-Rhône-Alpes;38;3;01;284;Ornacieux-Balbins ;846;27;873
84;Auvergne-Rhône-Alpes;38;1;19;285;Ornon;161;4;165
84;Auvergne-Rhône-Alpes;38;1;19;286;Oulles;6;0;6
84;Auvergne-Rhône-Alpes;38;2;08;287;Oyeu;1033;19;1052
84;Auvergne-Rhône-Alpes;38;3;26;288;Oytier-Saint-Oblas;1653;31;1684
84;Auvergne-Rhône-Alpes;38;1;19;289;Oz;224;4;228
84;Auvergne-Rhône-Alpes;38;3;21;290;Pact;852;15;867
84;Auvergne-Rhône-Alpes;38;3;01;291;Pajay;1147;17;1164
84;Auvergne-Rhône-Alpes;38;2;04;294;Panossas;662;16;678
84;Auvergne-Rhône-Alpes;38;2;17;295;Parmilieu;709;12;721
84;Auvergne-Rhône-Alpes;38;2;24;296;Le Passage;833;35;868
84;Auvergne-Rhône-Alpes;38;3;21;298;Le Péage-de-Roussillon;6588;60;6648
84;Auvergne-Rhône-Alpes;38;1;15;299;Pellafol;137;2;139
84;Auvergne-Rhône-Alpes;38;3;01;300;Penol;356;9;365
84;Auvergne-Rhône-Alpes;38;1;15;301;Percy;172;4;176
84;Auvergne-Rhône-Alpes;38;1;13;303;La Pierre;570;5;575
84;Auvergne-Rhône-Alpes;38;1;15;304;Pierre-Châtel;1496;37;1533
84;Auvergne-Rhône-Alpes;38;3;21;307;Pisieu;525;9;534
84;Auvergne-Rhône-Alpes;38;3;01;308;Plan;263;2;265
84;Auvergne-Rhône-Alpes;38;1;18;395;Plateau-des-Petites-Roches ;2408;74;2482
84;Auvergne-Rhône-Alpes;38;1;22;309;Poisat;2147;27;2174
84;Auvergne-Rhône-Alpes;38;1;25;310;Poliénas;1200;16;1216
84;Auvergne-Rhône-Alpes;38;3;21;311;Pommier-de-Beaurepaire;705;15;720
84;Auvergne-Rhône-Alpes;38;1;15;313;Ponsonnas;293;15;308
84;Auvergne-Rhône-Alpes;38;2;03;315;Le Pont-de-Beauvoisin;3582;142;3724
84;Auvergne-Rhône-Alpes;38;2;04;316;Pont-de-Chéruy;5876;43;5919
84;Auvergne-Rhône-Alpes;38;1;20;317;Le Pont-de-Claix;10605;75;10680
84;Auvergne-Rhône-Alpes;38;1;23;319;Pont-en-Royans;779;31;810
84;Auvergne-Rhône-Alpes;38;3;27;318;Pont-Évêque;5207;49;5256
84;Auvergne-Rhône-Alpes;38;1;13;314;Pontcharra;7376;171;7547
84;Auvergne-Rhône-Alpes;38;2;17;320;Porcieu-Amblagnieu;1776;40;1816
84;Auvergne-Rhône-Alpes;38;3;01;479;Porte-des-Bonnevaux ;2008;52;2060
84;Auvergne-Rhône-Alpes;38;1;15;321;Prébois;164;8;172
84;Auvergne-Rhône-Alpes;38;1;23;322;Presles;90;2;92
84;Auvergne-Rhône-Alpes;38;2;03;323;Pressins;1155;22;1177
84;Auvergne-Rhône-Alpes;38;3;21;324;Primarette;717;18;735
84;Auvergne-Rhône-Alpes;38;1;10;325;Proveysieux;509;9;518
84;Auvergne-Rhône-Alpes;38;1;15;326;Prunières;361;12;373
84;Auvergne-Rhône-Alpes;38;1;10;328;Quaix-en-Chartreuse;887;32;919
84;Auvergne-Rhône-Alpes;38;1;15;329;Quet-en-Beaumont;68;0;68
84;Auvergne-Rhône-Alpes;38;1;23;330;Quincieu;101;1;102
84;Auvergne-Rhône-Alpes;38;1;25;331;Réaumont;1010;31;1041
84;Auvergne-Rhône-Alpes;38;1;25;332;Renage;3487;51;3538
84;Auvergne-Rhône-Alpes;38;1;23;333;Rencurel;323;6;329
84;Auvergne-Rhône-Alpes;38;1;18;334;Revel;1313;43;1356
84;Auvergne-Rhône-Alpes;38;3;21;335;Revel-Tourdan;1052;26;1078
84;Auvergne-Rhône-Alpes;38;3;28;336;Reventin-Vaugris;1941;35;1976
84;Auvergne-Rhône-Alpes;38;1;25;337;Rives;6606;82;6688
84;Auvergne-Rhône-Alpes;38;1;23;338;La Rivière;741;9;750
84;Auvergne-Rhône-Alpes;38;2;26;339;Roche;2105;56;2161
84;Auvergne-Rhône-Alpes;38;3;28;340;Les Roches-de-Condrieu;1915;36;1951
84;Auvergne-Rhône-Alpes;38;2;24;341;Rochetoirin;1104;40;1144
84;Auvergne-Rhône-Alpes;38;1;15;342;Roissard;311;7;318
84;Auvergne-Rhône-Alpes;38;2;03;343;Romagnieu;1566;31;1597
84;Auvergne-Rhône-Alpes;38;3;21;344;Roussillon;8453;119;8572
84;Auvergne-Rhône-Alpes;38;1;23;345;Rovon;609;10;619
84;Auvergne-Rhône-Alpes;38;3;01;346;Royas;398;7;405
84;Auvergne-Rhône-Alpes;38;3;01;347;Roybon;1150;27;1177
84;Auvergne-Rhône-Alpes;38;2;02;348;Ruy-Montceau;4606;106;4712
84;Auvergne-Rhône-Alpes;38;3;21;349;Sablons;2297;22;2319
84;Auvergne-Rhône-Alpes;38;3;14;351;Saint-Agnin-sur-Bion;1076;22;1098
84;Auvergne-Rhône-Alpes;38;2;14;352;Saint-Alban-de-Roche;2056;59;2115
84;Auvergne-Rhône-Alpes;38;3;28;353;Saint-Alban-du-Rhône;836;18;854
84;Auvergne-Rhône-Alpes;38;2;03;354;Saint-Albin-de-Vaulserre;403;5;408
84;Auvergne-Rhône-Alpes;38;1;15;355;Saint-Andéol;122;6;128
84;Auvergne-Rhône-Alpes;38;1;23;356;Saint-André-en-Royans;312;18;330
84;Auvergne-Rhône-Alpes;38;2;24;357;Saint-André-le-Gaz;2777;147;2924
84;Auvergne-Rhône-Alpes;38;1;23;359;Saint Antoine l'Abbaye ;1164;28;1192
84;Auvergne-Rhône-Alpes;38;1;23;360;Saint-Appolinard;409;8;417
84;Auvergne-Rhône-Alpes;38;1;15;361;Saint-Arey;81;3;84
84;Auvergne-Rhône-Alpes;38;1;29;362;Saint-Aupre;1147;53;1200
84;Auvergne-Rhône-Alpes;38;3;21;363;Saint-Barthélemy;930;38;968
84;Auvergne-Rhône-Alpes;38;1;19;364;Saint-Barthélemy-de-Séchilienne;432;4;436
84;Auvergne-Rhône-Alpes;38;2;04;365;Saint-Baudille-de-la-Tour;817;19;836
84;Auvergne-Rhône-Alpes;38;1;15;366;Saint-Baudille-et-Pipet;259;8;267
84;Auvergne-Rhône-Alpes;38;1;25;368;Saint-Blaise-du-Buis;1071;25;1096
84;Auvergne-Rhône-Alpes;38;1;23;370;Saint-Bonnet-de-Chavagne;644;18;662
84;Auvergne-Rhône-Alpes;38;2;03;372;Saint-Bueil;723;10;733
84;Auvergne-Rhône-Alpes;38;1;29;373;Saint-Cassien;1156;42;1198
84;Auvergne-Rhône-Alpes;38;2;02;374;Saint-Chef;3637;106;3743
84;Auvergne-Rhône-Alpes;38;1;19;375;Saint-Christophe-en-Oisans;107;0;107
84;Auvergne-Rhône-Alpes;38;1;03;376;Saint-Christophe-sur-Guiers;831;9;840
84;Auvergne-Rhône-Alpes;38;2;24;377;Saint-Clair-de-la-Tour;3454;59;3513
84;Auvergne-Rhône-Alpes;38;3;28;378;Saint-Clair-du-Rhône;3761;87;3848
84;Auvergne-Rhône-Alpes;38;3;01;379;Saint-Clair-sur-Galaure;276;8;284
84;Auvergne-Rhône-Alpes;38;2;08;380;Saint-Didier-de-Bizonnes;305;5;310
84;Auvergne-Rhône-Alpes;38;2;24;381;Saint-Didier-de-la-Tour;2072;53;2125
84;Auvergne-Rhône-Alpes;38;1;10;382;Saint-Égrève;15801;217;16018
84;Auvergne-Rhône-Alpes;38;1;29;383;Saint-Étienne-de-Crossey;2581;106;2687
84;Auvergne-Rhône-Alpes;38;3;01;384;Saint-Étienne-de-Saint-Geoirs;3226;44;3270
84;Auvergne-Rhône-Alpes;38;2;03;386;Saint-Geoire-en-Valdaine;2390;41;2431
84;Auvergne-Rhône-Alpes;38;3;01;387;Saint-Geoirs;511;13;524
84;Auvergne-Rhône-Alpes;38;3;26;389;Saint-Georges-d'Espéranche;3396;67;3463
84;Auvergne-Rhône-Alpes;38;1;20;388;Saint-Georges-de-Commiers;2406;31;2437
84;Auvergne-Rhône-Alpes;38;1;23;390;Saint-Gervais;540;9;549
84;Auvergne-Rhône-Alpes;38;1;15;391;Saint-Guillaume;252;5;257
84;Auvergne-Rhône-Alpes;38;2;04;392;Saint-Hilaire-de-Brens;625;23;648
84;Auvergne-Rhône-Alpes;38;3;01;393;Saint-Hilaire-de-la-Côte;1540;33;1573
84;Auvergne-Rhône-Alpes;38;1;23;394;Saint-Hilaire-du-Rosier;1868;32;1900
84;Auvergne-Rhône-Alpes;38;1;15;396;Saint-Honoré;818;27;845
84;Auvergne-Rhône-Alpes;38;1;18;397;Saint-Ismier;7026;311;7337
84;Auvergne-Rhône-Alpes;38;2;03;398;Saint-Jean-d'Avelanne;971;16;987
84;Auvergne-Rhône-Alpes;38;1;15;403;Saint-Jean-d'Hérans;286;5;291
84;Auvergne-Rhône-Alpes;38;3;14;399;Saint-Jean-de-Bournay;4579;101;4680
84;Auvergne-Rhône-Alpes;38;1;25;400;Saint-Jean-de-Moirans;3543;79;3622
84;Auvergne-Rhône-Alpes;38;2;24;401;Saint-Jean-de-Soudain;1612;40;1652
84;Auvergne-Rhône-Alpes;38;1;15;402;Saint-Jean-de-Vaulx;530;19;549
84;Auvergne-Rhône-Alpes;38;1;18;404;Saint-Jean-le-Vieux;295;4;299
84;Auvergne-Rhône-Alpes;38;1;03;405;Saint-Joseph-de-Rivière;1222;28;1250
84;Auvergne-Rhône-Alpes;38;3;21;406;Saint-Julien-de-l'Herms;149;4;153
84;Auvergne-Rhône-Alpes;38;3;26;408;Saint-Just-Chaleyssin;2611;60;2671
84;Auvergne-Rhône-Alpes;38;1;23;409;Saint-Just-de-Claix;1262;32;1294
84;Auvergne-Rhône-Alpes;38;1;23;410;Saint-Lattier;1366;23;1389
84;Auvergne-Rhône-Alpes;38;1;03;412;Saint-Laurent-du-Pont;4520;102;4622
84;Auvergne-Rhône-Alpes;38;1;15;413;Saint-Laurent-en-Beaumont;441;9;450
84;Auvergne-Rhône-Alpes;38;2;02;415;Saint-Marcel-Bel-Accueil;1413;38;1451
84;Auvergne-Rhône-Alpes;38;1;23;416;Saint-Marcellin;7791;179;7970
84;Auvergne-Rhône-Alpes;38;1;22;421;Saint-Martin-d'Hères;38398;268;38666
84;Auvergne-Rhône-Alpes;38;1;19;422;Saint-Martin-d'Uriage;5482;174;5656
84;Auvergne-Rhône-Alpes;38;1;15;419;Saint-Martin-de-Clelles;189;2;191
84;Auvergne-Rhône-Alpes;38;1;15;115;Saint-Martin-de-la-Cluze;723;19;742
84;Auvergne-Rhône-Alpes;38;2;03;420;Saint-Martin-de-Vaulserre;254;5;259
84;Auvergne-Rhône-Alpes;38;1;10;423;Saint-Martin-le-Vinoux;5799;61;5860
84;Auvergne-Rhône-Alpes;38;1;15;424;Saint-Maurice-en-Trièves;161;3;164
84;Auvergne-Rhône-Alpes;38;3;28;425;Saint-Maurice-l'Exil;6192;92;6284
84;Auvergne-Rhône-Alpes;38;1;13;426;Saint-Maximin;659;16;675
84;Auvergne-Rhône-Alpes;38;3;01;427;Saint-Michel-de-Saint-Geoirs;301;4;305
84;Auvergne-Rhône-Alpes;38;1;15;428;Saint-Michel-en-Beaumont;31;0;31
84;Auvergne-Rhône-Alpes;38;1;15;429;Saint-Michel-les-Portes;275;7;282
84;Auvergne-Rhône-Alpes;38;1;18;430;Saint-Mury-Monteymond;319;7;326
84;Auvergne-Rhône-Alpes;38;1;18;431;Saint-Nazaire-les-Eymes;2949;89;3038
84;Auvergne-Rhône-Alpes;38;1;29;432;Saint-Nicolas-de-Macherin;958;24;982
84;Auvergne-Rhône-Alpes;38;1;07;433;Saint-Nizier-du-Moucherotte;1092;31;1123
84;Auvergne-Rhône-Alpes;38;2;08;434;Saint-Ondras;645;6;651
84;Auvergne-Rhône-Alpes;38;3;01;437;Saint-Paul-d'Izeaux;293;6;299
84;Auvergne-Rhône-Alpes;38;1;20;436;Saint-Paul-de-Varces;2222;40;2262
84;Auvergne-Rhône-Alpes;38;1;15;438;Saint-Paul-lès-Monestier;265;1;266
84;Auvergne-Rhône-Alpes;38;1;03;446;Saint-Pierre-d'Entremont;570;14;584
84;Auvergne-Rhône-Alpes;38;3;01;440;Saint-Pierre-de-Bressieux;758;16;774
84;Auvergne-Rhône-Alpes;38;1;03;442;Saint-Pierre-de-Chartreuse;989;27;1016
84;Auvergne-Rhône-Alpes;38;1;23;443;Saint-Pierre-de-Chérennes;462;12;474
84;Auvergne-Rhône-Alpes;38;1;15;444;Saint-Pierre-de-Méaroz;121;6;127
84;Auvergne-Rhône-Alpes;38;1;19;445;Saint-Pierre-de-Mésage;767;6;773
84;Auvergne-Rhône-Alpes;38;3;28;448;Saint-Prim;1390;31;1421
84;Auvergne-Rhône-Alpes;38;2;26;449;Saint-Quentin-Fallavier;6083;64;6147
84;Auvergne-Rhône-Alpes;38;1;25;450;Saint-Quentin-sur-Isère;1472;19;1491
84;Auvergne-Rhône-Alpes;38;2;04;451;Saint-Romain-de-Jalionas;3324;41;3365
84;Auvergne-Rhône-Alpes;38;3;21;452;Saint-Romain-de-Surieu;353;9;362
84;Auvergne-Rhône-Alpes;38;1;23;453;Saint-Romans;1774;41;1815
84;Auvergne-Rhône-Alpes;38;1;23;454;Saint-Sauveur;2102;50;2152
84;Auvergne-Rhône-Alpes;38;2;02;455;Saint-Savin;4094;81;4175
84;Auvergne-Rhône-Alpes;38;3;01;457;Saint-Siméon-de-Bressieux;2888;64;2952
84;Auvergne-Rhône-Alpes;38;2;17;458;Saint-Sorlin-de-Morestel;621;16;637
84;Auvergne-Rhône-Alpes;38;3;28;459;Saint-Sorlin-de-Vienne;877;7;884
84;Auvergne-Rhône-Alpes;38;2;08;460;Saint-Sulpice-des-Rivoires;430;12;442
84;Auvergne-Rhône-Alpes;38;1;15;462;Saint-Théoffrey;534;14;548
84;Auvergne-Rhône-Alpes;38;1;23;463;Saint-Vérand;1716;38;1754
84;Auvergne-Rhône-Alpes;38;2;24;464;Saint-Victor-de-Cessieu;2235;49;2284
84;Auvergne-Rhône-Alpes;38;2;17;465;Saint-Victor-de-Morestel;1086;22;1108
84;Auvergne-Rhône-Alpes;38;1;13;466;Saint-Vincent-de-Mercuze;1512;48;1560
84;Auvergne-Rhône-Alpes;38;1;18;350;Sainte-Agnès;558;18;576
84;Auvergne-Rhône-Alpes;38;3;01;358;Sainte-Anne-sur-Gervonde;715;11;726
84;Auvergne-Rhône-Alpes;38;2;24;369;Sainte-Blandine;959;37;996
84;Auvergne-Rhône-Alpes;38;1;15;414;Sainte-Luce;42;2;44
84;Auvergne-Rhône-Alpes;38;1;13;417;Sainte-Marie-d'Alloix;483;17;500
84;Auvergne-Rhône-Alpes;38;1;13;418;Sainte-Marie-du-Mont;236;2;238
84;Auvergne-Rhône-Alpes;38;2;02;467;Salagnon;1436;38;1474
84;Auvergne-Rhône-Alpes;38;3;21;468;Salaise-sur-Sanne;4485;71;4556
84;Auvergne-Rhône-Alpes;38;1;15;469;La Salette-Fallavaux;67;0;67
84;Auvergne-Rhône-Alpes;38;1;15;470;La Salle-en-Beaumont;328;8;336
84;Auvergne-Rhône-Alpes;38;1;16;471;Le Sappey-en-Chartreuse;1127;30;1157
84;Auvergne-Rhône-Alpes;38;1;10;472;Sarcenas;202;4;206
84;Auvergne-Rhône-Alpes;38;3;01;473;Sardieu;1137;21;1158
84;Auvergne-Rhône-Alpes;38;1;07;474;Sassenage;11277;203;11480
84;Auvergne-Rhône-Alpes;38;2;26;475;Satolas-et-Bonce;2438;28;2466
84;Auvergne-Rhône-Alpes;38;3;01;476;Savas-Mépin;896;10;906
84;Auvergne-Rhône-Alpes;38;1;19;478;Séchilienne;1051;13;1064
84;Auvergne-Rhône-Alpes;38;3;27;480;Septème;2067;41;2108
84;Auvergne-Rhône-Alpes;38;2;02;481;Sérézin-de-la-Tour;1068;31;1099
84;Auvergne-Rhône-Alpes;38;2;17;483;Sermérieu;1663;50;1713
84;Auvergne-Rhône-Alpes;38;3;27;484;Serpaize;2030;26;2056
84;Auvergne-Rhône-Alpes;38;1;23;275;Serre-Nerpol;302;37;339
84;Auvergne-Rhône-Alpes;38;1;06;485;Seyssinet-Pariset;12017;144;12161
84;Auvergne-Rhône-Alpes;38;1;06;486;Seyssins;7783;107;7890
84;Auvergne-Rhône-Alpes;38;3;27;487;Seyssuel;2010;51;2061
84;Auvergne-Rhône-Alpes;38;2;04;488;Siccieu-Saint-Julien-et-Carisieu;580;16;596
84;Auvergne-Rhône-Alpes;38;1;15;489;Siévoz;135;2;137
84;Auvergne-Rhône-Alpes;38;3;01;490;Sillans;1921;46;1967
84;Auvergne-Rhône-Alpes;38;1;15;492;Sinard;704;22;726
84;Auvergne-Rhône-Alpes;38;2;17;494;Soleymieu;780;20;800
84;Auvergne-Rhône-Alpes;38;1;23;495;La Sône;586;4;590
84;Auvergne-Rhône-Alpes;38;3;21;496;Sonnay;1243;25;1268
84;Auvergne-Rhône-Alpes;38;1;15;497;Sousville;142;0;142
84;Auvergne-Rhône-Alpes;38;2;02;498;Succieu;733;21;754
84;Auvergne-Rhône-Alpes;38;1;29;407;La Sure en Chartreuse;985;30;1015
84;Auvergne-Rhône-Alpes;38;1;15;499;Susville;1239;17;1256
84;Auvergne-Rhône-Alpes;38;1;23;500;Têche;574;6;580
84;Auvergne-Rhône-Alpes;38;1;13;501;Tencin;2112;23;2135
84;Auvergne-Rhône-Alpes;38;1;18;503;La Terrasse;2524;131;2655
84;Auvergne-Rhône-Alpes;38;1;13;504;Theys;1980;98;2078
84;Auvergne-Rhône-Alpes;38;3;01;505;Thodure;757;14;771
84;Auvergne-Rhône-Alpes;38;2;04;507;Tignieu-Jameyzieu;7385;96;7481
84;Auvergne-Rhône-Alpes;38;2;24;508;Torchefelon;766;26;792
84;Auvergne-Rhône-Alpes;38;2;24;509;La Tour-du-Pin;8137;206;8343
84;Auvergne-Rhône-Alpes;38;1;13;511;Le Touvet;3203;102;3305
84;Auvergne-Rhône-Alpes;38;3;14;512;Tramolé;768;24;792
84;Auvergne-Rhône-Alpes;38;1;15;513;Treffort;296;7;303
84;Auvergne-Rhône-Alpes;38;1;15;514;Tréminis;177;1;178
84;Auvergne-Rhône-Alpes;38;2;04;515;Trept;2173;55;2228
84;Auvergne-Rhône-Alpes;38;1;16;516;La Tronche;6588;140;6728
84;Auvergne-Rhône-Alpes;38;1;25;517;Tullins;7719;122;7841
84;Auvergne-Rhône-Alpes;38;2;08;560;Val-de-Virieu ;1537;19;1556
84;Auvergne-Rhône-Alpes;38;1;15;518;Valbonnais;501;12;513
84;Auvergne-Rhône-Alpes;38;3;26;519;Valencin;2795;47;2842
84;Auvergne-Rhône-Alpes;38;2;08;520;Valencogne;691;20;711
84;Auvergne-Rhône-Alpes;38;1;15;521;La Valette;70;2;72
84;Auvergne-Rhône-Alpes;38;1;15;522;Valjouffrey;132;2;134
84;Auvergne-Rhône-Alpes;38;1;23;523;Varacieux;842;19;861
84;Auvergne-Rhône-Alpes;38;1;20;524;Varces-Allières-et-Risset;8272;171;8443
84;Auvergne-Rhône-Alpes;38;2;17;525;Vasselin;461;5;466
84;Auvergne-Rhône-Alpes;38;1;23;526;Vatilieu;362;11;373
84;Auvergne-Rhône-Alpes;38;1;19;527;Vaujany;339;4;343
84;Auvergne-Rhône-Alpes;38;1;19;528;Vaulnaveys-le-Bas;1292;29;1321
84;Auvergne-Rhône-Alpes;38;1;19;529;Vaulnaveys-le-Haut;3902;60;3962
84;Auvergne-Rhône-Alpes;38;2;14;530;Vaulx-Milieu;2546;51;2597
84;Auvergne-Rhône-Alpes;38;2;03;531;Velanne;543;6;549
84;Auvergne-Rhône-Alpes;38;2;04;532;Vénérieu;892;10;902
84;Auvergne-Rhône-Alpes;38;1;22;533;Venon;723;16;739
84;Auvergne-Rhône-Alpes;38;2;04;535;Vernas;265;7;272
84;Auvergne-Rhône-Alpes;38;3;28;536;Vernioz;1346;25;1371
84;Auvergne-Rhône-Alpes;38;2;26;537;La Verpillière;7305;88;7393
84;Auvergne-Rhône-Alpes;38;1;18;538;Le Versoud;4876;64;4940
84;Auvergne-Rhône-Alpes;38;2;17;539;Vertrieu;625;21;646
84;Auvergne-Rhône-Alpes;38;1;07;540;Veurey-Voroize;1436;26;1462
84;Auvergne-Rhône-Alpes;38;2;04;542;Veyssilieu;333;15;348
84;Auvergne-Rhône-Alpes;38;2;17;543;Vézeronce-Curtin;2147;35;2182
84;Auvergne-Rhône-Alpes;38;3;99;544;Vienne;29583;339;29922
84;Auvergne-Rhône-Alpes;38;1;20;545;Vif;8580;126;8706
84;Auvergne-Rhône-Alpes;38;2;17;546;Vignieu;994;88;1082
84;Auvergne-Rhône-Alpes;38;2;08;292;Villages du Lac de Paladru;2507;60;2567
84;Auvergne-Rhône-Alpes;38;1;18;547;Villard-Bonnot;7175;103;7278
84;Auvergne-Rhône-Alpes;38;1;07;548;Villard-de-Lans;4239;225;4464
84;Auvergne-Rhône-Alpes;38;1;19;549;Villard-Notre-Dame;28;3;31
84;Auvergne-Rhône-Alpes;38;1;19;550;Villard-Reculas;56;0;56
84;Auvergne-Rhône-Alpes;38;1;19;551;Villard-Reymond;42;1;43
84;Auvergne-Rhône-Alpes;38;1;15;552;Villard-Saint-Christophe;405;12;417
84;Auvergne-Rhône-Alpes;38;3;21;556;Ville-sous-Anjou;1176;20;1196
84;Auvergne-Rhône-Alpes;38;2;14;553;Villefontaine;18808;270;19078
84;Auvergne-Rhône-Alpes;38;2;04;554;Villemoirieu;1837;69;1906
84;Auvergne-Rhône-Alpes;38;3;01;555;Villeneuve-de-Marc;1153;30;1183
84;Auvergne-Rhône-Alpes;38;2;04;557;Villette-d'Anthon;5035;88;5123
84;Auvergne-Rhône-Alpes;38;3;27;558;Villette-de-Vienne;1923;31;1954
84;Auvergne-Rhône-Alpes;38;1;23;559;Vinay;4298;72;4370
84;Auvergne-Rhône-Alpes;38;3;01;561;Viriville;1647;31;1678
84;Auvergne-Rhône-Alpes;38;1;19;562;Vizille;7303;168;7471
84;Auvergne-Rhône-Alpes;38;1;29;563;Voiron;20248;496;20744
84;Auvergne-Rhône-Alpes;38;2;03;564;Voissant;230;10;240
84;Auvergne-Rhône-Alpes;38;1;29;565;Voreppe;9229;372;9601
84;Auvergne-Rhône-Alpes;38;1;25;566;Vourey;1702;48;1750
27;Bourgogne-Franche-Comté;39;1;17;001;Abergement-la-Ronce;848;25;873
27;Bourgogne-Franche-Comté;39;1;01;002;Abergement-le-Grand;60;1;61
27;Bourgogne-Franche-Comté;39;1;03;003;Abergement-le-Petit;46;0;46
27;Bourgogne-Franche-Comté;39;1;01;004;Abergement-lès-Thésy;56;3;59
27;Bourgogne-Franche-Comté;39;1;01;006;Aiglepierre;445;16;461
27;Bourgogne-Franche-Comté;39;2;09;007;Alièze;154;5;159
27;Bourgogne-Franche-Comté;39;1;02;008;Amange;439;49;488
27;Bourgogne-Franche-Comté;39;2;04;009;Andelot-en-Montagne;512;11;523
27;Bourgogne-Franche-Comté;39;2;13;010;Andelot-Morval;94;1;95
27;Bourgogne-Franche-Comté;39;1;17;011;Annoire;392;5;397
27;Bourgogne-Franche-Comté;39;1;01;013;Arbois;3314;209;3523
27;Bourgogne-Franche-Comté;39;1;02;014;Archelange;217;6;223
27;Bourgogne-Franche-Comté;39;2;04;015;Ardon;116;2;118
27;Bourgogne-Franche-Comté;39;1;01;586;Aresches;31;0;31
27;Bourgogne-Franche-Comté;39;2;09;016;Arinthod ;1103;34;1137
27;Bourgogne-Franche-Comté;39;2;89;017;Arlay;1217;37;1254
27;Bourgogne-Franche-Comté;39;2;  ;018;Aromas ;658;18;676
27;Bourgogne-Franche-Comté;39;2;15;020;Arsure-Arsurette;101;4;105
27;Bourgogne-Franche-Comté;39;1;01;019;Les Arsures;222;10;232
27;Bourgogne-Franche-Comté;39;1;17;022;Asnans-Beauvoisin;730;11;741
27;Bourgogne-Franche-Comté;39;1;02;024;Audelange;270;6;276
27;Bourgogne-Franche-Comté;39;2;13;025;Augea;274;7;281
27;Bourgogne-Franche-Comté;39;1;10;026;Augerans;179;1;180
27;Bourgogne-Franche-Comté;39;2;13;027;Augisey;193;6;199
27;Bourgogne-Franche-Comté;39;1;03;028;Aumont;473;7;480
27;Bourgogne-Franche-Comté;39;1;17;029;Aumur;366;9;375
27;Bourgogne-Franche-Comté;39;1;02;030;Authume;820;21;841
27;Bourgogne-Franche-Comté;39;1;02;031;Auxange;201;3;204
27;Bourgogne-Franche-Comté;39;3;14;032;Avignon-lès-Saint-Claude;374;17;391
27;Bourgogne-Franche-Comté;39;1;17;034;Balaiseaux;310;8;318
27;Bourgogne-Franche-Comté;39;2;13;035;Balanod;350;9;359
27;Bourgogne-Franche-Comté;39;1;10;037;Bans;195;4;199
27;Bourgogne-Franche-Comté;39;2;15;038;Barésia-sur-l'Ain;146;2;148
27;Bourgogne-Franche-Comté;39;1;10;039;La Barre;236;5;241
27;Bourgogne-Franche-Comté;39;1;03;040;Barretaine;177;2;179
27;Bourgogne-Franche-Comté;39;2;12;041;Baume-les-Messieurs;161;6;167
27;Bourgogne-Franche-Comté;39;1;02;042;Baverans;500;21;521
27;Bourgogne-Franche-Comté;39;2;13;043;Beaufort-Orbagna;1375;19;1394
27;Bourgogne-Franche-Comté;39;2;09;045;Beffia;80;3;83
27;Bourgogne-Franche-Comté;39;3;16;046;Bellecombe;67;4;71
27;Bourgogne-Franche-Comté;39;3;11;047;Bellefontaine;531;16;547
27;Bourgogne-Franche-Comté;39;1;10;048;Belmont;256;8;264
27;Bourgogne-Franche-Comté;39;1;03;049;Bersaillin;407;14;421
27;Bourgogne-Franche-Comté;39;1;12;050;Besain;161;10;171
27;Bourgogne-Franche-Comté;39;1;02;051;Biarne;408;5;413
27;Bourgogne-Franche-Comté;39;2;15;052;Bief-des-Maisons;71;0;71
27;Bourgogne-Franche-Comté;39;2;15;053;Bief-du-Fourg;204;4;208
27;Bourgogne-Franche-Comté;39;1;03;054;Biefmorin;106;1;107
27;Bourgogne-Franche-Comté;39;2;15;055;Billecul;47;1;48
27;Bourgogne-Franche-Comté;39;2;03;056;Bletterans;1473;28;1501
27;Bourgogne-Franche-Comté;39;2;12;057;Blois-sur-Seille;104;1;105
27;Bourgogne-Franche-Comté;39;2;12;058;Blye;168;5;173
27;Bourgogne-Franche-Comté;39;3;11;059;Bois-d'Amont;1636;42;1678
27;Bourgogne-Franche-Comté;39;2;03;060;Bois-de-Gand;56;1;57
27;Bourgogne-Franche-Comté;39;2;15;061;Boissia;112;5;117
27;Bourgogne-Franche-Comté;39;2;09;062;La Boissière;69;0;69
27;Bourgogne-Franche-Comté;39;2;15;063;Bonlieu;263;6;269
27;Bourgogne-Franche-Comté;39;2;12;065;Bonnefontaine;107;0;107
27;Bourgogne-Franche-Comté;39;2;08;066;Bornay;179;6;185
27;Bourgogne-Franche-Comté;39;3;16;068;Les Bouchoux;313;9;322
27;Bourgogne-Franche-Comté;39;2;04;070;Bourg-de-Sirod;96;2;98
27;Bourgogne-Franche-Comté;39;1;01;072;Bracon;272;7;279
27;Bourgogne-Franche-Comté;39;1;03;073;Brainans;170;6;176
27;Bourgogne-Franche-Comté;39;1;02;074;Brans;211;8;219
27;Bourgogne-Franche-Comté;39;1;10;076;La Bretenière;221;1;222
27;Bourgogne-Franche-Comté;39;1;17;077;Bretenières;41;1;42
27;Bourgogne-Franche-Comté;39;1;02;078;Brevans;679;14;693
27;Bourgogne-Franche-Comté;39;2;12;079;Briod;205;9;214
27;Bourgogne-Franche-Comté;39;2;13;080;Broissia;63;2;65
27;Bourgogne-Franche-Comté;39;1;12;081;Buvilly;383;8;391
27;Bourgogne-Franche-Comté;39;2;15;083;Censeau;310;6;316
27;Bourgogne-Franche-Comté;39;1;01;084;Cernans;142;4;146
27;Bourgogne-Franche-Comté;39;2;15;085;Cerniébaud;90;1;91
27;Bourgogne-Franche-Comté;39;2;09;086;Cernon;244;2;246
27;Bourgogne-Franche-Comté;39;2;13;088;Cesancey;390;11;401
27;Bourgogne-Franche-Comté;39;2;88;021;La Chailleuse;595;14;609
27;Bourgogne-Franche-Comté;39;1;17;090;Chaînée-des-Coupis;183;4;187
27;Bourgogne-Franche-Comté;39;2;15;091;Les Chalesmes;94;1;95
27;Bourgogne-Franche-Comté;39;2;09;092;Chambéria;180;1;181
27;Bourgogne-Franche-Comté;39;1;10;093;Chamblay;425;10;435
27;Bourgogne-Franche-Comté;39;1;12;094;Chamole;164;7;171
27;Bourgogne-Franche-Comté;39;1;10;095;Champagne-sur-Loue;125;5;130
27;Bourgogne-Franche-Comté;39;1;02;096;Champagney;474;8;482
27;Bourgogne-Franche-Comté;39;2;04;097;Champagnole;7989;390;8379
27;Bourgogne-Franche-Comté;39;1;17;099;Champdivers;433;7;440
27;Bourgogne-Franche-Comté;39;2;03;100;Champrougier;101;3;104
27;Bourgogne-Franche-Comté;39;1;05;101;Champvans;1428;32;1460
27;Bourgogne-Franche-Comté;39;3;09;102;Chancia;230;4;234
27;Bourgogne-Franche-Comté;39;1;01;103;La Chapelle-sur-Furieuse;311;1;312
27;Bourgogne-Franche-Comté;39;2;03;104;Chapelle-Voland;602;9;611
27;Bourgogne-Franche-Comté;39;2;04;105;Chapois;222;9;231
27;Bourgogne-Franche-Comté;39;3;09;106;Charchilla;284;6;290
27;Bourgogne-Franche-Comté;39;2;15;107;Charcier;136;3;139
27;Bourgogne-Franche-Comté;39;2;15;108;Charency;55;3;58
27;Bourgogne-Franche-Comté;39;2;15;109;Charézier;177;2;179
27;Bourgogne-Franche-Comté;39;2;03;110;La Charme;67;0;67
27;Bourgogne-Franche-Comté;39;2;09;111;Charnod;39;0;39
27;Bourgogne-Franche-Comté;39;2;03;112;La Chassagne;114;1;115
27;Bourgogne-Franche-Comté;39;3;16;339;Chassal-Molinges ;1124;28;1152
27;Bourgogne-Franche-Comté;39;2;12;114;Château-Chalon;143;7;150
27;Bourgogne-Franche-Comté;39;3;09;118;Châtel-de-Joux;52;0;52
27;Bourgogne-Franche-Comté;39;1;01;116;La Châtelaine;144;2;146
27;Bourgogne-Franche-Comté;39;1;10;117;Chatelay;108;6;114
27;Bourgogne-Franche-Comté;39;1;03;119;Le Chateley;87;3;90
27;Bourgogne-Franche-Comté;39;2;04;120;Châtelneuf;134;8;142
27;Bourgogne-Franche-Comté;39;1;02;121;Châtenois;401;7;408
27;Bourgogne-Franche-Comté;39;2;12;122;Châtillon;110;5;115
27;Bourgogne-Franche-Comté;39;2;03;124;Chaumergy;477;15;492
27;Bourgogne-Franche-Comté;39;3;15;126;La Chaumusse;397;11;408
27;Bourgogne-Franche-Comté;39;1;12;127;Chaussenans;103;1;104
27;Bourgogne-Franche-Comté;39;1;17;128;Chaussin;1592;24;1616
27;Bourgogne-Franche-Comté;39;1;01;133;Chaux-Champagny;69;2;71
27;Bourgogne-Franche-Comté;39;2;15;129;Chaux-des-Crotenay;402;14;416
27;Bourgogne-Franche-Comté;39;3;15;131;La Chaux-du-Dombief;557;13;570
27;Bourgogne-Franche-Comté;39;2;03;132;La Chaux-en-Bresse;37;0;37
27;Bourgogne-Franche-Comté;39;2;09;134;Chavéria;227;8;235
27;Bourgogne-Franche-Comté;39;2;03;136;Chemenot;37;1;38
27;Bourgogne-Franche-Comté;39;1;17;138;Chemin;343;10;353
27;Bourgogne-Franche-Comté;39;1;17;139;Chêne-Bernard;69;0;69
27;Bourgogne-Franche-Comté;39;2;03;140;Chêne-Sec;38;0;38
27;Bourgogne-Franche-Comté;39;1;02;141;Chevigny;278;6;284
27;Bourgogne-Franche-Comté;39;2;13;142;Chevreaux;125;1;126
27;Bourgogne-Franche-Comté;39;2;15;143;Chevrotaine;33;0;33
27;Bourgogne-Franche-Comté;39;2;07;145;Chille;296;19;315
27;Bourgogne-Franche-Comté;39;2;08;146;Chilly-le-Vignoble;647;25;672
27;Bourgogne-Franche-Comté;39;1;01;147;Chilly-sur-Salins;104;4;108
27;Bourgogne-Franche-Comté;39;1;10;149;Chissey-sur-Loue;312;9;321
27;Bourgogne-Franche-Comté;39;1;06;150;Choisey;1037;30;1067
27;Bourgogne-Franche-Comté;39;3;16;151;Choux;122;6;128
27;Bourgogne-Franche-Comté;39;2;04;153;Cize;791;31;822
27;Bourgogne-Franche-Comté;39;2;15;154;Clairvaux-les-Lacs;1442;43;1485
27;Bourgogne-Franche-Comté;39;1;01;155;Clucy;78;0;78
27;Bourgogne-Franche-Comté;39;2;15;156;Cogna;249;7;256
27;Bourgogne-Franche-Comté;39;3;16;157;Coiserette;53;3;56
27;Bourgogne-Franche-Comté;39;1;03;159;Colonne;261;2;263
27;Bourgogne-Franche-Comté;39;2;03;160;Commenailles;896;17;913
27;Bourgogne-Franche-Comté;39;2;07;162;Condamine;266;5;271
27;Bourgogne-Franche-Comté;39;2;09;163;Condes;112;3;115
27;Bourgogne-Franche-Comté;39;2;12;164;Conliège;663;27;690
27;Bourgogne-Franche-Comté;39;2;15;165;Conte;54;0;54
27;Bourgogne-Franche-Comté;39;2;09;166;Cornod;217;4;221
27;Bourgogne-Franche-Comté;39;2;03;167;Cosges;362;5;367
27;Bourgogne-Franche-Comté;39;3;86;491;Coteaux du Lizon;2328;96;2424
27;Bourgogne-Franche-Comté;39;2;09;168;Courbette;48;0;48
27;Bourgogne-Franche-Comté;39;2;08;169;Courbouzon;592;15;607
27;Bourgogne-Franche-Comté;39;2;07;170;Courlans;923;28;951
27;Bourgogne-Franche-Comté;39;2;07;171;Courlaoux;1119;30;1149
27;Bourgogne-Franche-Comté;39;1;10;172;Courtefontaine;253;14;267
27;Bourgogne-Franche-Comté;39;2;13;173;Cousance;1304;25;1329
27;Bourgogne-Franche-Comté;39;3;16;174;Coyrière;65;0;65
27;Bourgogne-Franche-Comté;39;3;09;175;Coyron;73;7;80
27;Bourgogne-Franche-Comté;39;1;10;176;Cramans;525;8;533
27;Bourgogne-Franche-Comté;39;2;15;178;Crans;73;1;74
27;Bourgogne-Franche-Comté;39;3;09;179;Crenans;237;5;242
27;Bourgogne-Franche-Comté;39;2;13;180;Cressia;255;120;375
27;Bourgogne-Franche-Comté;39;1;06;182;Crissey;666;25;691
27;Bourgogne-Franche-Comté;39;2;04;183;Crotenay;627;80;707
27;Bourgogne-Franche-Comté;39;3;09;184;Les Crozets;196;5;201
27;Bourgogne-Franche-Comté;39;2;13;185;Cuisia;391;12;403
27;Bourgogne-Franche-Comté;39;2;15;187;Cuvier;266;7;273
27;Bourgogne-Franche-Comté;39;1;02;188;Dammartin-Marpain;340;4;344
27;Bourgogne-Franche-Comté;39;1;06;189;Damparis;2662;80;2742
27;Bourgogne-Franche-Comté;39;1;  ;190;Dampierre ;1285;28;1313
27;Bourgogne-Franche-Comté;39;1;03;191;Darbonnay;89;5;94
27;Bourgogne-Franche-Comté;39;2;15;192;Denezières;72;1;73
27;Bourgogne-Franche-Comté;39;1;17;193;Le Deschaux;1017;17;1034
27;Bourgogne-Franche-Comté;39;2;03;194;Desnes;482;6;488
27;Bourgogne-Franche-Comté;39;2;03;196;Les Deux-Fays;111;2;113
27;Bourgogne-Franche-Comté;39;2;13;197;Digna;354;11;365
27;Bourgogne-Franche-Comté;39;1;98;198;Dole;23770;896;24666
27;Bourgogne-Franche-Comté;39;2;  ;199;Domblans ;1230;30;1260
27;Bourgogne-Franche-Comté;39;2;09;200;Dompierre-sur-Mont;223;7;230
27;Bourgogne-Franche-Comté;39;2;15;201;Doucier;289;34;323
27;Bourgogne-Franche-Comté;39;1;01;202;Dournon;138;1;139
27;Bourgogne-Franche-Comté;39;2;15;203;Doye;101;2;103
27;Bourgogne-Franche-Comté;39;2;09;204;Dramelay;29;3;32
27;Bourgogne-Franche-Comté;39;1;02;205;Éclans-Nenon;384;8;392
27;Bourgogne-Franche-Comté;39;1;10;206;Écleux;226;10;236
27;Bourgogne-Franche-Comté;39;2;09;207;Écrille;81;3;84
27;Bourgogne-Franche-Comté;39;2;15;208;Entre-deux-Monts;140;9;149
27;Bourgogne-Franche-Comté;39;2;04;210;Équevillon;581;14;595
27;Bourgogne-Franche-Comté;39;1;17;211;Les Essards-Taignevaux;257;3;260
27;Bourgogne-Franche-Comté;39;2;15;214;Esserval-Tartre;121;3;124
27;Bourgogne-Franche-Comté;39;3;09;216;Étival;309;11;320
27;Bourgogne-Franche-Comté;39;2;07;217;L' Étoile;559;14;573
27;Bourgogne-Franche-Comté;39;1;10;218;Étrepigney;428;6;434
27;Bourgogne-Franche-Comté;39;1;10;219;Évans;648;12;660
27;Bourgogne-Franche-Comté;39;1;02;220;Falletans;394;9;403
27;Bourgogne-Franche-Comté;39;2;15;221;La Favière;31;1;32
27;Bourgogne-Franche-Comté;39;1;12;222;Fay-en-Montagne;82;7;89
27;Bourgogne-Franche-Comté;39;1;01;223;La Ferté;198;2;200
27;Bourgogne-Franche-Comté;39;1;12;225;Le Fied;200;6;206
27;Bourgogne-Franche-Comté;39;2;15;227;Foncine-le-Bas;190;7;197
27;Bourgogne-Franche-Comté;39;2;15;228;Foncine-le-Haut;1072;28;1100
27;Bourgogne-Franche-Comté;39;2;03;229;Fontainebrux;202;10;212
27;Bourgogne-Franche-Comté;39;2;15;230;Fontenu;75;3;78
27;Bourgogne-Franche-Comté;39;3;15;232;Fort-du-Plasne;444;11;455
27;Bourgogne-Franche-Comté;39;1;05;233;Foucherans;2242;39;2281
27;Bourgogne-Franche-Comté;39;2;03;234;Foulenay;82;0;82
27;Bourgogne-Franche-Comté;39;1;10;235;Fraisans;1203;14;1217
27;Bourgogne-Franche-Comté;39;2;03;236;Francheville;57;1;58
27;Bourgogne-Franche-Comté;39;2;15;237;Fraroz;50;4;54
27;Bourgogne-Franche-Comté;39;1;02;238;Frasne-les-Meulières;115;7;122
27;Bourgogne-Franche-Comté;39;2;15;239;La Frasnée;39;2;41
27;Bourgogne-Franche-Comté;39;2;15;240;Le Frasnois;163;5;168
27;Bourgogne-Franche-Comté;39;2;08;241;Frébuans;374;9;383
27;Bourgogne-Franche-Comté;39;2;12;244;Frontenay;165;5;170
27;Bourgogne-Franche-Comté;39;1;17;245;Gatey;365;9;374
27;Bourgogne-Franche-Comté;39;1;02;246;Gendrey;427;13;440
27;Bourgogne-Franche-Comté;39;2;09;247;Genod;70;2;72
27;Bourgogne-Franche-Comté;39;1;01;248;Geraise;43;0;43
27;Bourgogne-Franche-Comté;39;1;10;249;Germigney;77;4;81
27;Bourgogne-Franche-Comté;39;2;08;250;Geruge;171;7;178
27;Bourgogne-Franche-Comté;39;2;08;251;Gevingey;453;95;548
27;Bourgogne-Franche-Comté;39;1;06;252;Gevry;699;10;709
27;Bourgogne-Franche-Comté;39;2;13;253;Gigny;279;8;287
27;Bourgogne-Franche-Comté;39;2;15;254;Gillois;136;6;142
27;Bourgogne-Franche-Comté;39;2;13;255;Gizia;235;4;239
27;Bourgogne-Franche-Comté;39;3;15;258;Grande-Rivière Château ;626;19;645
27;Bourgogne-Franche-Comté;39;1;10;259;Grange-de-Vaivre;34;1;35
27;Bourgogne-Franche-Comté;39;2;13;261;Graye-et-Charnay;140;2;142
27;Bourgogne-Franche-Comté;39;1;02;262;Gredisans;136;1;137
27;Bourgogne-Franche-Comté;39;1;03;263;Grozon;412;14;426
27;Bourgogne-Franche-Comté;39;2;15;265;Hautecour;194;4;198
27;Bourgogne-Franche-Comté;39;2;12;177;Hauteroche;960;24;984
27;Bourgogne-Franche-Comté;39;3;11;368;Hauts de Bienne;5312;270;5582
27;Bourgogne-Franche-Comté;39;1;17;266;Les Hays;337;2;339
27;Bourgogne-Franche-Comté;39;1;01;267;Ivory;99;1;100
27;Bourgogne-Franche-Comté;39;1;01;268;Ivrey;59;1;60
27;Bourgogne-Franche-Comté;39;3;09;269;Jeurre;270;1;271
27;Bourgogne-Franche-Comté;39;1;02;270;Jouhe;554;66;620
27;Bourgogne-Franche-Comté;39;3;15;271;Lac-des-Rouges-Truites;393;17;410
27;Bourgogne-Franche-Comté;39;2;12;272;Ladoye-sur-Seille;51;3;54
27;Bourgogne-Franche-Comté;39;3;16;274;Lajoux;273;13;286
27;Bourgogne-Franche-Comté;39;3;16;275;Lamoura;646;17;663
27;Bourgogne-Franche-Comté;39;2;04;277;Le Larderet;67;1;68
27;Bourgogne-Franche-Comté;39;2;15;278;Largillay-Marsonnay;148;2;150
27;Bourgogne-Franche-Comté;39;2;03;279;Larnaud;605;13;618
27;Bourgogne-Franche-Comté;39;3;16;280;Larrivoire;102;2;104
27;Bourgogne-Franche-Comté;39;2;04;281;Le Latet;83;2;85
27;Bourgogne-Franche-Comté;39;2;15;282;La Latette;77;2;79
27;Bourgogne-Franche-Comté;39;3;16;283;Lavancia-Epercy;636;18;654
27;Bourgogne-Franche-Comté;39;1;02;284;Lavangeot;140;2;142
27;Bourgogne-Franche-Comté;39;1;02;285;Lavans-lès-Dole;325;8;333
27;Bourgogne-Franche-Comté;39;3;  ;286;Lavans-lès-Saint-Claude ;2377;108;2485
27;Bourgogne-Franche-Comté;39;2;12;288;Lavigny;382;5;387
27;Bourgogne-Franche-Comté;39;3;09;289;Lect;354;7;361
27;Bourgogne-Franche-Comté;39;1;01;291;Lemuy;239;5;244
27;Bourgogne-Franche-Comté;39;2;04;292;Lent;152;4;156
27;Bourgogne-Franche-Comté;39;3;14;293;Leschères;208;4;212
27;Bourgogne-Franche-Comté;39;2;13;295;Loisia;167;1;168
27;Bourgogne-Franche-Comté;39;2;03;296;Lombard;213;5;218
27;Bourgogne-Franche-Comté;39;3;11;297;Longchaumois;1155;32;1187
27;Bourgogne-Franche-Comté;39;2;15;298;Longcochon;62;3;65
27;Bourgogne-Franche-Comté;39;1;17;299;Longwy-sur-le-Doubs;498;10;508
27;Bourgogne-Franche-Comté;39;2;99;300;Lons-le-Saunier;17320;779;18099
27;Bourgogne-Franche-Comté;39;2;04;301;Loulle;172;4;176
27;Bourgogne-Franche-Comté;39;1;02;302;Louvatange;95;4;99
27;Bourgogne-Franche-Comté;39;2;12;304;Le Louverot;217;9;226
27;Bourgogne-Franche-Comté;39;1;10;305;La Loye;555;9;564
27;Bourgogne-Franche-Comté;39;2;08;306;Macornay;968;36;1004
27;Bourgogne-Franche-Comté;39;3;09;307;Maisod;329;10;339
27;Bourgogne-Franche-Comté;39;1;02;308;Malange;320;7;327
27;Bourgogne-Franche-Comté;39;2;03;310;Mantry;461;13;474
27;Bourgogne-Franche-Comté;39;2;09;312;Marigna-sur-Valouse;113;4;117
27;Bourgogne-Franche-Comté;39;2;15;313;Marigny;210;1;211
27;Bourgogne-Franche-Comté;39;2;09;314;Marnézia;85;4;89
27;Bourgogne-Franche-Comté;39;1;01;315;Marnoz;401;22;423
27;Bourgogne-Franche-Comté;39;2;12;317;La Marre;345;15;360
27;Bourgogne-Franche-Comté;39;3;09;318;Martigna;191;13;204
27;Bourgogne-Franche-Comté;39;1;01;319;Mathenay;143;1;144
27;Bourgogne-Franche-Comté;39;2;13;320;Maynal;334;1;335
27;Bourgogne-Franche-Comté;39;2;12;321;Menétru-le-Vignoble;157;2;159
27;Bourgogne-Franche-Comté;39;2;15;322;Menétrux-en-Joux;54;2;56
27;Bourgogne-Franche-Comté;39;1;02;323;Menotey;310;14;324
27;Bourgogne-Franche-Comté;39;2;09;324;Mérona;8;0;8
27;Bourgogne-Franche-Comté;39;1;01;325;Mesnay;580;15;595
27;Bourgogne-Franche-Comté;39;2;15;326;Mesnois;182;4;186
27;Bourgogne-Franche-Comté;39;2;08;327;Messia-sur-Sorne;842;13;855
27;Bourgogne-Franche-Comté;39;3;09;328;Meussia;423;7;430
27;Bourgogne-Franche-Comté;39;2;15;329;Mièges ;170;3;173
27;Bourgogne-Franche-Comté;39;1;03;330;Miéry;152;5;157
27;Bourgogne-Franche-Comté;39;2;15;331;Mignovillard ;826;26;852
27;Bourgogne-Franche-Comté;39;3;09;333;Moirans-en-Montagne;2107;118;2225
27;Bourgogne-Franche-Comté;39;2;08;334;Moiron;129;5;134
27;Bourgogne-Franche-Comté;39;1;02;335;Moissey;565;11;576
27;Bourgogne-Franche-Comté;39;1;12;336;Molain;107;4;111
27;Bourgogne-Franche-Comté;39;1;01;337;Molamboz;89;3;92
27;Bourgogne-Franche-Comté;39;1;17;338;Molay;499;6;505
27;Bourgogne-Franche-Comté;39;1;03;342;Monay;123;1;124
27;Bourgogne-Franche-Comté;39;2;04;344;Monnet-la-Ville;339;14;353
27;Bourgogne-Franche-Comté;39;2;13;343;Monnetay;14;1;15
27;Bourgogne-Franche-Comté;39;1;05;345;Monnières;414;16;430
27;Bourgogne-Franche-Comté;39;1;10;365;Mont-sous-Vaudrey;1277;22;1299
27;Bourgogne-Franche-Comté;39;2;04;366;Mont-sur-Monnet;246;6;252
27;Bourgogne-Franche-Comté;39;2;13;346;Montagna-le-Reconduit;117;5;122
27;Bourgogne-Franche-Comté;39;2;12;348;Montaigu;422;47;469
27;Bourgogne-Franche-Comté;39;2;12;349;Montain;499;23;522
27;Bourgogne-Franche-Comté;39;1;10;350;Montbarrey;313;4;317
27;Bourgogne-Franche-Comté;39;3;09;351;Montcusel;149;7;156
27;Bourgogne-Franche-Comté;39;1;10;352;Monteplain;131;2;133
27;Bourgogne-Franche-Comté;39;2;13;353;Montfleur;174;9;183
27;Bourgogne-Franche-Comté;39;1;03;354;Montholier;365;3;368
27;Bourgogne-Franche-Comté;39;1;01;355;Montigny-lès-Arsures;243;8;251
27;Bourgogne-Franche-Comté;39;2;04;356;Montigny-sur-l'Ain;201;8;209
27;Bourgogne-Franche-Comté;39;2;13;273;Montlainsia ;245;7;252
27;Bourgogne-Franche-Comté;39;1;01;359;Montmarlon;31;1;32
27;Bourgogne-Franche-Comté;39;1;02;360;Montmirey-la-Ville;174;2;176
27;Bourgogne-Franche-Comté;39;1;02;361;Montmirey-le-Château;196;5;201
27;Bourgogne-Franche-Comté;39;2;07;362;Montmorot;3055;331;3386
27;Bourgogne-Franche-Comté;39;2;13;363;Montrevel;87;1;88
27;Bourgogne-Franche-Comté;39;2;04;364;Montrond;492;14;506
27;Bourgogne-Franche-Comté;39;3;11;367;Morbier;2278;96;2374
27;Bourgogne-Franche-Comté;39;1;10;370;Mouchard;1082;313;1395
27;Bourgogne-Franche-Comté;39;2;15;372;Mournans-Charbonny;85;9;94
27;Bourgogne-Franche-Comté;39;3;16;373;Les Moussières;164;4;168
27;Bourgogne-Franche-Comté;39;2;09;375;Moutonne;132;0;132
27;Bourgogne-Franche-Comté;39;2;04;376;Moutoux;74;2;76
27;Bourgogne-Franche-Comté;39;1;02;377;Mutigney;172;8;180
27;Bourgogne-Franche-Comté;39;2;03;379;Nance;520;11;531
27;Bourgogne-Franche-Comté;39;3;  ;130;Nanchez ;810;22;832
27;Bourgogne-Franche-Comté;39;2;09;380;Nancuise;46;2;48
27;Bourgogne-Franche-Comté;39;2;04;381;Les Nans;94;3;97
27;Bourgogne-Franche-Comté;39;1;17;385;Neublans-Abergement;543;5;548
27;Bourgogne-Franche-Comté;39;1;03;386;Neuvilley;85;0;85
27;Bourgogne-Franche-Comté;39;1;10;387;Nevy-lès-Dole;288;6;294
27;Bourgogne-Franche-Comté;39;2;12;388;Nevy-sur-Seille;199;8;207
27;Bourgogne-Franche-Comté;39;2;04;389;Ney;581;14;595
27;Bourgogne-Franche-Comté;39;2;12;390;Nogna;295;12;307
27;Bourgogne-Franche-Comté;39;2;15;391;Nozeroy;423;13;436
27;Bourgogne-Franche-Comté;39;1;02;392;Offlanges;198;3;201
27;Bourgogne-Franche-Comté;39;2;15;393;Onglières;64;2;66
27;Bourgogne-Franche-Comté;39;2;09;394;Onoz;71;4;75
27;Bourgogne-Franche-Comté;39;1;10;396;Orchamps;1132;16;1148
27;Bourgogne-Franche-Comté;39;2;09;397;Orgelet;1605;45;1650
27;Bourgogne-Franche-Comté;39;1;02;398;Ougney;385;3;388
27;Bourgogne-Franche-Comté;39;1;10;399;Ounans;359;8;367
27;Bourgogne-Franche-Comté;39;1;10;400;Our;142;2;144
27;Bourgogne-Franche-Comté;39;1;03;401;Oussières;237;5;242
27;Bourgogne-Franche-Comté;39;1;02;402;Pagney;318;7;325
27;Bourgogne-Franche-Comté;39;1;10;403;Pagnoz;225;5;230
27;Bourgogne-Franche-Comté;39;2;12;404;Pannessières;486;10;496
27;Bourgogne-Franche-Comté;39;1;06;405;Parcey;986;21;1007
27;Bourgogne-Franche-Comté;39;2;04;406;Le Pasquier;257;3;260
27;Bourgogne-Franche-Comté;39;2;03;407;Passenans;340;6;346
27;Bourgogne-Franche-Comté;39;2;15;408;Patornay;145;6;151
27;Bourgogne-Franche-Comté;39;1;02;409;Peintre;130;1;131
27;Bourgogne-Franche-Comté;39;2;12;411;Perrigny;1521;46;1567
27;Bourgogne-Franche-Comté;39;1;17;412;Peseux;319;2;321
27;Bourgogne-Franche-Comté;39;3;16;413;La Pesse;337;7;344
27;Bourgogne-Franche-Comté;39;1;17;415;Petit-Noir;1100;10;1110
27;Bourgogne-Franche-Comté;39;1;12;418;Picarreau;100;2;102
27;Bourgogne-Franche-Comté;39;2;04;419;Pillemoine;60;1;61
27;Bourgogne-Franche-Comté;39;2;09;420;Pimorin;204;3;207
27;Bourgogne-Franche-Comté;39;2;12;421;Le Pin;239;15;254
27;Bourgogne-Franche-Comté;39;2;12;422;Plainoiseau;531;13;544
27;Bourgogne-Franche-Comté;39;2;09;423;Plaisia;107;9;116
27;Bourgogne-Franche-Comté;39;2;15;424;Les Planches-en-Montagne;162;3;165
27;Bourgogne-Franche-Comté;39;1;01;425;Les Planches-près-Arbois;91;1;92
27;Bourgogne-Franche-Comté;39;1;03;426;Plasne;216;10;226
27;Bourgogne-Franche-Comté;39;2;15;427;Plénise;63;0;63
27;Bourgogne-Franche-Comté;39;2;15;428;Plénisette;24;3;27
27;Bourgogne-Franche-Comté;39;1;17;429;Pleure;437;3;440
27;Bourgogne-Franche-Comté;39;1;10;430;Plumont;103;2;105
27;Bourgogne-Franche-Comté;39;2;12;431;Poids-de-Fiole;335;4;339
27;Bourgogne-Franche-Comté;39;1;02;432;Pointre;126;1;127
27;Bourgogne-Franche-Comté;39;1;12;434;Poligny;4025;384;4409
27;Bourgogne-Franche-Comté;39;1;01;436;Pont-d'Héry;231;8;239
27;Bourgogne-Franche-Comté;39;2;15;435;Pont-de-Poitte;638;22;660
27;Bourgogne-Franche-Comté;39;2;04;437;Pont-du-Navoy;275;5;280
27;Bourgogne-Franche-Comté;39;1;10;439;Port-Lesney;526;12;538
27;Bourgogne-Franche-Comté;39;3;11;441;Prémanon;1193;31;1224
27;Bourgogne-Franche-Comté;39;2;09;443;Présilly;127;5;132
27;Bourgogne-Franche-Comté;39;1;01;444;Pretin;61;2;63
27;Bourgogne-Franche-Comté;39;2;12;445;Publy;284;15;299
27;Bourgogne-Franche-Comté;39;1;01;446;Pupillin;241;3;244
27;Bourgogne-Franche-Comté;39;2;03;447;Quintigny;252;6;258
27;Bourgogne-Franche-Comté;39;1;17;448;Rahon;492;16;508
27;Bourgogne-Franche-Comté;39;1;02;449;Rainans;267;10;277
27;Bourgogne-Franche-Comté;39;1;10;451;Ranchot;499;4;503
27;Bourgogne-Franche-Comté;39;1;10;452;Rans;534;7;541
27;Bourgogne-Franche-Comté;39;3;14;453;Ravilloles;465;12;477
27;Bourgogne-Franche-Comté;39;2;03;454;Recanoz;91;2;93
27;Bourgogne-Franche-Comté;39;2;09;455;Reithouse;56;1;57
27;Bourgogne-Franche-Comté;39;2;03;456;Relans;342;4;346
27;Bourgogne-Franche-Comté;39;2;03;457;Les Repôts;51;0;51
27;Bourgogne-Franche-Comté;39;2;12;458;Revigny;246;15;261
27;Bourgogne-Franche-Comté;39;2;15;461;Rix;80;0;80
27;Bourgogne-Franche-Comté;39;3;14;460;La Rixouse;193;8;201
27;Bourgogne-Franche-Comté;39;1;02;462;Rochefort-sur-Nenon;679;5;684
27;Bourgogne-Franche-Comté;39;3;16;463;Rogna;228;6;234
27;Bourgogne-Franche-Comté;39;1;02;464;Romain;210;6;216
27;Bourgogne-Franche-Comté;39;1;02;465;Romange;200;2;202
27;Bourgogne-Franche-Comté;39;2;13;466;Rosay;125;0;125
27;Bourgogne-Franche-Comté;39;2;13;467;Rotalier;158;6;164
27;Bourgogne-Franche-Comté;39;2;09;468;Rothonay;136;4;140
27;Bourgogne-Franche-Comté;39;1;02;469;Rouffange;113;2;115
27;Bourgogne-Franche-Comté;39;3;11;470;Les Rousses;3640;81;3721
27;Bourgogne-Franche-Comté;39;2;03;471;Ruffey-sur-Seille;747;17;764
27;Bourgogne-Franche-Comté;39;2;03;472;Rye;215;4;219
27;Bourgogne-Franche-Comté;39;2;15;473;Saffloz;96;2;98
27;Bourgogne-Franche-Comté;39;2;13;475;Saint-Amour;2385;103;2488
27;Bourgogne-Franche-Comté;39;1;17;476;Saint-Aubin;1801;43;1844
27;Bourgogne-Franche-Comté;39;1;17;477;Saint-Baraing;260;5;265
27;Bourgogne-Franche-Comté;39;3;14;478;Saint-Claude;9103;242;9345
27;Bourgogne-Franche-Comté;39;1;01;479;Saint-Cyr-Montmalin;242;6;248
27;Bourgogne-Franche-Comté;39;2;07;480;Saint-Didier;263;14;277
27;Bourgogne-Franche-Comté;39;2;04;481;Saint-Germain-en-Montagne;400;9;409
27;Bourgogne-Franche-Comté;39;2;09;137;Saint-Hymetière-sur-Valouse ;438;15;453
27;Bourgogne-Franche-Comté;39;2;03;486;Saint-Lamain;114;4;118
27;Bourgogne-Franche-Comté;39;3;15;487;Saint-Laurent-en-Grandvaux;1807;36;1843
27;Bourgogne-Franche-Comté;39;1;03;489;Saint-Lothain;466;11;477
27;Bourgogne-Franche-Comté;39;1;17;490;Saint-Loup;261;7;268
27;Bourgogne-Franche-Comté;39;2;12;492;Saint-Maur;234;3;237
27;Bourgogne-Franche-Comté;39;2;15;493;Saint-Maurice-Crillat;239;2;241
27;Bourgogne-Franche-Comté;39;3;15;494;Saint-Pierre;351;20;371
27;Bourgogne-Franche-Comté;39;1;01;495;Saint-Thiébaud;62;0;62
27;Bourgogne-Franche-Comté;39;2;13;474;Sainte-Agnès;356;10;366
27;Bourgogne-Franche-Comté;39;1;01;497;Saizenay;94;2;96
27;Bourgogne-Franche-Comté;39;1;10;498;Salans;603;11;614
27;Bourgogne-Franche-Comté;39;1;02;499;Saligney;188;3;191
27;Bourgogne-Franche-Comté;39;1;01;500;Salins-les-Bains;2567;150;2717
27;Bourgogne-Franche-Comté;39;1;05;501;Sampans;1182;12;1194
27;Bourgogne-Franche-Comté;39;1;10;502;Santans;289;7;296
27;Bourgogne-Franche-Comté;39;2;04;503;Sapois;379;15;394
27;Bourgogne-Franche-Comté;39;2;09;504;Sarrogna;227;9;236
27;Bourgogne-Franche-Comté;39;2;15;505;Saugeot;64;3;67
27;Bourgogne-Franche-Comté;39;1;17;507;Séligney;78;1;79
27;Bourgogne-Franche-Comté;39;2;03;508;Sellières;731;10;741
27;Bourgogne-Franche-Comté;39;3;16;510;Septmoncel les Molunes;814;24;838
27;Bourgogne-Franche-Comté;39;2;03;511;Sergenaux;64;3;67
27;Bourgogne-Franche-Comté;39;2;03;512;Sergenon;51;1;52
27;Bourgogne-Franche-Comté;39;1;02;513;Sermange;242;1;243
27;Bourgogne-Franche-Comté;39;1;02;514;Serre-les-Moulières;191;11;202
27;Bourgogne-Franche-Comté;39;2;04;517;Sirod;522;20;542
27;Bourgogne-Franche-Comté;39;2;15;518;Songeson;69;1;70
27;Bourgogne-Franche-Comté;39;2;15;519;Soucia;182;6;188
27;Bourgogne-Franche-Comté;39;1;10;520;Souvans;480;5;485
27;Bourgogne-Franche-Comté;39;2;04;522;Supt;103;2;105
27;Bourgogne-Franche-Comté;39;2;04;523;Syam;189;8;197
27;Bourgogne-Franche-Comté;39;1;17;525;Tassenières;394;7;401
27;Bourgogne-Franche-Comté;39;1;17;526;Tavaux;3938;96;4034
27;Bourgogne-Franche-Comté;39;1;02;527;Taxenne;114;1;115
27;Bourgogne-Franche-Comté;39;1;02;528;Thervay;384;7;391
27;Bourgogne-Franche-Comté;39;1;01;529;Thésy;66;1;67
27;Bourgogne-Franche-Comté;39;2;09;530;Thoirette-Coisia;861;24;885
27;Bourgogne-Franche-Comté;39;2;15;531;Thoiria;185;5;190
27;Bourgogne-Franche-Comté;39;2;13;532;Thoissia;37;1;38
27;Bourgogne-Franche-Comté;39;2;03;533;Toulouse-le-Château;219;6;225
27;Bourgogne-Franche-Comté;39;2;09;534;La Tour-du-Meix;239;4;243
27;Bourgogne-Franche-Comté;39;1;03;535;Tourmont;467;16;483
27;Bourgogne-Franche-Comté;39;2;  ;537;Trenal ;458;12;470
27;Bourgogne-Franche-Comté;39;2;13;378;Les Trois-Châteaux;764;15;779
27;Bourgogne-Franche-Comté;39;2;15;538;Uxelles;57;1;58
27;Bourgogne-Franche-Comté;39;1;01;539;Vadans;282;7;289
27;Bourgogne-Franche-Comté;39;2;13;209;Val-d'Épy;334;7;341
27;Bourgogne-Franche-Comté;39;2;13;576;Val-Sonnette;920;34;954
27;Bourgogne-Franche-Comté;39;2;13;485;Val Suran;787;13;800
27;Bourgogne-Franche-Comté;39;2;04;540;Valempoulières;193;11;204
27;Bourgogne-Franche-Comté;39;2;09;290;Valzin en Petite Montagne;487;17;504
27;Bourgogne-Franche-Comté;39;2;04;543;Vannoz;212;8;220
27;Bourgogne-Franche-Comté;39;2;04;545;Le Vaudioux;174;7;181
27;Bourgogne-Franche-Comté;39;1;10;546;Vaudrey;357;13;370
27;Bourgogne-Franche-Comté;39;3;16;547;Vaux-lès-Saint-Claude;687;18;705
27;Bourgogne-Franche-Comté;39;1;12;548;Vaux-sur-Poligny;76;5;81
27;Bourgogne-Franche-Comté;39;2;12;550;Verges;191;5;196
27;Bourgogne-Franche-Comté;39;2;13;551;Véria;118;3;121
27;Bourgogne-Franche-Comté;39;2;08;552;Vernantois;315;11;326
27;Bourgogne-Franche-Comté;39;2;12;553;Le Vernois;300;10;310
27;Bourgogne-Franche-Comté;39;2;04;554;Vers-en-Montagne;229;5;234
27;Bourgogne-Franche-Comté;39;2;03;555;Vers-sous-Sellières;243;2;245
27;Bourgogne-Franche-Comté;39;2;15;556;Vertamboz;95;3;98
27;Bourgogne-Franche-Comté;39;2;09;557;Vescles;190;9;199
27;Bourgogne-Franche-Comté;39;2;12;558;Vevy;284;12;296
27;Bourgogne-Franche-Comté;39;1;10;559;La Vieille-Loye;399;4;403
27;Bourgogne-Franche-Comté;39;3;16;560;Villard-Saint-Sauveur;614;20;634
27;Bourgogne-Franche-Comté;39;3;09;561;Villards-d'Héria;393;6;399
27;Bourgogne-Franche-Comté;39;1;10;565;Villeneuve-d'Aval;88;1;89
27;Bourgogne-Franche-Comté;39;2;07;567;Villeneuve-sous-Pymont;296;9;305
27;Bourgogne-Franche-Comté;39;1;10;569;Villers-Farlay;672;10;682
27;Bourgogne-Franche-Comté;39;1;03;570;Villers-les-Bois;215;1;216
27;Bourgogne-Franche-Comté;39;1;17;571;Villers-Robert;232;2;234
27;Bourgogne-Franche-Comté;39;1;03;568;Villerserine;47;3;50
27;Bourgogne-Franche-Comté;39;1;01;572;Villette-lès-Arbois;390;7;397
27;Bourgogne-Franche-Comté;39;1;06;573;Villette-lès-Dole;776;13;789
27;Bourgogne-Franche-Comté;39;2;03;574;Villevieux;709;20;729
27;Bourgogne-Franche-Comté;39;2;03;575;Le Villey;88;0;88
27;Bourgogne-Franche-Comté;39;2;03;577;Vincent-Froideville ;397;2;399
27;Bourgogne-Franche-Comté;39;3;16;579;Viry;917;42;959
27;Bourgogne-Franche-Comté;39;1;02;581;Vitreux;283;4;287
27;Bourgogne-Franche-Comté;39;2;12;582;Voiteur;756;22;778
27;Bourgogne-Franche-Comté;39;2;09;583;Vosbles-Valfin;185;6;191
27;Bourgogne-Franche-Comté;39;1;02;584;Vriange;159;2;161
27;Bourgogne-Franche-Comté;39;3;16;585;Vulvoz;21;0;21
75;Nouvelle-Aquitaine;40;2;01;001;Aire-sur-l'Adour;6119;554;6673
75;Nouvelle-Aquitaine;40;1;04;002;Amou;1550;23;1573
75;Nouvelle-Aquitaine;40;1;05;003;Angoumé;278;9;287
75;Nouvelle-Aquitaine;40;1;09;004;Angresse;2065;47;2112
75;Nouvelle-Aquitaine;40;2;02;005;Arboucave;202;3;205
75;Nouvelle-Aquitaine;40;2;13;006;Arengosse;691;7;698
75;Nouvelle-Aquitaine;40;1;04;007;Argelos;165;2;167
75;Nouvelle-Aquitaine;40;2;08;008;Argelouse;97;2;99
75;Nouvelle-Aquitaine;40;1;04;011;Arsague;336;3;339
75;Nouvelle-Aquitaine;40;2;01;012;Artassenx;254;4;258
75;Nouvelle-Aquitaine;40;2;01;013;Arthez-d'Armagnac;106;5;111
75;Nouvelle-Aquitaine;40;2;08;014;Arue;353;4;357
75;Nouvelle-Aquitaine;40;2;08;015;Arx;50;1;51
75;Nouvelle-Aquitaine;40;2;02;016;Aubagnan;255;3;258
75;Nouvelle-Aquitaine;40;2;02;017;Audignon;395;1;396
75;Nouvelle-Aquitaine;40;1;13;018;Audon;378;6;384
75;Nouvelle-Aquitaine;40;2;03;019;Aureilhan;1071;28;1099
75;Nouvelle-Aquitaine;40;2;02;020;Aurice;614;23;637
75;Nouvelle-Aquitaine;40;1;09;021;Azur;863;19;882
75;Nouvelle-Aquitaine;40;2;01;022;Bahus-Soubiran;402;14;416
75;Nouvelle-Aquitaine;40;1;04;023;Baigts;357;8;365
75;Nouvelle-Aquitaine;40;2;02;024;Banos;268;4;272
75;Nouvelle-Aquitaine;40;2;02;026;Bas-Mauco;361;10;371
75;Nouvelle-Aquitaine;40;2;01;025;Bascons;840;31;871
75;Nouvelle-Aquitaine;40;1;04;027;Bassercles;154;2;156
75;Nouvelle-Aquitaine;40;1;04;028;Bastennes;253;9;262
75;Nouvelle-Aquitaine;40;2;02;029;Bats;312;3;315
75;Nouvelle-Aquitaine;40;2;08;030;Baudignan;52;0;52
75;Nouvelle-Aquitaine;40;1;13;031;Bégaar;1177;12;1189
75;Nouvelle-Aquitaine;40;2;07;032;Belhade;203;1;204
75;Nouvelle-Aquitaine;40;2;08;033;Bélis;166;5;171
75;Nouvelle-Aquitaine;40;1;12;034;Bélus;605;13;618
75;Nouvelle-Aquitaine;40;1;06;035;Bénesse-lès-Dax;531;10;541
75;Nouvelle-Aquitaine;40;1;14;036;Bénesse-Maremne;3459;66;3525
75;Nouvelle-Aquitaine;40;2;11;037;Benquet;1782;45;1827
75;Nouvelle-Aquitaine;40;1;04;038;Bergouey;101;4;105
75;Nouvelle-Aquitaine;40;2;08;039;Betbezer-d'Armagnac;150;0;150
75;Nouvelle-Aquitaine;40;1;13;040;Beylongue;360;2;362
75;Nouvelle-Aquitaine;40;1;04;041;Beyries;128;2;130
75;Nouvelle-Aquitaine;40;1;15;042;Biarrotte;308;7;315
75;Nouvelle-Aquitaine;40;2;03;043;Bias;761;13;774
75;Nouvelle-Aquitaine;40;1;15;044;Biaudos;907;32;939
75;Nouvelle-Aquitaine;40;2;07;046;Biscarrosse;13946;346;14292
75;Nouvelle-Aquitaine;40;1;04;047;Bonnegarde;271;5;276
75;Nouvelle-Aquitaine;40;2;01;049;Bordères-et-Lamensans;392;6;398
75;Nouvelle-Aquitaine;40;2;10;050;Bostens;208;2;210
75;Nouvelle-Aquitaine;40;2;11;051;Bougue;792;24;816
75;Nouvelle-Aquitaine;40;2;01;052;Bourdalat;238;5;243
75;Nouvelle-Aquitaine;40;2;08;053;Bourriot-Bergonce;308;4;312
75;Nouvelle-Aquitaine;40;1;04;054;Brassempouy;264;6;270
75;Nouvelle-Aquitaine;40;2;11;055;Bretagne-de-Marsan;1571;28;1599
75;Nouvelle-Aquitaine;40;2;08;056;Brocas;785;22;807
75;Nouvelle-Aquitaine;40;2;01;057;Buanes;256;6;262
75;Nouvelle-Aquitaine;40;2;08;058;Cachen;227;11;238
75;Nouvelle-Aquitaine;40;1;12;059;Cagnotte;762;20;782
75;Nouvelle-Aquitaine;40;2;08;060;Callen;143;4;147
75;Nouvelle-Aquitaine;40;2;11;061;Campagne;986;26;1012
75;Nouvelle-Aquitaine;40;2;10;062;Campet-et-Lamolère;480;7;487
75;Nouvelle-Aquitaine;40;1;06;063;Candresse;805;27;832
75;Nouvelle-Aquitaine;40;2;08;064;Canenx-et-Réaut;162;2;164
75;Nouvelle-Aquitaine;40;1;14;065;Capbreton;8892;311;9203
75;Nouvelle-Aquitaine;40;1;13;066;Carcarès-Sainte-Croix;525;4;529
75;Nouvelle-Aquitaine;40;1;13;067;Carcen-Ponson;633;5;638
75;Nouvelle-Aquitaine;40;1;04;068;Cassen;578;17;595
75;Nouvelle-Aquitaine;40;1;04;069;Castaignos-Souslens;401;5;406
75;Nouvelle-Aquitaine;40;2;01;070;Castandet;395;17;412
75;Nouvelle-Aquitaine;40;1;04;074;Castel-Sarrazin;550;20;570
75;Nouvelle-Aquitaine;40;1;04;071;Castelnau-Chalosse;600;43;643
75;Nouvelle-Aquitaine;40;2;02;072;Castelnau-Tursan;189;2;191
75;Nouvelle-Aquitaine;40;2;02;073;Castelner;111;2;113
75;Nouvelle-Aquitaine;40;1;03;075;Castets;2425;26;2451
75;Nouvelle-Aquitaine;40;2;02;076;Cauna;445;7;452
75;Nouvelle-Aquitaine;40;1;12;077;Cauneille;799;17;816
75;Nouvelle-Aquitaine;40;1;04;078;Caupenne;395;8;403
75;Nouvelle-Aquitaine;40;2;02;079;Cazalis;135;4;139
75;Nouvelle-Aquitaine;40;2;01;080;Cazères-sur-l'Adour;1092;31;1123
75;Nouvelle-Aquitaine;40;2;08;081;Cère;412;6;418
75;Nouvelle-Aquitaine;40;2;01;082;Classun;265;8;273
75;Nouvelle-Aquitaine;40;2;02;083;Clèdes;125;7;132
75;Nouvelle-Aquitaine;40;1;04;084;Clermont;764;36;800
75;Nouvelle-Aquitaine;40;2;08;085;Commensacq;425;12;437
75;Nouvelle-Aquitaine;40;2;02;086;Coudures;479;8;487
75;Nouvelle-Aquitaine;40;2;08;087;Créon-d'Armagnac;362;7;369
75;Nouvelle-Aquitaine;40;1;98;088;Dax;20762;842;21604
75;Nouvelle-Aquitaine;40;1;04;089;Doazit;857;27;884
75;Nouvelle-Aquitaine;40;1;04;090;Donzacq;473;10;483
75;Nouvelle-Aquitaine;40;2;01;091;Duhort-Bachen;659;19;678
75;Nouvelle-Aquitaine;40;2;02;092;Dumes;234;6;240
75;Nouvelle-Aquitaine;40;2;08;093;Escalans;255;3;258
75;Nouvelle-Aquitaine;40;2;08;094;Escource;727;11;738
75;Nouvelle-Aquitaine;40;1;12;095;Estibeaux;699;18;717
75;Nouvelle-Aquitaine;40;2;08;096;Estigarde;113;2;115
75;Nouvelle-Aquitaine;40;2;01;097;Eugénie-les-Bains;451;10;461
75;Nouvelle-Aquitaine;40;2;02;098;Eyres-Moncube;360;13;373
75;Nouvelle-Aquitaine;40;2;02;099;Fargues;325;3;328
75;Nouvelle-Aquitaine;40;2;01;100;Le Frêche;409;2;411
75;Nouvelle-Aquitaine;40;1;12;101;Gaas;486;18;504
75;Nouvelle-Aquitaine;40;2;08;102;Gabarret;1288;246;1534
75;Nouvelle-Aquitaine;40;2;10;103;Gaillères;622;16;638
75;Nouvelle-Aquitaine;40;1;04;104;Gamarde-les-Bains;1365;33;1398
75;Nouvelle-Aquitaine;40;2;08;105;Garein;436;11;447
75;Nouvelle-Aquitaine;40;1;04;106;Garrey;206;6;212
75;Nouvelle-Aquitaine;40;2;07;108;Gastes;842;14;856
75;Nouvelle-Aquitaine;40;1;04;109;Gaujacq;432;10;442
75;Nouvelle-Aquitaine;40;2;02;110;Geaune;695;14;709
75;Nouvelle-Aquitaine;40;2;10;111;Geloux;694;16;710
75;Nouvelle-Aquitaine;40;1;04;112;Gibret;101;1;102
75;Nouvelle-Aquitaine;40;1;04;113;Goos;515;9;524
75;Nouvelle-Aquitaine;40;1;05;114;Gourbera;368;13;381
75;Nouvelle-Aquitaine;40;1;04;115;Gousse;301;10;311
75;Nouvelle-Aquitaine;40;1;13;116;Gouts;274;3;277
75;Nouvelle-Aquitaine;40;2;01;117;Grenade-sur-l'Adour;2456;82;2538
75;Nouvelle-Aquitaine;40;1;12;118;Habas;1484;25;1509
75;Nouvelle-Aquitaine;40;2;02;119;Hagetmau;4671;115;4786
75;Nouvelle-Aquitaine;40;1;12;120;Hastingues;586;17;603
75;Nouvelle-Aquitaine;40;1;04;121;Hauriet;277;5;282
75;Nouvelle-Aquitaine;40;2;02;122;Haut-Mauco;959;29;988
75;Nouvelle-Aquitaine;40;1;05;123;Herm;1142;33;1175
75;Nouvelle-Aquitaine;40;2;08;124;Herré;141;2;143
75;Nouvelle-Aquitaine;40;1;06;125;Heugas;1347;37;1384
75;Nouvelle-Aquitaine;40;1;04;126;Hinx;1879;42;1921
75;Nouvelle-Aquitaine;40;2;01;127;Hontanx;606;4;610
75;Nouvelle-Aquitaine;40;2;02;128;Horsarrieu;686;20;706
75;Nouvelle-Aquitaine;40;1;14;129;Josse;847;26;873
75;Nouvelle-Aquitaine;40;2;02;130;Labastide-Chalosse;153;0;153
75;Nouvelle-Aquitaine;40;2;08;131;Labastide-d'Armagnac;689;5;694
75;Nouvelle-Aquitaine;40;1;12;132;Labatut;1424;25;1449
75;Nouvelle-Aquitaine;40;1;14;133;Labenne;6717;112;6829
75;Nouvelle-Aquitaine;40;2;08;134;Labouheyre;2739;44;2783
75;Nouvelle-Aquitaine;40;2;08;135;Labrit;861;8;869
75;Nouvelle-Aquitaine;40;2;02;136;Lacajunte;156;4;160
75;Nouvelle-Aquitaine;40;2;01;137;Lacquy;282;10;292
75;Nouvelle-Aquitaine;40;2;02;138;Lacrabe;274;6;280
75;Nouvelle-Aquitaine;40;2;11;139;Laglorieuse;551;15;566
75;Nouvelle-Aquitaine;40;2;08;140;Lagrange;187;3;190
75;Nouvelle-Aquitaine;40;1;04;141;Lahosse;306;4;310
75;Nouvelle-Aquitaine;40;1;13;142;Laluque;1033;20;1053
75;Nouvelle-Aquitaine;40;1;13;143;Lamothe;307;4;311
75;Nouvelle-Aquitaine;40;1;04;144;Larbey;243;9;252
75;Nouvelle-Aquitaine;40;2;01;145;Larrivière-Saint-Savin;636;23;659
75;Nouvelle-Aquitaine;40;2;01;146;Latrille;160;3;163
75;Nouvelle-Aquitaine;40;1;04;147;Laurède;379;3;382
75;Nouvelle-Aquitaine;40;2;02;148;Lauret;84;3;87
75;Nouvelle-Aquitaine;40;2;08;149;Lencouacq;378;5;383
75;Nouvelle-Aquitaine;40;1;03;150;Léon;1927;51;1978
75;Nouvelle-Aquitaine;40;1;13;151;Lesgor;435;12;447
75;Nouvelle-Aquitaine;40;2;13;152;Lesperon;1038;26;1064
75;Nouvelle-Aquitaine;40;1;13;153;Le Leuy;244;6;250
75;Nouvelle-Aquitaine;40;1;03;154;Lévignacq;313;6;319
75;Nouvelle-Aquitaine;40;1;03;155;Linxe;1490;38;1528
75;Nouvelle-Aquitaine;40;2;07;156;Liposthey;544;5;549
75;Nouvelle-Aquitaine;40;1;03;157;Lit-et-Mixe;1632;39;1671
75;Nouvelle-Aquitaine;40;2;08;158;Losse;276;3;279
75;Nouvelle-Aquitaine;40;1;04;159;Louer;307;7;314
75;Nouvelle-Aquitaine;40;1;04;160;Lourquen;180;6;186
75;Nouvelle-Aquitaine;40;2;08;161;Lubbon;95;1;96
75;Nouvelle-Aquitaine;40;2;10;162;Lucbardez-et-Bargues;581;13;594
75;Nouvelle-Aquitaine;40;2;07;163;Lüe;564;10;574
75;Nouvelle-Aquitaine;40;2;08;165;Luglon;393;11;404
75;Nouvelle-Aquitaine;40;2;01;166;Lussagnet;74;1;75
75;Nouvelle-Aquitaine;40;2;08;167;Luxey;661;10;671
75;Nouvelle-Aquitaine;40;1;09;168;Magescq;2244;34;2278
75;Nouvelle-Aquitaine;40;2;08;169;Maillas;129;3;132
75;Nouvelle-Aquitaine;40;2;08;170;Maillères;239;3;242
75;Nouvelle-Aquitaine;40;2;07;171;Mano;120;3;123
75;Nouvelle-Aquitaine;40;2;02;172;Mant;268;4;272
75;Nouvelle-Aquitaine;40;1;04;173;Marpaps;140;5;145
75;Nouvelle-Aquitaine;40;2;02;174;Mauries;88;1;89
75;Nouvelle-Aquitaine;40;2;01;175;Maurrin;438;6;444
75;Nouvelle-Aquitaine;40;2;08;176;Mauvezin-d'Armagnac;90;1;91
75;Nouvelle-Aquitaine;40;1;04;177;Maylis;314;17;331
75;Nouvelle-Aquitaine;40;2;11;178;Mazerolles;625;27;652
75;Nouvelle-Aquitaine;40;1;05;179;Mées;1818;46;1864
75;Nouvelle-Aquitaine;40;1;13;180;Meilhan;1147;30;1177
75;Nouvelle-Aquitaine;40;1;09;181;Messanges;972;31;1003
75;Nouvelle-Aquitaine;40;2;03;182;Mézos;824;11;835
75;Nouvelle-Aquitaine;40;1;12;183;Mimbaste;992;33;1025
75;Nouvelle-Aquitaine;40;2;03;184;Mimizan;7137;164;7301
75;Nouvelle-Aquitaine;40;2;02;185;Miramont-Sensacq;358;8;366
75;Nouvelle-Aquitaine;40;1;12;186;Misson;796;17;813
75;Nouvelle-Aquitaine;40;1;09;187;Moliets-et-Maa;1179;16;1195
75;Nouvelle-Aquitaine;40;2;02;188;Momuy;461;12;473
75;Nouvelle-Aquitaine;40;2;02;189;Monget;87;3;90
75;Nouvelle-Aquitaine;40;2;02;190;Monségur;386;11;397
75;Nouvelle-Aquitaine;40;2;99;192;Mont-de-Marsan;29683;1420;31103
75;Nouvelle-Aquitaine;40;2;02;191;Montaut;617;13;630
75;Nouvelle-Aquitaine;40;2;01;193;Montégut;74;2;76
75;Nouvelle-Aquitaine;40;1;04;194;Montfort-en-Chalosse;1170;30;1200
75;Nouvelle-Aquitaine;40;2;02;195;Montgaillard;625;13;638
75;Nouvelle-Aquitaine;40;2;02;196;Montsoué;568;11;579
75;Nouvelle-Aquitaine;40;2;13;197;Morcenx-la-Nouvelle ;5022;132;5154
75;Nouvelle-Aquitaine;40;2;02;198;Morganx;173;8;181
75;Nouvelle-Aquitaine;40;1;12;199;Mouscardès;268;3;271
75;Nouvelle-Aquitaine;40;2;07;200;Moustey;684;11;695
75;Nouvelle-Aquitaine;40;1;04;201;Mugron;1352;103;1455
75;Nouvelle-Aquitaine;40;1;06;202;Narrosse;3217;74;3291
75;Nouvelle-Aquitaine;40;1;04;203;Nassiet;335;13;348
75;Nouvelle-Aquitaine;40;1;04;204;Nerbis;266;4;270
75;Nouvelle-Aquitaine;40;1;04;205;Nousse;247;8;255
75;Nouvelle-Aquitaine;40;1;12;206;Oeyregave;334;13;347
75;Nouvelle-Aquitaine;40;1;06;207;Oeyreluy;1507;219;1726
75;Nouvelle-Aquitaine;40;1;04;208;Onard;368;6;374
75;Nouvelle-Aquitaine;40;1;15;209;Ondres;5356;117;5473
75;Nouvelle-Aquitaine;40;2;13;210;Onesse-Laharie;1018;19;1037
75;Nouvelle-Aquitaine;40;1;12;211;Orist;737;18;755
75;Nouvelle-Aquitaine;40;1;12;212;Orthevielle;961;16;977
75;Nouvelle-Aquitaine;40;1;14;213;Orx;625;10;635
75;Nouvelle-Aquitaine;40;1;12;214;Ossages;502;5;507
75;Nouvelle-Aquitaine;40;2;13;215;Ousse-Suzan;281;8;289
75;Nouvelle-Aquitaine;40;1;04;216;Ozourt;202;2;204
75;Nouvelle-Aquitaine;40;2;07;217;Parentis-en-Born;6466;211;6677
75;Nouvelle-Aquitaine;40;2;08;218;Parleboscq;506;4;510
75;Nouvelle-Aquitaine;40;2;02;219;Payros-Cazautets;107;2;109
75;Nouvelle-Aquitaine;40;2;02;220;Pécorade;140;6;146
75;Nouvelle-Aquitaine;40;2;01;221;Perquie;342;14;356
75;Nouvelle-Aquitaine;40;1;12;222;Pey;683;22;705
75;Nouvelle-Aquitaine;40;2;02;223;Peyre;236;8;244
75;Nouvelle-Aquitaine;40;1;12;224;Peyrehorade;3659;178;3837
75;Nouvelle-Aquitaine;40;2;02;225;Philondenx;202;6;208
75;Nouvelle-Aquitaine;40;2;02;226;Pimbo;209;3;212
75;Nouvelle-Aquitaine;40;2;07;227;Pissos;1445;20;1465
75;Nouvelle-Aquitaine;40;1;04;228;Pomarez;1558;27;1585
75;Nouvelle-Aquitaine;40;2;03;229;Pontenx-les-Forges;1633;32;1665
75;Nouvelle-Aquitaine;40;1;13;230;Pontonx-sur-l'Adour;2839;105;2944
75;Nouvelle-Aquitaine;40;1;12;231;Port-de-Lanne;1114;30;1144
75;Nouvelle-Aquitaine;40;2;02;232;Poudenx;223;10;233
75;Nouvelle-Aquitaine;40;1;12;233;Pouillon;3081;81;3162
75;Nouvelle-Aquitaine;40;2;10;234;Pouydesseaux;913;28;941
75;Nouvelle-Aquitaine;40;1;04;235;Poyanne;686;11;697
75;Nouvelle-Aquitaine;40;1;04;236;Poyartin;808;21;829
75;Nouvelle-Aquitaine;40;1;04;237;Préchacq-les-Bains;757;6;763
75;Nouvelle-Aquitaine;40;2;01;238;Pujo-le-Plan;623;19;642
75;Nouvelle-Aquitaine;40;2;02;239;Puyol-Cazalet;107;3;110
75;Nouvelle-Aquitaine;40;2;01;240;Renung;527;20;547
75;Nouvelle-Aquitaine;40;2;08;164;Retjons;353;1;354
75;Nouvelle-Aquitaine;40;2;08;242;Rimbez-et-Baudiets;105;0;105
75;Nouvelle-Aquitaine;40;1;13;243;Rion-des-Landes;3012;42;3054
75;Nouvelle-Aquitaine;40;1;05;244;Rivière-Saas-et-Gourby;1225;28;1253
75;Nouvelle-Aquitaine;40;2;08;245;Roquefort;1898;49;1947
75;Nouvelle-Aquitaine;40;2;08;246;Sabres;1170;150;1320
75;Nouvelle-Aquitaine;40;2;01;247;Saint-Agnet;181;6;187
75;Nouvelle-Aquitaine;40;1;15;248;Saint-André-de-Seignanx;1812;27;1839
75;Nouvelle-Aquitaine;40;1;04;249;Saint-Aubin;504;13;517
75;Nouvelle-Aquitaine;40;2;10;250;Saint-Avit;683;21;704
75;Nouvelle-Aquitaine;40;1;15;251;Saint-Barthélemy;421;14;435
75;Nouvelle-Aquitaine;40;2;02;253;Saint-Cricq-Chalosse;643;12;655
75;Nouvelle-Aquitaine;40;1;12;254;Saint-Cricq-du-Gave;425;11;436
75;Nouvelle-Aquitaine;40;2;01;255;Saint-Cricq-Villeneuve;478;11;489
75;Nouvelle-Aquitaine;40;1;12;256;Saint-Étienne-d'Orthe;705;17;722
75;Nouvelle-Aquitaine;40;2;01;259;Saint-Gein;434;13;447
75;Nouvelle-Aquitaine;40;1;04;260;Saint-Geours-d'Auribat;421;8;429
75;Nouvelle-Aquitaine;40;1;09;261;Saint-Geours-de-Maremne;2712;48;2760
75;Nouvelle-Aquitaine;40;2;08;262;Saint-Gor;307;6;313
75;Nouvelle-Aquitaine;40;1;04;263;Saint-Jean-de-Lier;414;8;422
75;Nouvelle-Aquitaine;40;1;14;264;Saint-Jean-de-Marsacq;1675;24;1699
75;Nouvelle-Aquitaine;40;2;08;265;Saint-Julien-d'Armagnac;110;0;110
75;Nouvelle-Aquitaine;40;1;03;266;Saint-Julien-en-Born;1672;34;1706
75;Nouvelle-Aquitaine;40;2;08;267;Saint-Justin;988;13;1001
75;Nouvelle-Aquitaine;40;1;15;268;Saint-Laurent-de-Gosse;671;21;692
75;Nouvelle-Aquitaine;40;1;12;269;Saint-Lon-les-Mines;1224;38;1262
75;Nouvelle-Aquitaine;40;2;01;270;Saint-Loubouer;443;14;457
75;Nouvelle-Aquitaine;40;2;10;274;Saint-Martin-d'Oney;1389;40;1429
75;Nouvelle-Aquitaine;40;1;14;272;Saint-Martin-de-Hinx;1552;38;1590
75;Nouvelle-Aquitaine;40;1;15;273;Saint-Martin-de-Seignanx;5632;128;5760
75;Nouvelle-Aquitaine;40;2;01;275;Saint-Maurice-sur-Adour;595;18;613
75;Nouvelle-Aquitaine;40;1;03;276;Saint-Michel-Escalus;311;8;319
75;Nouvelle-Aquitaine;40;1;06;277;Saint-Pandelon;716;49;765
75;Nouvelle-Aquitaine;40;2;03;278;Saint-Paul-en-Born;964;16;980
75;Nouvelle-Aquitaine;40;1;05;279;Saint-Paul-lès-Dax;13436;483;13919
75;Nouvelle-Aquitaine;40;2;11;280;Saint-Perdon;1733;32;1765
75;Nouvelle-Aquitaine;40;2;11;281;Saint-Pierre-du-Mont;9625;363;9988
75;Nouvelle-Aquitaine;40;2;02;282;Saint-Sever;4966;98;5064
75;Nouvelle-Aquitaine;40;1;05;283;Saint-Vincent-de-Paul;3165;222;3387
75;Nouvelle-Aquitaine;40;1;14;284;Saint-Vincent-de-Tyrosse;7669;259;7928
75;Nouvelle-Aquitaine;40;1;13;285;Saint-Yaguen;628;14;642
75;Nouvelle-Aquitaine;40;2;02;252;Sainte-Colombe;651;16;667
75;Nouvelle-Aquitaine;40;2;07;257;Sainte-Eulalie-en-Born;1264;20;1284
75;Nouvelle-Aquitaine;40;2;01;258;Sainte-Foy;257;3;260
75;Nouvelle-Aquitaine;40;1;14;271;Sainte-Marie-de-Gosse;1187;25;1212
75;Nouvelle-Aquitaine;40;2;02;286;Samadet;1165;22;1187
75;Nouvelle-Aquitaine;40;2;07;287;Sanguinet;4343;64;4407
75;Nouvelle-Aquitaine;40;2;08;288;Sarbazan;1167;22;1189
75;Nouvelle-Aquitaine;40;2;02;289;Sarraziet;244;1;245
75;Nouvelle-Aquitaine;40;2;01;290;Sarron;109;3;112
75;Nouvelle-Aquitaine;40;1;14;291;Saubion;1616;30;1646
75;Nouvelle-Aquitaine;40;1;14;292;Saubrigues;1455;75;1530
75;Nouvelle-Aquitaine;40;1;09;293;Saubusse;1113;23;1136
75;Nouvelle-Aquitaine;40;1;06;294;Saugnac-et-Cambran;1551;32;1583
75;Nouvelle-Aquitaine;40;2;07;295;Saugnacq-et-Muret;1072;18;1090
75;Nouvelle-Aquitaine;40;1;09;296;Seignosse;3874;95;3969
75;Nouvelle-Aquitaine;40;2;08;297;Le Sen;230;3;233
75;Nouvelle-Aquitaine;40;2;02;298;Serres-Gaston;395;14;409
75;Nouvelle-Aquitaine;40;2;02;299;Serreslous-et-Arribans;194;11;205
75;Nouvelle-Aquitaine;40;1;06;300;Seyresse;946;33;979
75;Nouvelle-Aquitaine;40;1;05;301;Siest;137;2;139
75;Nouvelle-Aquitaine;40;2;08;303;Solférino;323;2;325
75;Nouvelle-Aquitaine;40;1;09;304;Soorts-Hossegor;3459;85;3544
75;Nouvelle-Aquitaine;40;2;02;305;Sorbets;197;8;205
75;Nouvelle-Aquitaine;40;1;12;306;Sorde-l'Abbaye;626;13;639
75;Nouvelle-Aquitaine;40;2;08;307;Sore;1138;22;1160
75;Nouvelle-Aquitaine;40;1;04;308;Sort-en-Chalosse;924;28;952
75;Nouvelle-Aquitaine;40;1;13;309;Souprosse;1133;19;1152
75;Nouvelle-Aquitaine;40;1;09;310;Soustons;8056;195;8251
75;Nouvelle-Aquitaine;40;1;03;311;Taller;618;13;631
75;Nouvelle-Aquitaine;40;1;15;312;Tarnos;12498;288;12786
75;Nouvelle-Aquitaine;40;1;13;313;Tartas;3242;45;3287
75;Nouvelle-Aquitaine;40;1;05;314;Tercis-les-Bains;1242;39;1281
75;Nouvelle-Aquitaine;40;1;05;315;Téthieu;765;11;776
75;Nouvelle-Aquitaine;40;1;12;316;Tilh;824;19;843
75;Nouvelle-Aquitaine;40;1;09;317;Tosse;3119;77;3196
75;Nouvelle-Aquitaine;40;1;04;318;Toulouzette;325;6;331
75;Nouvelle-Aquitaine;40;2;08;319;Trensacq;242;4;246
75;Nouvelle-Aquitaine;40;2;10;320;Uchacq-et-Parentis;598;20;618
75;Nouvelle-Aquitaine;40;2;02;321;Urgons;247;9;256
75;Nouvelle-Aquitaine;40;1;03;322;Uza;196;2;198
75;Nouvelle-Aquitaine;40;2;08;323;Vert;262;5;267
75;Nouvelle-Aquitaine;40;1;04;324;Vicq-d'Auribat;261;10;271
75;Nouvelle-Aquitaine;40;1;03;326;Vielle-Saint-Girons;1362;33;1395
75;Nouvelle-Aquitaine;40;2;08;327;Vielle-Soubiran;227;5;232
75;Nouvelle-Aquitaine;40;2;01;325;Vielle-Tursan;264;11;275
75;Nouvelle-Aquitaine;40;1;09;328;Vieux-Boucau-les-Bains;1624;22;1646
75;Nouvelle-Aquitaine;40;2;01;329;Le Vignau;487;6;493
75;Nouvelle-Aquitaine;40;1;13;330;Villenave;321;6;327
75;Nouvelle-Aquitaine;40;2;01;331;Villeneuve-de-Marsan;2428;46;2474
75;Nouvelle-Aquitaine;40;2;07;332;Ychoux;2284;54;2338
75;Nouvelle-Aquitaine;40;2;13;333;Ygos-Saint-Saturnin;1329;26;1355
75;Nouvelle-Aquitaine;40;1;06;334;Yzosse;374;13;387
24;Centre-Val de Loire;41;2;06;001;Ambloy;188;5;193
24;Centre-Val de Loire;41;3;11;002;Angé;850;24;874
24;Centre-Val de Loire;41;2;14;003;Areines;605;228;833
24;Centre-Val de Loire;41;2;06;004;Artins;265;5;270
24;Centre-Val de Loire;41;1;01;006;Autainville;446;8;454
24;Centre-Val de Loire;41;2;06;007;Authon;726;13;739
24;Centre-Val de Loire;41;1;01;008;Avaray;734;16;750
24;Centre-Val de Loire;41;1;08;009;Averdon;692;15;707
24;Centre-Val de Loire;41;2;14;010;Azé;1014;29;1043
24;Centre-Val de Loire;41;2;09;012;Baillou;213;12;225
24;Centre-Val de Loire;41;1;05;013;Bauzy;275;5;280
24;Centre-Val de Loire;41;1;01;173;Beauce la Romaine ;3495;68;3563
24;Centre-Val de Loire;41;2;09;014;Beauchêne;164;2;166
24;Centre-Val de Loire;41;3;12;016;Billy;1024;10;1034
24;Centre-Val de Loire;41;1;01;017;Binas;666;17;683
24;Centre-Val de Loire;41;1;99;018;Blois;45871;1578;47449
24;Centre-Val de Loire;41;1;01;019;Boisseau;97;2;99
24;Centre-Val de Loire;41;2;09;020;Bonneveau;461;6;467
24;Centre-Val de Loire;41;2;09;022;Bouffry;133;1;134
24;Centre-Val de Loire;41;2;09;024;Boursay;171;7;178
24;Centre-Val de Loire;41;1;05;025;Bracieux;1304;18;1322
24;Centre-Val de Loire;41;2;09;026;Brévainville;173;4;177
24;Centre-Val de Loire;41;1;01;027;Briou;145;2;147
24;Centre-Val de Loire;41;2;09;028;Busloup;453;8;461
24;Centre-Val de Loire;41;1;04;029;Candé-sur-Beuvron;1500;25;1525
24;Centre-Val de Loire;41;2;09;030;Cellé;224;3;227
24;Centre-Val de Loire;41;1;15;031;Cellettes;2642;69;2711
24;Centre-Val de Loire;41;1;04;032;Chailles;2684;79;2763
24;Centre-Val de Loire;41;1;05;034;Chambord;93;1;94
24;Centre-Val de Loire;41;1;08;035;Champigny-en-Beauce;613;15;628
24;Centre-Val de Loire;41;3;13;036;Chaon;455;7;462
24;Centre-Val de Loire;41;2;09;037;La Chapelle-Enchérie;210;4;214
24;Centre-Val de Loire;41;3;12;038;La Chapelle-Montmartin;427;11;438
24;Centre-Val de Loire;41;1;01;039;La Chapelle-Saint-Martin-en-Plaine;715;21;736
24;Centre-Val de Loire;41;1;08;040;La Chapelle-Vendômoise;792;26;818
24;Centre-Val de Loire;41;2;09;041;La Chapelle-Vicomtesse;164;3;167
24;Centre-Val de Loire;41;3;11;042;Châteauvieux;534;4;538
24;Centre-Val de Loire;41;3;11;043;Châtillon-sur-Cher;1707;32;1739
24;Centre-Val de Loire;41;3;12;044;Châtres-sur-Cher;1103;10;1113
24;Centre-Val de Loire;41;1;04;045;Chaumont-sur-Loire;1082;10;1092
24;Centre-Val de Loire;41;3;13;046;Chaumont-sur-Tharonne;1076;15;1091
24;Centre-Val de Loire;41;1;03;047;La Chaussée-Saint-Victor;4530;117;4647
24;Centre-Val de Loire;41;2;09;048;Chauvigny-du-Perche;223;4;227
24;Centre-Val de Loire;41;3;11;049;Chémery;956;13;969
24;Centre-Val de Loire;41;1;15;050;Cheverny;929;39;968
24;Centre-Val de Loire;41;3;07;051;Chissay-en-Touraine;1103;28;1131
24;Centre-Val de Loire;41;1;15;052;Chitenay;1084;34;1118
24;Centre-Val de Loire;41;2;09;053;Choue;532;5;537
24;Centre-Val de Loire;41;3;07;054;Choussy;336;5;341
24;Centre-Val de Loire;41;1;01;057;Conan;172;0;172
24;Centre-Val de Loire;41;1;01;058;Concriers;180;5;185
24;Centre-Val de Loire;41;3;89;059;Controis-en-Sologne;6783;157;6940
24;Centre-Val de Loire;41;2;09;060;Cormenon;691;12;703
24;Centre-Val de Loire;41;1;15;061;Cormeray;1555;26;1581
24;Centre-Val de Loire;41;3;07;062;Couddes;548;7;555
24;Centre-Val de Loire;41;2;09;248;Couëtron-au-Perche;1052;24;1076
24;Centre-Val de Loire;41;3;11;063;Couffy;488;8;496
24;Centre-Val de Loire;41;2;06;065;Coulommiers-la-Tour;559;16;575
24;Centre-Val de Loire;41;1;15;067;Cour-Cheverny;2824;77;2901
24;Centre-Val de Loire;41;1;01;069;Cour-sur-Loire;258;6;264
24;Centre-Val de Loire;41;1;01;066;Courbouzon;434;10;444
24;Centre-Val de Loire;41;3;05;068;Courmemin;501;9;510
24;Centre-Val de Loire;41;1;05;071;Crouy-sur-Cosson;546;12;558
24;Centre-Val de Loire;41;2;06;072;Crucheray;390;16;406
24;Centre-Val de Loire;41;2;09;073;Danzé;688;17;705
24;Centre-Val de Loire;41;3;05;074;Dhuizon;1231;14;1245
24;Centre-Val de Loire;41;2;09;075;Droué;1000;8;1008
24;Centre-Val de Loire;41;1;01;077;Épiais;133;6;139
24;Centre-Val de Loire;41;2;09;078;Épuisay;820;17;837
24;Centre-Val de Loire;41;2;06;079;Les Essarts;106;0;106
24;Centre-Val de Loire;41;3;07;080;Faverolles-sur-Cher;1387;31;1418
24;Centre-Val de Loire;41;2;06;081;Faye;235;5;240
24;Centre-Val de Loire;41;3;05;083;La Ferté-Beauharnais;540;4;544
24;Centre-Val de Loire;41;3;13;084;La Ferté-Imbault;974;27;1001
24;Centre-Val de Loire;41;1;05;085;La Ferté-Saint-Cyr;1054;13;1067
24;Centre-Val de Loire;41;2;09;087;Fontaine-les-Coteaux;334;5;339
24;Centre-Val de Loire;41;2;09;088;Fontaine-Raoul;232;6;238
24;Centre-Val de Loire;41;1;05;086;Fontaines-en-Sologne;637;9;646
24;Centre-Val de Loire;41;2;09;089;La Fontenelle;199;2;201
24;Centre-Val de Loire;41;2;09;090;Fortan;262;6;268
24;Centre-Val de Loire;41;1;08;091;Fossé;1311;19;1330
24;Centre-Val de Loire;41;1;08;093;Françay;272;9;281
24;Centre-Val de Loire;41;3;07;094;Fresnes;1153;38;1191
24;Centre-Val de Loire;41;2;09;095;Fréteval;1075;22;1097
24;Centre-Val de Loire;41;2;09;096;Le Gault-du-Perche;340;3;343
24;Centre-Val de Loire;41;3;12;097;Gièvres;2386;30;2416
24;Centre-Val de Loire;41;2;06;098;Gombergean;181;4;185
24;Centre-Val de Loire;41;3;12;099;Gy-en-Sologne;498;13;511
24;Centre-Val de Loire;41;2;06;100;Les Hayes;173;8;181
24;Centre-Val de Loire;41;1;08;101;Herbault;1207;41;1248
24;Centre-Val de Loire;41;2;06;102;Houssay;387;3;390
24;Centre-Val de Loire;41;2;06;103;Huisseau-en-Beauce;420;11;431
24;Centre-Val de Loire;41;1;05;104;Huisseau-sur-Cosson;2297;51;2348
24;Centre-Val de Loire;41;1;01;105;Josnes;875;19;894
24;Centre-Val de Loire;41;3;13;106;Lamotte-Beuvron;4688;61;4749
24;Centre-Val de Loire;41;2;06;107;Lancé;475;6;481
24;Centre-Val de Loire;41;1;08;108;Lancôme;123;3;126
24;Centre-Val de Loire;41;1;08;109;Landes-le-Gaulois;748;21;769
24;Centre-Val de Loire;41;3;12;110;Langon-sur-Cher;818;19;837
24;Centre-Val de Loire;41;3;12;112;Lassay-sur-Croisne;247;9;256
24;Centre-Val de Loire;41;2;06;113;Lavardin;180;8;188
24;Centre-Val de Loire;41;1;01;114;Lestiou;287;7;294
24;Centre-Val de Loire;41;2;09;115;Lignières;386;6;392
24;Centre-Val de Loire;41;2;09;116;Lisle;195;3;198
24;Centre-Val de Loire;41;3;10;118;Loreux;203;4;207
24;Centre-Val de Loire;41;1;01;119;Lorges;350;6;356
24;Centre-Val de Loire;41;2;06;120;Lunay;1263;35;1298
24;Centre-Val de Loire;41;1;01;121;La Madeleine-Villefrouin;31;0;31
24;Centre-Val de Loire;41;3;12;122;Maray;233;2;235
24;Centre-Val de Loire;41;1;01;123;Marchenoir;669;11;680
24;Centre-Val de Loire;41;2;06;124;Marcilly-en-Beauce;343;21;364
24;Centre-Val de Loire;41;3;13;125;Marcilly-en-Gault;730;14;744
24;Centre-Val de Loire;41;3;11;126;Mareuil-sur-Cher;1153;21;1174
24;Centre-Val de Loire;41;3;05;127;La Marolle-en-Sologne;340;6;346
24;Centre-Val de Loire;41;1;08;128;Marolles;718;17;735
24;Centre-Val de Loire;41;1;05;129;Maslives;706;13;719
24;Centre-Val de Loire;41;1;01;130;Maves;664;12;676
24;Centre-Val de Loire;41;2;14;131;Mazangé;843;28;871
24;Centre-Val de Loire;41;3;11;132;Méhers;326;6;332
24;Centre-Val de Loire;41;1;03;134;Menars;622;22;644
24;Centre-Val de Loire;41;3;12;135;Mennetou-sur-Cher;876;9;885
24;Centre-Val de Loire;41;1;01;136;Mer;6205;105;6310
24;Centre-Val de Loire;41;1;08;137;Mesland;570;24;594
24;Centre-Val de Loire;41;2;14;138;Meslay;312;9;321
24;Centre-Val de Loire;41;3;11;139;Meusnes;1094;11;1105
24;Centre-Val de Loire;41;3;10;140;Millançay;759;19;778
24;Centre-Val de Loire;41;2;09;141;Moisy;368;2;370
24;Centre-Val de Loire;41;2;09;143;Mondoubleau;1318;53;1371
24;Centre-Val de Loire;41;1;05;150;Mont-près-Chambord;3305;90;3395
24;Centre-Val de Loire;41;1;08;144;Monteaux;752;23;775
24;Centre-Val de Loire;41;1;04;145;Monthou-sur-Bièvre;806;21;827
24;Centre-Val de Loire;41;3;07;146;Monthou-sur-Cher;961;15;976
24;Centre-Val de Loire;41;1;04;147;Les Montils;1919;43;1962
24;Centre-Val de Loire;41;1;05;148;Montlivault;1346;35;1381
24;Centre-Val de Loire;41;2;06;149;Montoire-sur-le-Loir;3752;197;3949
24;Centre-Val de Loire;41;3;07;151;Montrichard Val de Cher;3763;51;3814
24;Centre-Val de Loire;41;3;05;152;Montrieux-en-Sologne;639;12;651
24;Centre-Val de Loire;41;2;06;153;Montrouveau;153;3;156
24;Centre-Val de Loire;41;2;09;154;Morée;1082;27;1109
24;Centre-Val de Loire;41;1;01;155;Muides-sur-Loire;1235;30;1265
24;Centre-Val de Loire;41;1;01;156;Mulsans;507;13;520
24;Centre-Val de Loire;41;3;12;157;Mur-de-Sologne;1518;17;1535
24;Centre-Val de Loire;41;2;06;158;Naveil;2386;58;2444
24;Centre-Val de Loire;41;3;05;159;Neung-sur-Beuvron;1234;17;1251
24;Centre-Val de Loire;41;1;05;160;Neuvy;322;4;326
24;Centre-Val de Loire;41;3;13;161;Nouan-le-Fuzelier;2324;46;2370
24;Centre-Val de Loire;41;2;06;163;Nourray;113;2;115
24;Centre-Val de Loire;41;3;11;164;Noyers-sur-Cher;2725;32;2757
24;Centre-Val de Loire;41;3;07;166;Oisly;377;5;382
24;Centre-Val de Loire;41;3;12;168;Orçay;235;4;239
24;Centre-Val de Loire;41;1;01;171;Oucques La Nouvelle ;1730;29;1759
24;Centre-Val de Loire;41;2;09;172;Ouzouer-le-Doyen;234;1;235
24;Centre-Val de Loire;41;2;06;174;Périgny;177;7;184
24;Centre-Val de Loire;41;2;09;175;Pezou;1120;18;1138
24;Centre-Val de Loire;41;3;13;176;Pierrefitte-sur-Sauldre;770;18;788
24;Centre-Val de Loire;41;2;09;177;Le Plessis-Dorin;165;0;165
24;Centre-Val de Loire;41;1;01;178;Le Plessis-l'Échelle;66;2;68
24;Centre-Val de Loire;41;2;09;179;Le Poislay;184;1;185
24;Centre-Val de Loire;41;3;07;180;Pontlevoy;1529;176;1705
24;Centre-Val de Loire;41;3;11;181;Pouillé;796;21;817
24;Centre-Val de Loire;41;2;06;182;Pray;288;9;297
24;Centre-Val de Loire;41;2;06;184;Prunay-Cassereau;607;7;614
24;Centre-Val de Loire;41;3;12;185;Pruniers-en-Sologne;2353;56;2409
24;Centre-Val de Loire;41;2;09;186;Rahart;317;5;322
24;Centre-Val de Loire;41;2;09;187;Renay;176;4;180
24;Centre-Val de Loire;41;1;01;188;Rhodon;120;3;123
24;Centre-Val de Loire;41;1;04;189;Rilly-sur-Loire;474;6;480
24;Centre-Val de Loire;41;2;06;190;Rocé;215;7;222
24;Centre-Val de Loire;41;1;01;191;Roches;68;3;71
24;Centre-Val de Loire;41;2;06;192;Les Roches-l'Évêque;271;3;274
24;Centre-Val de Loire;41;2;09;193;Romilly;137;3;140
24;Centre-Val de Loire;41;3;10;194;Romorantin-Lanthenay;17871;471;18342
24;Centre-Val de Loire;41;3;11;195;Rougeou;155;2;157
24;Centre-Val de Loire;41;2;09;196;Ruan-sur-Egvonne;89;3;92
24;Centre-Val de Loire;41;3;11;198;Saint-Aignan;2844;90;2934
24;Centre-Val de Loire;41;2;06;199;Saint-Amand-Longpré;1208;27;1235
24;Centre-Val de Loire;41;2;06;201;Saint-Arnoult;322;3;325
24;Centre-Val de Loire;41;1;08;203;Saint-Bohaire;503;12;515
24;Centre-Val de Loire;41;1;05;204;Saint-Claude-de-Diray;1783;41;1824
24;Centre-Val de Loire;41;1;08;205;Saint-Cyr-du-Gault;174;2;176
24;Centre-Val de Loire;41;1;03;206;Saint-Denis-sur-Loire;850;25;875
24;Centre-Val de Loire;41;1;05;207;Saint-Dyé-sur-Loire;1136;20;1156
24;Centre-Val de Loire;41;1;08;208;Saint-Étienne-des-Guérets;113;4;117
24;Centre-Val de Loire;41;2;09;209;Saint-Firmin-des-Prés;819;41;860
24;Centre-Val de Loire;41;3;07;211;Saint-Georges-sur-Cher;2704;38;2742
24;Centre-Val de Loire;41;1;15;212;Saint-Gervais-la-Forêt;3181;96;3277
24;Centre-Val de Loire;41;2;06;213;Saint-Gourgon;109;5;114
24;Centre-Val de Loire;41;2;09;214;Saint-Hilaire-la-Gravelle;701;13;714
24;Centre-Val de Loire;41;2;06;215;Saint-Jacques-des-Guérets;93;2;95
24;Centre-Val de Loire;41;2;09;216;Saint-Jean-Froidmentel;553;8;561
24;Centre-Val de Loire;41;3;07;217;Saint-Julien-de-Chédon;754;15;769
24;Centre-Val de Loire;41;3;12;218;Saint-Julien-sur-Cher;764;12;776
24;Centre-Val de Loire;41;1;01;219;Saint-Laurent-des-Bois;299;3;302
24;Centre-Val de Loire;41;1;05;220;Saint-Laurent-Nouan;4352;84;4436
24;Centre-Val de Loire;41;1;01;221;Saint-Léonard-en-Beauce;645;17;662
24;Centre-Val de Loire;41;3;12;222;Saint-Loup;373;7;380
24;Centre-Val de Loire;41;1;08;223;Saint-Lubin-en-Vergonnois;718;10;728
24;Centre-Val de Loire;41;2;09;224;Saint-Marc-du-Cor;182;1;183
24;Centre-Val de Loire;41;2;06;225;Saint-Martin-des-Bois;576;11;587
24;Centre-Val de Loire;41;2;14;226;Saint-Ouen;3124;93;3217
24;Centre-Val de Loire;41;2;06;228;Saint-Rimay;290;3;293
24;Centre-Val de Loire;41;3;11;229;Saint-Romain-sur-Cher;1468;32;1500
24;Centre-Val de Loire;41;1;08;230;Saint-Sulpice-de-Pommeray;1848;55;1903
24;Centre-Val de Loire;41;3;13;231;Saint-Viâtre;1189;31;1220
24;Centre-Val de Loire;41;2;14;200;Sainte-Anne;465;28;493
24;Centre-Val de Loire;41;3;13;232;Salbris;5060;100;5160
24;Centre-Val de Loire;41;1;04;233;Sambin;920;16;936
24;Centre-Val de Loire;41;1;08;234;Santenay;286;9;295
24;Centre-Val de Loire;41;2;09;235;Sargé-sur-Braye;1028;22;1050
24;Centre-Val de Loire;41;2;06;236;Sasnières;104;3;107
24;Centre-Val de Loire;41;3;07;237;Sassay;1043;19;1062
24;Centre-Val de Loire;41;2;09;238;Savigny-sur-Braye;1987;28;2015
24;Centre-Val de Loire;41;3;11;239;Seigy;1026;23;1049
24;Centre-Val de Loire;41;3;13;241;Selles-Saint-Denis;1338;29;1367
24;Centre-Val de Loire;41;3;12;242;Selles-sur-Cher;4581;65;4646
24;Centre-Val de Loire;41;2;06;243;Selommes;812;13;825
24;Centre-Val de Loire;41;1;01;245;Séris;379;4;383
24;Centre-Val de Loire;41;1;04;246;Seur;480;18;498
24;Centre-Val de Loire;41;3;11;247;Soings-en-Sologne;1611;22;1633
24;Centre-Val de Loire;41;3;13;249;Souesmes;1053;14;1067
24;Centre-Val de Loire;41;2;09;250;Sougé;482;7;489
24;Centre-Val de Loire;41;3;13;251;Souvigny-en-Sologne;533;8;541
24;Centre-Val de Loire;41;1;01;252;Suèvres;1641;37;1678
24;Centre-Val de Loire;41;1;01;253;Talcy;252;5;257
24;Centre-Val de Loire;41;2;09;254;Le Temple;186;7;193
24;Centre-Val de Loire;41;2;06;255;Ternay;334;6;340
24;Centre-Val de Loire;41;3;12;256;Theillay;1251;19;1270
24;Centre-Val de Loire;41;3;11;258;Thésée;1144;23;1167
24;Centre-Val de Loire;41;2;06;259;Thoré-la-Rochette;863;33;896
24;Centre-Val de Loire;41;1;05;260;Thoury;419;6;425
24;Centre-Val de Loire;41;1;05;262;Tour-en-Sologne;1117;16;1133
24;Centre-Val de Loire;41;2;06;261;Tourailles;134;3;137
24;Centre-Val de Loire;41;2;06;265;Troo;290;10;300
24;Centre-Val de Loire;41;1;04;266;Valaire;85;3;88
24;Centre-Val de Loire;41;1;08;142;Valencisse;2376;91;2467
24;Centre-Val de Loire;41;2;06;070;Vallée-de-Ronsard ;521;9;530
24;Centre-Val de Loire;41;3;07;267;Vallières-les-Grandes;938;18;956
24;Centre-Val de Loire;41;1;08;055;Valloire-sur-Cisse;2416;55;2471
24;Centre-Val de Loire;41;3;10;268;Veilleins;161;4;165
24;Centre-Val de Loire;41;2;14;269;Vendôme;16133;649;16782
24;Centre-Val de Loire;41;3;10;271;Vernou-en-Sologne;626;6;632
24;Centre-Val de Loire;41;1;08;167;Veuzain-sur-Loire ;3482;102;3584
24;Centre-Val de Loire;41;1;01;273;Vievy-le-Rayé;455;7;462
24;Centre-Val de Loire;41;2;06;274;Villavard;128;0;128
24;Centre-Val de Loire;41;2;09;275;La Ville-aux-Clercs;1260;23;1283
24;Centre-Val de Loire;41;1;03;276;Villebarou;2462;80;2542
24;Centre-Val de Loire;41;2;09;277;Villebout;133;0;133
24;Centre-Val de Loire;41;2;06;278;Villechauve;268;8;276
24;Centre-Val de Loire;41;2;06;279;Villedieu-le-Château;406;5;411
24;Centre-Val de Loire;41;3;12;280;Villefranche-sur-Cher;2662;66;2728
24;Centre-Val de Loire;41;1;08;281;Villefrancœur;423;9;432
24;Centre-Val de Loire;41;3;10;282;Villeherviers;457;10;467
24;Centre-Val de Loire;41;2;06;283;Villemardy;276;4;280
24;Centre-Val de Loire;41;1;01;284;Villeneuve-Frouville;62;2;64
24;Centre-Val de Loire;41;3;05;285;Villeny;489;4;493
24;Centre-Val de Loire;41;2;06;286;Villeporcher;152;5;157
24;Centre-Val de Loire;41;2;06;287;Villerable;515;12;527
24;Centre-Val de Loire;41;1;03;288;Villerbon;804;15;819
24;Centre-Val de Loire;41;1;01;289;Villermain;395;8;403
24;Centre-Val de Loire;41;2;06;290;Villeromain;238;0;238
24;Centre-Val de Loire;41;2;06;291;Villetrun;322;4;326
24;Centre-Val de Loire;41;1;01;292;Villexanton;201;1;202
24;Centre-Val de Loire;41;2;14;294;Villiers-sur-Loir;1125;58;1183
24;Centre-Val de Loire;41;2;06;293;Villiersfaux;248;5;253
24;Centre-Val de Loire;41;1;15;295;Vineuil;7845;206;8051
24;Centre-Val de Loire;41;3;13;296;Vouzon;1472;34;1506
24;Centre-Val de Loire;41;3;13;297;Yvoy-le-Marron;742;8;750
84;Auvergne-Rhône-Alpes;42;1;20;001;Aboën;444;7;451
84;Auvergne-Rhône-Alpes;42;1;02;002;Ailleux;170;2;172
84;Auvergne-Rhône-Alpes;42;2;09;003;Ambierle;1909;47;1956
84;Auvergne-Rhône-Alpes;42;3;01;005;Andrézieux-Bouthéon;9740;147;9887
84;Auvergne-Rhône-Alpes;42;1;20;006;Apinac;411;8;419
84;Auvergne-Rhône-Alpes;42;2;03;007;Arcinges;214;5;219
84;Auvergne-Rhône-Alpes;42;2;09;008;Arcon;108;1;109
84;Auvergne-Rhône-Alpes;42;1;02;009;Arthun;532;5;537
84;Auvergne-Rhône-Alpes;42;1;01;010;Aveizieux;1649;22;1671
84;Auvergne-Rhône-Alpes;42;2;04;011;Balbigny;2902;57;2959
84;Auvergne-Rhône-Alpes;42;1;07;012;Bard;669;23;692
84;Auvergne-Rhône-Alpes;42;1;01;013;Bellegarde-en-Forez;1998;50;2048
84;Auvergne-Rhône-Alpes;42;2;03;014;Belleroche;313;8;321
84;Auvergne-Rhône-Alpes;42;2;03;015;Belmont-de-la-Loire;1485;26;1511
84;Auvergne-Rhône-Alpes;42;2;03;016;La Bénisson-Dieu;418;10;428
84;Auvergne-Rhône-Alpes;42;3;08;017;Le Bessat;451;6;457
84;Auvergne-Rhône-Alpes;42;3;08;018;Bessey;458;11;469
84;Auvergne-Rhône-Alpes;42;1;02;019;Boën-sur-Lignon;3214;73;3287
84;Auvergne-Rhône-Alpes;42;1;01;020;Boisset-lès-Montrond;1171;21;1192
84;Auvergne-Rhône-Alpes;42;1;07;021;Boisset-Saint-Priest;1237;10;1247
84;Auvergne-Rhône-Alpes;42;1;20;022;Bonson;3960;57;4017
84;Auvergne-Rhône-Alpes;42;3;08;023;Bourg-Argental;2930;56;2986
84;Auvergne-Rhône-Alpes;42;2;03;025;Boyer;200;4;204
84;Auvergne-Rhône-Alpes;42;2;03;026;Briennon;1705;39;1744
84;Auvergne-Rhône-Alpes;42;2;02;027;Bully;408;7;415
84;Auvergne-Rhône-Alpes;42;3;08;028;Burdignes;368;9;377
84;Auvergne-Rhône-Alpes;42;2;04;029;Bussières;1533;47;1580
84;Auvergne-Rhône-Alpes;42;1;02;030;Bussy-Albieux;535;3;538
84;Auvergne-Rhône-Alpes;42;3;06;031;Caloire;312;7;319
84;Auvergne-Rhône-Alpes;42;3;21;032;Cellieu;1695;24;1719
84;Auvergne-Rhône-Alpes;42;2;03;033;Le Cergne;632;24;656
84;Auvergne-Rhône-Alpes;42;1;02;034;Cervières;114;7;121
84;Auvergne-Rhône-Alpes;42;1;02;035;Cezay;215;9;224
84;Auvergne-Rhône-Alpes;42;3;21;036;Chagnon;500;17;517
84;Auvergne-Rhône-Alpes;42;1;07;037;Chalain-d'Uzore;574;22;596
84;Auvergne-Rhône-Alpes;42;1;07;038;Chalain-le-Comtal;703;14;717
84;Auvergne-Rhône-Alpes;42;1;02;039;Chalmazel-Jeansagnière;453;5;458
84;Auvergne-Rhône-Alpes;42;1;02;040;La Chamba;48;2;50
84;Auvergne-Rhône-Alpes;42;1;05;041;Chambéon;582;5;587
84;Auvergne-Rhône-Alpes;42;1;20;042;Chambles;1018;19;1037
84;Auvergne-Rhône-Alpes;42;3;15;044;Le Chambon-Feugerolles;12200;79;12279
84;Auvergne-Rhône-Alpes;42;1;02;045;La Chambonie;40;1;41
84;Auvergne-Rhône-Alpes;42;1;01;043;Chambœuf;1752;36;1788
84;Auvergne-Rhône-Alpes;42;1;02;046;Champdieu;1917;44;1961
84;Auvergne-Rhône-Alpes;42;2;09;047;Champoly;328;2;330
84;Auvergne-Rhône-Alpes;42;2;03;048;Chandon;1476;30;1506
84;Auvergne-Rhône-Alpes;42;2;09;049;Changy;645;20;665
84;Auvergne-Rhône-Alpes;42;1;07;050;La Chapelle-en-Lafaye;122;3;125
84;Auvergne-Rhône-Alpes;42;3;08;051;La Chapelle-Villars;530;14;544
84;Auvergne-Rhône-Alpes;42;2;03;052;Charlieu;3681;100;3781
84;Auvergne-Rhône-Alpes;42;3;10;053;Châteauneuf;1625;20;1645
84;Auvergne-Rhône-Alpes;42;1;02;054;Châtelneuf;342;8;350
84;Auvergne-Rhône-Alpes;42;1;05;055;Châtelus;138;8;146
84;Auvergne-Rhône-Alpes;42;2;09;339;Chausseterre;221;5;226
84;Auvergne-Rhône-Alpes;42;3;08;056;Chavanay;2883;50;2933
84;Auvergne-Rhône-Alpes;42;1;07;058;Chazelles-sur-Lavieu;262;6;268
84;Auvergne-Rhône-Alpes;42;1;05;059;Chazelles-sur-Lyon;5364;98;5462
84;Auvergne-Rhône-Alpes;42;1;07;060;Chenereilles;524;6;530
84;Auvergne-Rhône-Alpes;42;2;09;061;Cherier;563;15;578
84;Auvergne-Rhône-Alpes;42;1;05;062;Chevrières;1158;25;1183
84;Auvergne-Rhône-Alpes;42;2;04;063;Chirassimont;400;9;409
84;Auvergne-Rhône-Alpes;42;3;08;064;Chuyer;768;31;799
84;Auvergne-Rhône-Alpes;42;1;05;065;Civens;1373;52;1425
84;Auvergne-Rhône-Alpes;42;1;05;066;Cleppé;519;12;531
84;Auvergne-Rhône-Alpes;42;3;08;067;Colombier;301;3;304
84;Auvergne-Rhône-Alpes;42;2;03;068;Combre;432;11;443
84;Auvergne-Rhône-Alpes;42;2;04;069;Commelle-Vernay;2985;92;3077
84;Auvergne-Rhône-Alpes;42;2;04;070;Cordelle;914;21;935
84;Auvergne-Rhône-Alpes;42;1;02;072;La Côte-en-Couzan;67;1;68
84;Auvergne-Rhône-Alpes;42;2;04;071;Le Coteau;6881;179;7060
84;Auvergne-Rhône-Alpes;42;1;05;073;Cottance;727;17;744
84;Auvergne-Rhône-Alpes;42;2;03;074;Coutouvre;1091;26;1117
84;Auvergne-Rhône-Alpes;42;1;01;075;Craintilleux;1352;14;1366
84;Auvergne-Rhône-Alpes;42;2;09;076;Cremeaux;901;22;923
84;Auvergne-Rhône-Alpes;42;2;04;077;Croizet-sur-Gand;311;6;317
84;Auvergne-Rhône-Alpes;42;2;09;078;Le Crozet;265;11;276
84;Auvergne-Rhône-Alpes;42;2;03;079;Cuinzier;720;12;732
84;Auvergne-Rhône-Alpes;42;1;01;081;Cuzieu;1548;20;1568
84;Auvergne-Rhône-Alpes;42;3;10;083;Dargoire;522;4;526
84;Auvergne-Rhône-Alpes;42;1;02;084;Débats-Rivière-d'Orpra;157;4;161
84;Auvergne-Rhône-Alpes;42;3;08;085;Doizieux;831;18;849
84;Auvergne-Rhône-Alpes;42;2;03;086;Écoche;527;13;540
84;Auvergne-Rhône-Alpes;42;1;07;087;Écotay-l'Olme;1214;52;1266
84;Auvergne-Rhône-Alpes;42;1;05;088;Épercieux-Saint-Paul;750;17;767
84;Auvergne-Rhône-Alpes;42;1;02;089;Essertines-en-Châtelneuf;680;29;709
84;Auvergne-Rhône-Alpes;42;1;05;090;Essertines-en-Donzy;493;11;504
84;Auvergne-Rhône-Alpes;42;1;20;091;Estivareilles;683;15;698
84;Auvergne-Rhône-Alpes;42;3;21;092;L' Étrat;2584;101;2685
84;Auvergne-Rhône-Alpes;42;3;10;093;Farnay;1393;20;1413
84;Auvergne-Rhône-Alpes;42;1;05;094;Feurs;8252;157;8409
84;Auvergne-Rhône-Alpes;42;3;06;095;Firminy;16981;209;17190
84;Auvergne-Rhône-Alpes;42;3;21;096;Fontanès;680;11;691
84;Auvergne-Rhône-Alpes;42;3;21;097;La Fouillouse;4527;62;4589
84;Auvergne-Rhône-Alpes;42;2;04;098;Fourneaux;585;14;599
84;Auvergne-Rhône-Alpes;42;3;06;099;Fraisses;3721;52;3773
84;Auvergne-Rhône-Alpes;42;3;10;225;Genilac;3906;76;3982
84;Auvergne-Rhône-Alpes;42;1;05;100;La Gimond;277;11;288
84;Auvergne-Rhône-Alpes;42;3;08;101;Graix;143;1;144
84;Auvergne-Rhône-Alpes;42;1;05;102;Grammond;898;22;920
84;Auvergne-Rhône-Alpes;42;3;10;103;La Grand-Croix;5168;41;5209
84;Auvergne-Rhône-Alpes;42;2;03;104;La Gresle;852;20;872
84;Auvergne-Rhône-Alpes;42;1;07;105;Grézieux-le-Fromental;251;2;253
84;Auvergne-Rhône-Alpes;42;2;02;106;Grézolles;259;8;267
84;Auvergne-Rhône-Alpes;42;1;07;107;Gumières;321;9;330
84;Auvergne-Rhône-Alpes;42;1;07;108;L' Hôpital-le-Grand;1066;25;1091
84;Auvergne-Rhône-Alpes;42;1;02;109;L' Hôpital-sous-Rochefort;109;1;110
84;Auvergne-Rhône-Alpes;42;3;13;110;L' Horme;4768;42;4810
84;Auvergne-Rhône-Alpes;42;2;03;112;Jarnosse;427;8;435
84;Auvergne-Rhône-Alpes;42;1;05;113;Jas;228;6;234
84;Auvergne-Rhône-Alpes;42;3;08;115;Jonzieux;1197;15;1212
84;Auvergne-Rhône-Alpes;42;2;09;116;Juré;246;7;253
84;Auvergne-Rhône-Alpes;42;1;07;117;Lavieu;116;8;124
84;Auvergne-Rhône-Alpes;42;2;04;118;Lay;748;20;768
84;Auvergne-Rhône-Alpes;42;1;02;119;Leigneux;372;11;383
84;Auvergne-Rhône-Alpes;42;2;09;120;Lentigny;1757;40;1797
84;Auvergne-Rhône-Alpes;42;1;07;121;Lérigneux;150;2;152
84;Auvergne-Rhône-Alpes;42;1;07;122;Lézigneux;1705;78;1783
84;Auvergne-Rhône-Alpes;42;3;10;123;Lorette;4684;31;4715
84;Auvergne-Rhône-Alpes;42;3;08;124;Lupé;302;7;309
84;Auvergne-Rhône-Alpes;42;2;02;125;Luré;141;2;143
84;Auvergne-Rhône-Alpes;42;1;07;126;Luriecq;1298;31;1329
84;Auvergne-Rhône-Alpes;42;2;11;127;Mably;7641;118;7759
84;Auvergne-Rhône-Alpes;42;2;04;128;Machézal;386;8;394
84;Auvergne-Rhône-Alpes;42;3;08;129;Maclas;1812;68;1880
84;Auvergne-Rhône-Alpes;42;1;07;130;Magneux-Haute-Rive;572;10;582
84;Auvergne-Rhône-Alpes;42;2;03;131;Maizilly;335;9;344
84;Auvergne-Rhône-Alpes;42;3;08;132;Malleval;574;16;590
84;Auvergne-Rhône-Alpes;42;3;21;133;Marcenod;703;19;722
84;Auvergne-Rhône-Alpes;42;1;02;134;Marcilly-le-Châtel;1391;47;1438
84;Auvergne-Rhône-Alpes;42;1;05;135;Marclopt;516;27;543
84;Auvergne-Rhône-Alpes;42;1;02;136;Marcoux;750;32;782
84;Auvergne-Rhône-Alpes;42;1;07;137;Margerie-Chantagret;801;15;816
84;Auvergne-Rhône-Alpes;42;1;05;138;Maringes;667;12;679
84;Auvergne-Rhône-Alpes;42;3;08;139;Marlhes;1319;61;1380
84;Auvergne-Rhône-Alpes;42;1;07;140;Marols;431;8;439
84;Auvergne-Rhône-Alpes;42;2;03;141;Mars;562;11;573
84;Auvergne-Rhône-Alpes;42;1;20;142;Merle-Leignec;320;4;324
84;Auvergne-Rhône-Alpes;42;1;05;143;Mizérieux;471;5;476
84;Auvergne-Rhône-Alpes;42;2;03;145;Montagny;1066;18;1084
84;Auvergne-Rhône-Alpes;42;1;07;146;Montarcher;67;3;70
84;Auvergne-Rhône-Alpes;42;1;07;147;Montbrison;15656;614;16270
84;Auvergne-Rhône-Alpes;42;1;05;148;Montchal;487;9;496
84;Auvergne-Rhône-Alpes;42;1;01;149;Montrond-les-Bains;5290;81;5371
84;Auvergne-Rhône-Alpes;42;1;02;150;Montverdun;1387;30;1417
84;Auvergne-Rhône-Alpes;42;1;07;151;Mornand-en-Forez;412;79;491
84;Auvergne-Rhône-Alpes;42;2;03;152;Nandax;534;305;839
84;Auvergne-Rhône-Alpes;42;2;04;153;Neaux;480;12;492
84;Auvergne-Rhône-Alpes;42;2;04;154;Néronde;457;51;508
84;Auvergne-Rhône-Alpes;42;1;05;155;Nervieux;1000;23;1023
84;Auvergne-Rhône-Alpes;42;2;04;156;Neulise;1369;18;1387
84;Auvergne-Rhône-Alpes;42;2;09;157;Noailly;798;14;812
84;Auvergne-Rhône-Alpes;42;2;09;158;Les Noës;209;3;212
84;Auvergne-Rhône-Alpes;42;1;02;159;Noirétable;1577;106;1683
84;Auvergne-Rhône-Alpes;42;2;02;160;Nollieux;194;6;200
84;Auvergne-Rhône-Alpes;42;2;04;161;Notre-Dame-de-Boisset;570;19;589
84;Auvergne-Rhône-Alpes;42;2;09;162;Ouches;1156;19;1175
84;Auvergne-Rhône-Alpes;42;2;09;163;La Pacaudière;1063;20;1083
84;Auvergne-Rhône-Alpes;42;1;02;164;Palogneux;74;0;74
84;Auvergne-Rhône-Alpes;42;1;05;165;Panissières;2911;86;2997
84;Auvergne-Rhône-Alpes;42;2;04;166;Parigny;617;16;633
84;Auvergne-Rhône-Alpes;42;3;08;167;Pavezin;363;9;372
84;Auvergne-Rhône-Alpes;42;3;08;168;Pélussin;3751;100;3851
84;Auvergne-Rhône-Alpes;42;1;20;169;Périgneux;1546;27;1573
84;Auvergne-Rhône-Alpes;42;2;04;170;Perreux;2110;180;2290
84;Auvergne-Rhône-Alpes;42;2;04;171;Pinay;288;7;295
84;Auvergne-Rhône-Alpes;42;3;08;172;Planfoy;1053;24;1077
84;Auvergne-Rhône-Alpes;42;2;02;173;Pommiers;360;10;370
84;Auvergne-Rhône-Alpes;42;1;05;174;Poncins;1118;24;1142
84;Auvergne-Rhône-Alpes;42;1;05;175;Pouilly-lès-Feurs;1220;35;1255
84;Auvergne-Rhône-Alpes;42;2;09;176;Pouilly-les-Nonains;2161;46;2207
84;Auvergne-Rhône-Alpes;42;2;03;177;Pouilly-sous-Charlieu;2501;52;2553
84;Auvergne-Rhône-Alpes;42;2;03;178;Pradines;818;10;828
84;Auvergne-Rhône-Alpes;42;1;02;179;Pralong;852;28;880
84;Auvergne-Rhône-Alpes;42;1;07;180;Précieux;1033;101;1134
84;Auvergne-Rhône-Alpes;42;2;03;181;Régny;1515;30;1545
84;Auvergne-Rhône-Alpes;42;2;09;182;Renaison;3170;106;3276
84;Auvergne-Rhône-Alpes;42;3;15;183;La Ricamarie;7889;48;7937
84;Auvergne-Rhône-Alpes;42;2;12;184;Riorges;10757;279;11036
84;Auvergne-Rhône-Alpes;42;1;01;185;Rivas;680;19;699
84;Auvergne-Rhône-Alpes;42;3;10;186;Rive-de-Gier;15105;123;15228
84;Auvergne-Rhône-Alpes;42;2;98;187;Roanne;34004;743;34747
84;Auvergne-Rhône-Alpes;42;1;07;188;Roche;254;4;258
84;Auvergne-Rhône-Alpes;42;3;16;189;Roche-la-Molière;9825;91;9916
84;Auvergne-Rhône-Alpes;42;3;08;191;Roisey;954;32;986
84;Auvergne-Rhône-Alpes;42;1;20;192;Rozier-Côtes-d'Aurec;440;7;447
84;Auvergne-Rhône-Alpes;42;1;05;193;Rozier-en-Donzy;1435;39;1474
84;Auvergne-Rhône-Alpes;42;2;09;194;Sail-les-Bains;200;2;202
84;Auvergne-Rhône-Alpes;42;1;02;195;Sail-sous-Couzan;956;22;978
84;Auvergne-Rhône-Alpes;42;2;09;198;Saint-Alban-les-Eaux;951;22;973
84;Auvergne-Rhône-Alpes;42;2;09;199;Saint-André-d'Apchon;1939;63;2002
84;Auvergne-Rhône-Alpes;42;1;01;200;Saint-André-le-Puy;1533;26;1559
84;Auvergne-Rhône-Alpes;42;3;08;201;Saint-Appolinard;683;30;713
84;Auvergne-Rhône-Alpes;42;1;05;202;Saint-Barthélemy-Lestra;685;15;700
84;Auvergne-Rhône-Alpes;42;2;09;203;Saint-Bonnet-des-Quarts;310;12;322
84;Auvergne-Rhône-Alpes;42;1;20;204;Saint-Bonnet-le-Château;1517;47;1564
84;Auvergne-Rhône-Alpes;42;1;02;205;Saint-Bonnet-le-Courreau;688;15;703
84;Auvergne-Rhône-Alpes;42;1;01;206;Saint-Bonnet-les-Oules;1652;41;1693
84;Auvergne-Rhône-Alpes;42;3;13;207;Saint-Chamond;34979;469;35448
84;Auvergne-Rhône-Alpes;42;3;21;208;Saint-Christo-en-Jarez;1897;42;1939
84;Auvergne-Rhône-Alpes;42;1;20;211;Saint-Cyprien;2466;36;2502
84;Auvergne-Rhône-Alpes;42;2;04;212;Saint-Cyr-de-Favières;941;28;969
84;Auvergne-Rhône-Alpes;42;2;04;213;Saint-Cyr-de-Valorges;308;12;320
84;Auvergne-Rhône-Alpes;42;1;05;214;Saint-Cyr-les-Vignes;1048;29;1077
84;Auvergne-Rhône-Alpes;42;2;03;215;Saint-Denis-de-Cabanne;1256;25;1281
84;Auvergne-Rhône-Alpes;42;1;05;216;Saint-Denis-sur-Coise;659;18;677
84;Auvergne-Rhône-Alpes;42;1;02;217;Saint-Didier-sur-Rochefort;421;7;428
84;Auvergne-Rhône-Alpes;42;3;99;218;Saint-Étienne;173089;1968;175057
84;Auvergne-Rhône-Alpes;42;1;02;219;Saint-Étienne-le-Molard;1022;26;1048
84;Auvergne-Rhône-Alpes;42;2;09;220;Saint-Forgeux-Lespinasse;635;20;655
84;Auvergne-Rhône-Alpes;42;1;01;222;Saint-Galmier;5737;144;5881
84;Auvergne-Rhône-Alpes;42;3;16;223;Saint-Genest-Lerpt;6159;71;6230
84;Auvergne-Rhône-Alpes;42;3;08;224;Saint-Genest-Malifaux;2891;145;3036
84;Auvergne-Rhône-Alpes;42;2;02;226;Saint-Georges-de-Baroille;426;3;429
84;Auvergne-Rhône-Alpes;42;1;02;227;Saint-Georges-en-Couzan;409;10;419
84;Auvergne-Rhône-Alpes;42;1;07;228;Saint-Georges-Haute-Ville;1458;26;1484
84;Auvergne-Rhône-Alpes;42;2;03;229;Saint-Germain-la-Montagne;235;6;241
84;Auvergne-Rhône-Alpes;42;2;02;230;Saint-Germain-Laval;1621;31;1652
84;Auvergne-Rhône-Alpes;42;2;09;231;Saint-Germain-Lespinasse;1249;80;1329
84;Auvergne-Rhône-Alpes;42;2;09;232;Saint-Haon-le-Châtel;638;11;649
84;Auvergne-Rhône-Alpes;42;2;09;233;Saint-Haon-le-Vieux;956;24;980
84;Auvergne-Rhône-Alpes;42;3;21;234;Saint-Héand;3614;54;3668
84;Auvergne-Rhône-Alpes;42;1;20;235;Saint-Hilaire-Cusson-la-Valmitte;337;5;342
84;Auvergne-Rhône-Alpes;42;2;03;236;Saint-Hilaire-sous-Charlieu;525;10;535
84;Auvergne-Rhône-Alpes;42;3;18;237;Saint-Jean-Bonnefonds;6627;69;6696
84;Auvergne-Rhône-Alpes;42;1;02;238;Saint-Jean-la-Vêtre;318;11;329
84;Auvergne-Rhône-Alpes;42;2;09;239;Saint-Jean-Saint-Maurice-sur-Loire;1150;24;1174
84;Auvergne-Rhône-Alpes;42;1;07;240;Saint-Jean-Soleymieux;859;19;878
84;Auvergne-Rhône-Alpes;42;2;04;241;Saint-Jodard;402;5;407
84;Auvergne-Rhône-Alpes;42;3;10;242;Saint-Joseph;1915;29;1944
84;Auvergne-Rhône-Alpes;42;2;02;243;Saint-Julien-d'Oddes;277;5;282
84;Auvergne-Rhône-Alpes;42;3;08;246;Saint-Julien-Molin-Molette;1139;18;1157
84;Auvergne-Rhône-Alpes;42;1;02;247;Saint-Just-en-Bas;285;8;293
84;Auvergne-Rhône-Alpes;42;2;09;248;Saint-Just-en-Chevalet;1138;38;1176
84;Auvergne-Rhône-Alpes;42;2;04;249;Saint-Just-la-Pendue;1649;35;1684
84;Auvergne-Rhône-Alpes;42;1;20;279;Saint-Just-Saint-Rambert;15034;278;15312
84;Auvergne-Rhône-Alpes;42;1;05;251;Saint-Laurent-la-Conche;594;13;607
84;Auvergne-Rhône-Alpes;42;1;02;252;Saint-Laurent-Rochefort;250;2;252
84;Auvergne-Rhône-Alpes;42;2;12;253;Saint-Léger-sur-Roanne;1151;40;1191
84;Auvergne-Rhône-Alpes;42;2;09;255;Saint-Marcel-d'Urfé;287;7;294
84;Auvergne-Rhône-Alpes;42;2;04;254;Saint-Marcel-de-Félines;801;17;818
84;Auvergne-Rhône-Alpes;42;1;20;256;Saint-Marcellin-en-Forez;4856;49;4905
84;Auvergne-Rhône-Alpes;42;2;09;257;Saint-Martin-d'Estréaux;843;16;859
84;Auvergne-Rhône-Alpes;42;3;10;259;Saint-Martin-la-Plaine;3789;75;3864
84;Auvergne-Rhône-Alpes;42;2;02;260;Saint-Martin-la-Sauveté;923;60;983
84;Auvergne-Rhône-Alpes;42;1;05;261;Saint-Martin-Lestra;900;20;920
84;Auvergne-Rhône-Alpes;42;1;20;262;Saint-Maurice-en-Gourgois;1811;21;1832
84;Auvergne-Rhône-Alpes;42;1;05;264;Saint-Médard-en-Forez;1010;25;1035
84;Auvergne-Rhône-Alpes;42;3;08;265;Saint-Michel-sur-Rhône;841;25;866
84;Auvergne-Rhône-Alpes;42;1;20;266;Saint-Nizier-de-Fornas;665;13;678
84;Auvergne-Rhône-Alpes;42;2;03;267;Saint-Nizier-sous-Charlieu;1699;46;1745
84;Auvergne-Rhône-Alpes;42;1;07;269;Saint-Paul-d'Uzore;174;10;184
84;Auvergne-Rhône-Alpes;42;3;06;270;Saint-Paul-en-Cornillon;1361;31;1392
84;Auvergne-Rhône-Alpes;42;3;10;271;Saint-Paul-en-Jarez;4831;60;4891
84;Auvergne-Rhône-Alpes;42;3;08;272;Saint-Pierre-de-Bœuf;1714;38;1752
84;Auvergne-Rhône-Alpes;42;2;03;273;Saint-Pierre-la-Noaille;377;8;385
84;Auvergne-Rhône-Alpes;42;2;02;274;Saint-Polgues;257;8;265
84;Auvergne-Rhône-Alpes;42;3;18;275;Saint-Priest-en-Jarez;6092;95;6187
84;Auvergne-Rhône-Alpes;42;2;09;276;Saint-Priest-la-Prugne;432;6;438
84;Auvergne-Rhône-Alpes;42;2;04;277;Saint-Priest-la-Roche;344;1;345
84;Auvergne-Rhône-Alpes;42;1;02;278;Saint-Priest-la-Vêtre;145;1;146
84;Auvergne-Rhône-Alpes;42;3;08;280;Saint-Régis-du-Coin;395;11;406
84;Auvergne-Rhône-Alpes;42;2;09;281;Saint-Rirand;137;2;139
84;Auvergne-Rhône-Alpes;42;2;09;282;Saint-Romain-d'Urfé;249;5;254
84;Auvergne-Rhône-Alpes;42;3;21;283;Saint-Romain-en-Jarez;1222;28;1250
84;Auvergne-Rhône-Alpes;42;2;09;284;Saint-Romain-la-Motte;1429;59;1488
84;Auvergne-Rhône-Alpes;42;1;07;285;Saint-Romain-le-Puy;4052;63;4115
84;Auvergne-Rhône-Alpes;42;3;08;286;Saint-Romain-les-Atheux;951;15;966
84;Auvergne-Rhône-Alpes;42;3;08;287;Saint-Sauveur-en-Rue;1091;22;1113
84;Auvergne-Rhône-Alpes;42;1;02;288;Saint-Sixte;703;12;715
84;Auvergne-Rhône-Alpes;42;2;04;289;Saint-Symphorien-de-Lay;1896;36;1932
84;Auvergne-Rhône-Alpes;42;1;07;290;Saint-Thomas-la-Garde;596;22;618
84;Auvergne-Rhône-Alpes;42;2;03;293;Saint-Victor-sur-Rhins;1186;20;1206
84;Auvergne-Rhône-Alpes;42;2;04;294;Saint-Vincent-de-Boisset;965;28;993
84;Auvergne-Rhône-Alpes;42;2;04;196;Sainte-Agathe-en-Donzy;124;4;128
84;Auvergne-Rhône-Alpes;42;1;02;197;Sainte-Agathe-la-Bouteresse;1034;32;1066
84;Auvergne-Rhône-Alpes;42;2;04;209;Sainte-Colombe-sur-Gand;401;11;412
84;Auvergne-Rhône-Alpes;42;3;08;210;Sainte-Croix-en-Jarez;478;7;485
84;Auvergne-Rhône-Alpes;42;1;02;221;Sainte-Foy-Saint-Sulpice;514;15;529
84;Auvergne-Rhône-Alpes;42;1;02;295;Les Salles;554;7;561
84;Auvergne-Rhône-Alpes;42;1;05;296;Salt-en-Donzy;545;16;561
84;Auvergne-Rhône-Alpes;42;1;05;297;Salvizinet;592;30;622
84;Auvergne-Rhône-Alpes;42;1;02;298;Sauvain;380;5;385
84;Auvergne-Rhône-Alpes;42;1;07;299;Savigneux;3441;73;3514
84;Auvergne-Rhône-Alpes;42;2;03;300;Sevelinges;642;13;655
84;Auvergne-Rhône-Alpes;42;1;07;301;Soleymieux;672;8;680
84;Auvergne-Rhône-Alpes;42;3;21;302;Sorbiers;7856;167;8023
84;Auvergne-Rhône-Alpes;42;2;02;303;Souternon;284;6;290
84;Auvergne-Rhône-Alpes;42;1;20;304;Sury-le-Comtal;6612;270;6882
84;Auvergne-Rhône-Alpes;42;3;21;305;La Talaudière;6931;100;7031
84;Auvergne-Rhône-Alpes;42;3;08;306;Tarentaise;479;6;485
84;Auvergne-Rhône-Alpes;42;3;10;307;Tartaras;877;48;925
84;Auvergne-Rhône-Alpes;42;3;08;308;La Terrasse-sur-Dorlay;781;8;789
84;Auvergne-Rhône-Alpes;42;3;08;310;Thélis-la-Combe;153;2;155
84;Auvergne-Rhône-Alpes;42;3;21;311;La Tour-en-Jarez;1476;37;1513
84;Auvergne-Rhône-Alpes;42;1;20;312;La Tourette;595;17;612
84;Auvergne-Rhône-Alpes;42;1;02;313;Trelins;657;8;665
84;Auvergne-Rhône-Alpes;42;2;09;314;La Tuilière;290;8;298
84;Auvergne-Rhône-Alpes;42;1;01;315;Unias;428;14;442
84;Auvergne-Rhône-Alpes;42;3;06;316;Unieux;8408;80;8488
84;Auvergne-Rhône-Alpes;42;2;09;317;Urbise;127;6;133
84;Auvergne-Rhône-Alpes;42;1;20;318;Usson-en-Forez;1485;23;1508
84;Auvergne-Rhône-Alpes;42;1;05;319;Valeille;719;11;730
84;Auvergne-Rhône-Alpes;42;3;21;320;Valfleury;708;10;718
84;Auvergne-Rhône-Alpes;42;3;08;322;La Valla-en-Gier;1065;26;1091
84;Auvergne-Rhône-Alpes;42;1;02;321;La Valla-sur-Rochefort;102;1;103
84;Auvergne-Rhône-Alpes;42;1;01;323;Veauche;8976;105;9081
84;Auvergne-Rhône-Alpes;42;1;01;324;Veauchette;1170;17;1187
84;Auvergne-Rhône-Alpes;42;2;04;325;Vendranges;374;5;379
84;Auvergne-Rhône-Alpes;42;3;08;326;Véranne;856;28;884
84;Auvergne-Rhône-Alpes;42;3;08;327;Vérin;666;14;680
84;Auvergne-Rhône-Alpes;42;1;07;328;Verrières-en-Forez;710;74;784
84;Auvergne-Rhône-Alpes;42;3;08;329;La Versanne;376;5;381
84;Auvergne-Rhône-Alpes;42;1;02;245;Vêtre-sur-Anzon ;546;6;552
84;Auvergne-Rhône-Alpes;42;2;02;268;Vézelin-sur-Loire ;796;9;805
84;Auvergne-Rhône-Alpes;42;3;17;330;Villars;7952;159;8111
84;Auvergne-Rhône-Alpes;42;2;09;331;Villemontais;1019;31;1050
84;Auvergne-Rhône-Alpes;42;2;12;332;Villerest;4965;140;5105
84;Auvergne-Rhône-Alpes;42;2;03;333;Villers;587;13;600
84;Auvergne-Rhône-Alpes;42;2;04;334;Violay;1244;17;1261
84;Auvergne-Rhône-Alpes;42;1;05;335;Viricelles;449;20;469
84;Auvergne-Rhône-Alpes;42;1;05;336;Virigneux;635;20;655
84;Auvergne-Rhône-Alpes;42;2;09;337;Vivans;229;5;234
84;Auvergne-Rhône-Alpes;42;2;03;338;Vougy;1479;61;1540
84;Auvergne-Rhône-Alpes;43;1;17;001;Agnat;183;4;187
84;Auvergne-Rhône-Alpes;43;2;13;002;Aiguilhe;1491;63;1554
84;Auvergne-Rhône-Alpes;43;2;11;003;Allègre;884;18;902
84;Auvergne-Rhône-Alpes;43;2;08;004;Alleyrac;119;7;126
84;Auvergne-Rhône-Alpes;43;2;18;005;Alleyras;159;3;162
84;Auvergne-Rhône-Alpes;43;1;10;006;Ally;134;2;136
84;Auvergne-Rhône-Alpes;43;3;19;007;Araules;596;17;613
84;Auvergne-Rhône-Alpes;43;2;18;008;Arlempdes;141;6;147
84;Auvergne-Rhône-Alpes;43;1;10;009;Arlet;24;0;24
84;Auvergne-Rhône-Alpes;43;2;15;010;Arsac-en-Velay;1199;29;1228
84;Auvergne-Rhône-Alpes;43;1;10;011;Aubazat;181;5;186
84;Auvergne-Rhône-Alpes;43;3;01;012;Aurec-sur-Loire;6127;83;6210
84;Auvergne-Rhône-Alpes;43;1;17;014;Autrac;60;2;62
84;Auvergne-Rhône-Alpes;43;1;07;015;Auvers;51;0;51
84;Auvergne-Rhône-Alpes;43;1;17;016;Auzon;897;22;919
84;Auvergne-Rhône-Alpes;43;1;17;017;Azérat;279;5;284
84;Auvergne-Rhône-Alpes;43;2;18;018;Bains;1364;124;1488
84;Auvergne-Rhône-Alpes;43;2;18;019;Barges;106;2;108
84;Auvergne-Rhône-Alpes;43;3;02;020;Bas-en-Basset;4368;86;4454
84;Auvergne-Rhône-Alpes;43;2;06;021;Beaulieu;1034;20;1054
84;Auvergne-Rhône-Alpes;43;1;04;022;Beaumont;281;12;293
84;Auvergne-Rhône-Alpes;43;2;11;023;Beaune-sur-Arzon;215;2;217
84;Auvergne-Rhône-Alpes;43;3;19;024;Beaux;858;13;871
84;Auvergne-Rhône-Alpes;43;3;02;025;Beauzac;2953;66;3019
84;Auvergne-Rhône-Alpes;43;2;16;026;Bellevue-la-Montagne;432;12;444
84;Auvergne-Rhône-Alpes;43;1;11;027;Berbezit;46;0;46
84;Auvergne-Rhône-Alpes;43;3;19;028;Bessamorel;466;15;481
84;Auvergne-Rhône-Alpes;43;1;07;029;La Besseyre-Saint-Mary;98;1;99
84;Auvergne-Rhône-Alpes;43;2;16;030;Blanzac;402;10;412
84;Auvergne-Rhône-Alpes;43;1;10;031;Blassac;135;5;140
84;Auvergne-Rhône-Alpes;43;2;14;032;Blavozy;1670;50;1720
84;Auvergne-Rhône-Alpes;43;1;17;033;Blesle;635;8;643
84;Auvergne-Rhône-Alpes;43;3;02;034;Boisset;351;1;352
84;Auvergne-Rhône-Alpes;43;1;11;035;Bonneval;69;3;72
84;Auvergne-Rhône-Alpes;43;2;16;036;Borne;407;6;413
84;Auvergne-Rhône-Alpes;43;2;18;037;Le Bouchet-Saint-Nicolas;282;7;289
84;Auvergne-Rhône-Alpes;43;1;04;038;Bournoncle-Saint-Pierre;995;27;1022
84;Auvergne-Rhône-Alpes;43;2;18;039;Le Brignon;605;13;618
84;Auvergne-Rhône-Alpes;43;1;04;040;Brioude;6681;334;7015
84;Auvergne-Rhône-Alpes;43;2;14;041;Brives-Charensac;4131;228;4359
84;Auvergne-Rhône-Alpes;43;2;18;042;Cayres;719;17;736
84;Auvergne-Rhône-Alpes;43;2;16;043;Céaux-d'Allègre;472;8;480
84;Auvergne-Rhône-Alpes;43;1;10;044;Cerzat;210;4;214
84;Auvergne-Rhône-Alpes;43;2;12;045;Ceyssac;421;13;434
84;Auvergne-Rhône-Alpes;43;2;13;046;Chadrac;2488;69;2557
84;Auvergne-Rhône-Alpes;43;2;08;047;Chadron;312;8;320
84;Auvergne-Rhône-Alpes;43;1;11;048;La Chaise-Dieu;618;36;654
84;Auvergne-Rhône-Alpes;43;2;06;049;Chamalières-sur-Loire;490;9;499
84;Auvergne-Rhône-Alpes;43;1;17;050;Chambezon;120;0;120
84;Auvergne-Rhône-Alpes;43;3;08;051;Le Chambon-sur-Lignon;2457;40;2497
84;Auvergne-Rhône-Alpes;43;1;17;052;Champagnac-le-Vieux;199;2;201
84;Auvergne-Rhône-Alpes;43;2;08;053;Champclause;204;4;208
84;Auvergne-Rhône-Alpes;43;1;07;054;Chanaleilles;179;9;188
84;Auvergne-Rhône-Alpes;43;1;04;055;Chaniat;169;4;173
84;Auvergne-Rhône-Alpes;43;1;07;056;Chanteuges;437;13;450
84;Auvergne-Rhône-Alpes;43;2;11;057;La Chapelle-Bertin;47;2;49
84;Auvergne-Rhône-Alpes;43;3;09;058;La Chapelle-d'Aurec;1037;28;1065
84;Auvergne-Rhône-Alpes;43;1;11;059;La Chapelle-Geneste;109;1;110
84;Auvergne-Rhône-Alpes;43;1;07;060;Charraix;70;4;74
84;Auvergne-Rhône-Alpes;43;2;13;061;Chaspinhac;858;23;881
84;Auvergne-Rhône-Alpes;43;2;16;062;Chaspuzac;784;15;799
84;Auvergne-Rhône-Alpes;43;1;10;063;Chassagnes;156;2;158
84;Auvergne-Rhône-Alpes;43;1;17;064;Chassignolles;63;4;67
84;Auvergne-Rhône-Alpes;43;1;10;065;Chastel;126;4;130
84;Auvergne-Rhône-Alpes;43;2;08;066;Chaudeyrolles;112;4;116
84;Auvergne-Rhône-Alpes;43;1;10;067;Chavaniac-Lafayette;270;6;276
84;Auvergne-Rhône-Alpes;43;1;07;068;Chazelles;34;2;36
84;Auvergne-Rhône-Alpes;43;3;03;069;Chenereilles;320;7;327
84;Auvergne-Rhône-Alpes;43;1;10;070;Chilhac;177;2;179
84;Auvergne-Rhône-Alpes;43;2;11;071;Chomelix;473;6;479
84;Auvergne-Rhône-Alpes;43;1;10;072;La Chomette;154;5;159
84;Auvergne-Rhône-Alpes;43;1;11;073;Cistrières;137;3;140
84;Auvergne-Rhône-Alpes;43;1;04;074;Cohade;874;25;899
84;Auvergne-Rhône-Alpes;43;1;10;075;Collat;74;3;77
84;Auvergne-Rhône-Alpes;43;1;11;076;Connangles;142;1;143
84;Auvergne-Rhône-Alpes;43;2;18;077;Costaros;537;16;553
84;Auvergne-Rhône-Alpes;43;2;15;078;Coubon;3248;88;3336
84;Auvergne-Rhône-Alpes;43;1;10;079;Couteuges;300;11;311
84;Auvergne-Rhône-Alpes;43;2;11;080;Craponne-sur-Arzon;1966;41;2007
84;Auvergne-Rhône-Alpes;43;1;10;082;Cronce;73;2;75
84;Auvergne-Rhône-Alpes;43;1;07;083;Cubelles;151;4;155
84;Auvergne-Rhône-Alpes;43;2;18;084;Cussac-sur-Loire;1690;35;1725
84;Auvergne-Rhône-Alpes;43;1;07;085;Desges;58;5;63
84;Auvergne-Rhône-Alpes;43;1;10;086;Domeyrat;186;10;196
84;Auvergne-Rhône-Alpes;43;3;03;087;Dunières;2727;66;2793
84;Auvergne-Rhône-Alpes;43;1;17;088;Espalem;313;8;321
84;Auvergne-Rhône-Alpes;43;2;12;089;Espaly-Saint-Marcel;3512;170;3682
84;Auvergne-Rhône-Alpes;43;1;07;090;Esplantas-Vazeilles;126;4;130
84;Auvergne-Rhône-Alpes;43;2;08;091;Les Estables;328;14;342
84;Auvergne-Rhône-Alpes;43;2;08;092;Fay-sur-Lignon;357;7;364
84;Auvergne-Rhône-Alpes;43;1;11;093;Félines;321;7;328
84;Auvergne-Rhône-Alpes;43;1;10;094;Ferrussac;82;2;84
84;Auvergne-Rhône-Alpes;43;2;16;095;Fix-Saint-Geneys;128;4;132
84;Auvergne-Rhône-Alpes;43;1;04;096;Fontannes;918;234;1152
84;Auvergne-Rhône-Alpes;43;2;08;097;Freycenet-la-Cuche;106;1;107
84;Auvergne-Rhône-Alpes;43;2;08;098;Freycenet-la-Tour;108;5;113
84;Auvergne-Rhône-Alpes;43;1;17;099;Frugerès-les-Mines;554;6;560
84;Auvergne-Rhône-Alpes;43;1;10;100;Frugières-le-Pin;166;2;168
84;Auvergne-Rhône-Alpes;43;2;08;101;Goudet;58;6;64
84;Auvergne-Rhône-Alpes;43;3;19;102;Grazac;1083;17;1100
84;Auvergne-Rhône-Alpes;43;1;17;103;Grenier-Montgon;114;2;116
84;Auvergne-Rhône-Alpes;43;1;07;104;Grèzes;198;6;204
84;Auvergne-Rhône-Alpes;43;1;10;105;Javaugues;184;7;191
84;Auvergne-Rhône-Alpes;43;1;10;106;Jax;147;3;150
84;Auvergne-Rhône-Alpes;43;1;10;107;Josat;88;0;88
84;Auvergne-Rhône-Alpes;43;2;11;108;Jullianges;440;10;450
84;Auvergne-Rhône-Alpes;43;2;18;109;Lafarre;75;3;78
84;Auvergne-Rhône-Alpes;43;1;04;110;Lamothe;852;14;866
84;Auvergne-Rhône-Alpes;43;2;18;111;Landos;885;22;907
84;Auvergne-Rhône-Alpes;43;1;07;112;Langeac;3575;78;3653
84;Auvergne-Rhône-Alpes;43;2;08;113;Lantriac;1924;54;1978
84;Auvergne-Rhône-Alpes;43;3;19;114;Lapte;1721;38;1759
84;Auvergne-Rhône-Alpes;43;2;08;115;Laussonne;1014;18;1032
84;Auvergne-Rhône-Alpes;43;1;11;116;Laval-sur-Doulon;63;3;66
84;Auvergne-Rhône-Alpes;43;1;04;117;Lavaudieu;249;7;256
84;Auvergne-Rhône-Alpes;43;1;10;118;Lavoûte-Chilhac;277;4;281
84;Auvergne-Rhône-Alpes;43;2;06;119;Lavoûte-sur-Loire;836;17;853
84;Auvergne-Rhône-Alpes;43;1;17;120;Lempdes-sur-Allagnon;1334;26;1360
84;Auvergne-Rhône-Alpes;43;1;17;121;Léotoing;225;5;230
84;Auvergne-Rhône-Alpes;43;2;16;122;Lissac;282;5;287
84;Auvergne-Rhône-Alpes;43;1;17;123;Lorlanges;383;15;398
84;Auvergne-Rhône-Alpes;43;2;16;124;Loudes;925;18;943
84;Auvergne-Rhône-Alpes;43;1;10;125;Lubilhac;83;1;84
84;Auvergne-Rhône-Alpes;43;2;06;126;Malrevers;757;15;772
84;Auvergne-Rhône-Alpes;43;3;02;127;Malvalette;837;15;852
84;Auvergne-Rhône-Alpes;43;1;11;128;Malvières;133;2;135
84;Auvergne-Rhône-Alpes;43;3;03;129;Le Mas-de-Tence;159;7;166
84;Auvergne-Rhône-Alpes;43;1;10;131;Mazerat-Aurouze;197;2;199
84;Auvergne-Rhône-Alpes;43;3;08;130;Mazet-Saint-Voy;1110;29;1139
84;Auvergne-Rhône-Alpes;43;1;10;132;Mazeyrat-d'Allier;1462;43;1505
84;Auvergne-Rhône-Alpes;43;1;10;133;Mercœur;140;1;141
84;Auvergne-Rhône-Alpes;43;2;06;134;Mézères;155;4;159
84;Auvergne-Rhône-Alpes;43;2;08;135;Le Monastier-sur-Gazeille;1779;31;1810
84;Auvergne-Rhône-Alpes;43;1;07;136;Monistrol-d'Allier;206;1;207
84;Auvergne-Rhône-Alpes;43;3;09;137;Monistrol-sur-Loire;8854;424;9278
84;Auvergne-Rhône-Alpes;43;2;11;138;Monlet;416;12;428
84;Auvergne-Rhône-Alpes;43;1;10;139;Montclard;55;0;55
84;Auvergne-Rhône-Alpes;43;2;13;140;Le Monteil;680;23;703
84;Auvergne-Rhône-Alpes;43;3;03;141;Montfaucon-en-Velay;1176;24;1200
84;Auvergne-Rhône-Alpes;43;3;03;142;Montregard;591;10;601
84;Auvergne-Rhône-Alpes;43;2;08;143;Montusclat;133;0;133
84;Auvergne-Rhône-Alpes;43;2;08;144;Moudeyres;97;3;100
84;Auvergne-Rhône-Alpes;43;2;18;145;Ouides;57;0;57
84;Auvergne-Rhône-Alpes;43;1;04;147;Paulhac;637;21;658
84;Auvergne-Rhône-Alpes;43;1;10;148;Paulhaguet;868;18;886
84;Auvergne-Rhône-Alpes;43;1;07;149;Pébrac;115;4;119
84;Auvergne-Rhône-Alpes;43;2;06;150;Le Pertuis;460;13;473
84;Auvergne-Rhône-Alpes;43;1;07;151;Pinols;191;5;196
84;Auvergne-Rhône-Alpes;43;2;13;152;Polignac;2812;84;2896
84;Auvergne-Rhône-Alpes;43;3;01;153;Pont-Salomon;1960;31;1991
84;Auvergne-Rhône-Alpes;43;2;18;154;Pradelles;546;18;564
84;Auvergne-Rhône-Alpes;43;1;07;155;Prades;63;1;64
84;Auvergne-Rhône-Alpes;43;2;08;156;Présailles;115;6;121
84;Auvergne-Rhône-Alpes;43;2;99;157;Le Puy-en-Velay;19061;879;19940
84;Auvergne-Rhône-Alpes;43;2;06;158;Queyrières;319;11;330
84;Auvergne-Rhône-Alpes;43;3;03;159;Raucoules;931;24;955
84;Auvergne-Rhône-Alpes;43;2;18;160;Rauret;194;3;197
84;Auvergne-Rhône-Alpes;43;3;02;162;Retournac;2959;58;3017
84;Auvergne-Rhône-Alpes;43;3;03;163;Riotord;1177;18;1195
84;Auvergne-Rhône-Alpes;43;2;11;164;Roche-en-Régnier;493;2;495
84;Auvergne-Rhône-Alpes;43;2;06;165;Rosières;1524;30;1554
84;Auvergne-Rhône-Alpes;43;3;02;166;Saint-André-de-Chalencon;366;16;382
84;Auvergne-Rhône-Alpes;43;1;07;167;Saint-Arcons-d'Allier;190;4;194
84;Auvergne-Rhône-Alpes;43;2;18;168;Saint-Arcons-de-Barges;118;1;119
84;Auvergne-Rhône-Alpes;43;1;10;169;Saint-Austremoine;48;0;48
84;Auvergne-Rhône-Alpes;43;1;10;170;Saint-Beauzire;449;6;455
84;Auvergne-Rhône-Alpes;43;1;07;171;Saint-Bérain;87;3;90
84;Auvergne-Rhône-Alpes;43;3;03;172;Saint-Bonnet-le-Froid;229;2;231
84;Auvergne-Rhône-Alpes;43;1;07;173;Saint-Christophe-d'Allier;91;2;93
84;Auvergne-Rhône-Alpes;43;2;18;174;Saint-Christophe-sur-Dolaison;956;12;968
84;Auvergne-Rhône-Alpes;43;1;10;175;Saint-Cirgues;166;6;172
84;Auvergne-Rhône-Alpes;43;3;05;177;Saint-Didier-en-Velay;3443;53;3496
84;Auvergne-Rhône-Alpes;43;1;10;178;Saint-Didier-sur-Doulon;195;8;203
84;Auvergne-Rhône-Alpes;43;2;18;180;Saint-Étienne-du-Vigan;99;5;104
84;Auvergne-Rhône-Alpes;43;2;06;181;Saint-Étienne-Lardeyrol;759;20;779
84;Auvergne-Rhône-Alpes;43;1;17;182;Saint-Étienne-sur-Blesle;54;0;54
84;Auvergne-Rhône-Alpes;43;3;01;184;Saint-Ferréol-d'Auroure;2472;31;2503
84;Auvergne-Rhône-Alpes;43;2;08;186;Saint-Front;402;4;406
84;Auvergne-Rhône-Alpes;43;2;16;187;Saint-Geneys-près-Saint-Paulien;320;4;324
84;Auvergne-Rhône-Alpes;43;1;10;188;Saint-Georges-d'Aurac;469;8;477
84;Auvergne-Rhône-Alpes;43;2;11;189;Saint-Georges-Lagricol;523;13;536
84;Auvergne-Rhône-Alpes;43;2;14;190;Saint-Germain-Laprade;3653;82;3735
84;Auvergne-Rhône-Alpes;43;1;04;191;Saint-Géron;254;4;258
84;Auvergne-Rhône-Alpes;43;2;18;192;Saint-Haon;291;11;302
84;Auvergne-Rhône-Alpes;43;1;17;193;Saint-Hilaire;159;1;160
84;Auvergne-Rhône-Alpes;43;2;06;194;Saint-Hostien;736;22;758
84;Auvergne-Rhône-Alpes;43;1;10;195;Saint-Ilpize;188;5;193
84;Auvergne-Rhône-Alpes;43;2;11;196;Saint-Jean-d'Aubrigoux;177;2;179
84;Auvergne-Rhône-Alpes;43;2;16;197;Saint-Jean-de-Nay;352;5;357
84;Auvergne-Rhône-Alpes;43;2;18;198;Saint-Jean-Lachalm;292;8;300
84;Auvergne-Rhône-Alpes;43;3;03;199;Saint-Jeures;965;26;991
84;Auvergne-Rhône-Alpes;43;2;06;200;Saint-Julien-Chapteuil;1959;42;2001
84;Auvergne-Rhône-Alpes;43;2;11;201;Saint-Julien-d'Ance;247;8;255
84;Auvergne-Rhône-Alpes;43;1;07;202;Saint-Julien-des-Chazes;69;1;70
84;Auvergne-Rhône-Alpes;43;3;19;203;Saint-Julien-du-Pinet;478;13;491
84;Auvergne-Rhône-Alpes;43;3;03;204;Saint-Julien-Molhesabate;177;1;178
84;Auvergne-Rhône-Alpes;43;3;01;205;Saint-Just-Malmont;4209;59;4268
84;Auvergne-Rhône-Alpes;43;1;10;206;Saint-Just-près-Brioude;419;16;435
84;Auvergne-Rhône-Alpes;43;1;04;207;Saint-Laurent-Chabreuges;252;11;263
84;Auvergne-Rhône-Alpes;43;2;08;210;Saint-Martin-de-Fugères;224;7;231
84;Auvergne-Rhône-Alpes;43;3;09;211;Saint-Maurice-de-Lignon;2637;71;2708
84;Auvergne-Rhône-Alpes;43;3;11;212;Saint-Pal-de-Chalencon;1015;16;1031
84;Auvergne-Rhône-Alpes;43;3;05;213;Saint-Pal-de-Mons;2284;52;2336
84;Auvergne-Rhône-Alpes;43;1;11;214;Saint-Pal-de-Senouire;109;3;112
84;Auvergne-Rhône-Alpes;43;2;18;215;Saint-Paul-de-Tartas;187;5;192
84;Auvergne-Rhône-Alpes;43;2;16;216;Saint-Paulien;2425;56;2481
84;Auvergne-Rhône-Alpes;43;2;11;217;Saint-Pierre-du-Champ;542;11;553
84;Auvergne-Rhône-Alpes;43;2;06;218;Saint-Pierre-Eynac;1168;27;1195
84;Auvergne-Rhône-Alpes;43;1;10;219;Saint-Préjet-Armandon;111;4;115
84;Auvergne-Rhône-Alpes;43;1;07;220;Saint-Préjet-d'Allier;171;4;175
84;Auvergne-Rhône-Alpes;43;2;16;221;Saint-Privat-d'Allier ;398;13;411
84;Auvergne-Rhône-Alpes;43;1;10;222;Saint-Privat-du-Dragon;160;1;161
84;Auvergne-Rhône-Alpes;43;3;03;223;Saint-Romain-Lachalm;1104;24;1128
84;Auvergne-Rhône-Alpes;43;1;07;225;Saint-Vénérand;52;0;52
84;Auvergne-Rhône-Alpes;43;1;17;226;Saint-Vert;109;4;113
84;Auvergne-Rhône-Alpes;43;3;05;227;Saint-Victor-Malescours;820;16;836
84;Auvergne-Rhône-Alpes;43;2;11;228;Saint-Victor-sur-Arlanc;91;2;93
84;Auvergne-Rhône-Alpes;43;2;16;229;Saint-Vidal;610;9;619
84;Auvergne-Rhône-Alpes;43;2;06;230;Saint-Vincent;1020;19;1039
84;Auvergne-Rhône-Alpes;43;1;10;183;Sainte-Eugénie-de-Villeneuve;109;2;111
84;Auvergne-Rhône-Alpes;43;1;17;185;Sainte-Florine;3185;77;3262
84;Auvergne-Rhône-Alpes;43;1;10;208;Sainte-Marguerite;44;2;46
84;Auvergne-Rhône-Alpes;43;3;05;224;Sainte-Sigolène;5959;100;6059
84;Auvergne-Rhône-Alpes;43;2;08;231;Salettes;136;4;140
84;Auvergne-Rhône-Alpes;43;1;10;232;Salzuit;362;5;367
84;Auvergne-Rhône-Alpes;43;2;16;233;Sanssac-l'Église;1097;41;1138
84;Auvergne-Rhône-Alpes;43;1;07;234;Saugues;1701;124;1825
84;Auvergne-Rhône-Alpes;43;3;05;236;La Séauve-sur-Semène;1475;20;1495
84;Auvergne-Rhône-Alpes;43;1;11;237;Sembadel;227;6;233
84;Auvergne-Rhône-Alpes;43;2;18;238;Séneujols;304;7;311
84;Auvergne-Rhône-Alpes;43;1;07;239;Siaugues-Sainte-Marie;800;15;815
84;Auvergne-Rhône-Alpes;43;3;02;240;Solignac-sous-Roche;253;7;260
84;Auvergne-Rhône-Alpes;43;2;18;241;Solignac-sur-Loire;1275;32;1307
84;Auvergne-Rhône-Alpes;43;1;07;242;Tailhac;72;3;75
84;Auvergne-Rhône-Alpes;43;3;03;244;Tence;3095;45;3140
84;Auvergne-Rhône-Alpes;43;1;07;245;Thoras;226;8;234
84;Auvergne-Rhône-Alpes;43;3;02;246;Tiranges;472;17;489
84;Auvergne-Rhône-Alpes;43;1;17;247;Torsiac;66;1;67
84;Auvergne-Rhône-Alpes;43;3;02;249;Valprivas;522;11;533
84;Auvergne-Rhône-Alpes;43;1;10;250;Vals-le-Chastel;43;3;46
84;Auvergne-Rhône-Alpes;43;2;12;251;Vals-près-le-Puy;3437;121;3558
84;Auvergne-Rhône-Alpes;43;2;11;252;Varennes-Saint-Honorat;24;2;26
84;Auvergne-Rhône-Alpes;43;2;08;253;Les Vastres;197;9;206
84;Auvergne-Rhône-Alpes;43;2;16;254;Vazeilles-Limandre;258;4;262
84;Auvergne-Rhône-Alpes;43;1;07;256;Venteuges;343;6;349
84;Auvergne-Rhône-Alpes;43;2;16;257;Vergezac;507;7;514
84;Auvergne-Rhône-Alpes;43;1;17;258;Vergongheon;1833;52;1885
84;Auvergne-Rhône-Alpes;43;2;16;259;Vernassal;358;11;369
84;Auvergne-Rhône-Alpes;43;2;16;260;Le Vernet;23;0;23
84;Auvergne-Rhône-Alpes;43;1;17;261;Vézézoux;606;6;612
84;Auvergne-Rhône-Alpes;43;1;04;262;Vieille-Brioude;1182;37;1219
84;Auvergne-Rhône-Alpes;43;2;18;263;Vielprat;61;0;61
84;Auvergne-Rhône-Alpes;43;1;10;264;Villeneuve-d'Allier;284;15;299
84;Auvergne-Rhône-Alpes;43;3;09;265;Les Villettes;1433;45;1478
84;Auvergne-Rhône-Alpes;43;1;10;013;Vissac-Auteyrac;317;10;327
84;Auvergne-Rhône-Alpes;43;2;06;267;Vorey;1461;15;1476
84;Auvergne-Rhône-Alpes;43;3;19;268;Yssingeaux;7245;466;7711
52;Pays de la Loire;44;5;08;001;Abbaretz;2079;40;2119
52;Pays de la Loire;44;2;07;002;Aigrefeuille-sur-Maine;3970;133;4103
52;Pays de la Loire;44;5;01;003;Ancenis-Saint-Géréon ;11012;393;11405
52;Pays de la Loire;44;3;09;006;Assérac;1818;42;1860
52;Pays de la Loire;44;5;19;007;Avessac;2468;55;2523
52;Pays de la Loire;44;2;29;009;Basse-Goulaine;9093;238;9331
52;Pays de la Loire;44;3;02;010;Batz-sur-Mer;2865;73;2938
52;Pays de la Loire;44;3;02;055;La Baule-Escoublac;16117;541;16658
52;Pays de la Loire;44;3;20;012;La Bernerie-en-Retz;3016;44;3060
52;Pays de la Loire;44;3;27;013;Besné;3117;40;3157
52;Pays de la Loire;44;2;28;014;Le Bignon;3840;70;3910
52;Pays de la Loire;44;5;03;015;Blain;9873;172;10045
52;Pays de la Loire;44;2;30;016;La Boissière-du-Doré;1049;18;1067
52;Pays de la Loire;44;2;21;018;Bouaye;7914;138;8052
52;Pays de la Loire;44;3;03;019;Bouée;997;14;1011
52;Pays de la Loire;44;2;21;020;Bouguenais;19658;304;19962
52;Pays de la Loire;44;2;07;022;Boussay;2643;49;2692
52;Pays de la Loire;44;5;03;023;Bouvron;3092;45;3137
52;Pays de la Loire;44;2;21;024;Brains;2836;58;2894
52;Pays de la Loire;44;3;03;025;Campbon;3979;67;4046
52;Pays de la Loire;44;2;04;026;Carquefou;20032;462;20494
52;Pays de la Loire;44;5;18;027;Casson;2331;27;2358
52;Pays de la Loire;44;5;18;028;Le Cellier;3884;104;3988
52;Pays de la Loire;44;3;09;030;La Chapelle-des-Marais;4262;90;4352
52;Pays de la Loire;44;5;06;031;La Chapelle-Glain;808;8;816
52;Pays de la Loire;44;2;30;032;La Chapelle-Heulin;3280;48;3328
52;Pays de la Loire;44;3;03;033;La Chapelle-Launay;3113;44;3157
52;Pays de la Loire;44;2;05;035;La Chapelle-sur-Erdre;19526;407;19933
52;Pays de la Loire;44;2;31;037;Château-Thébaud;3060;173;3233
52;Pays de la Loire;44;5;06;036;Châteaubriant;12011;495;12506
52;Pays de la Loire;44;3;89;005;Chaumes-en-Retz;6827;105;6932
52;Pays de la Loire;44;3;20;038;Chauvé;2892;45;2937
52;Pays de la Loire;44;2;10;039;Cheix-en-Retz;1086;8;1094
52;Pays de la Loire;44;5;08;221;La Chevallerais;1541;19;1560
52;Pays de la Loire;44;2;28;041;La Chevrolière;5688;87;5775
52;Pays de la Loire;44;2;07;043;Clisson;7399;240;7639
52;Pays de la Loire;44;5;08;044;Conquereuil;1105;28;1133
52;Pays de la Loire;44;2;28;156;Corcoué-sur-Logne;2982;39;3021
52;Pays de la Loire;44;2;03;045;Cordemais;3729;47;3776
52;Pays de la Loire;44;3;23;046;Corsept;2651;55;2706
52;Pays de la Loire;44;2;24;047;Couëron;21862;275;22137
52;Pays de la Loire;44;5;01;048;Couffé;2556;52;2608
52;Pays de la Loire;44;3;02;049;Le Croisic;4120;56;4176
52;Pays de la Loire;44;3;19;050;Crossac;2972;26;2998
52;Pays de la Loire;44;5;08;051;Derval;3496;428;3924
52;Pays de la Loire;44;2;30;029;Divatte-sur-Loire;6909;121;7030
52;Pays de la Loire;44;3;27;052;Donges;8038;92;8130
52;Pays de la Loire;44;3;19;053;Drefféac;2243;36;2279
52;Pays de la Loire;44;5;06;054;Erbray;3030;72;3102
52;Pays de la Loire;44;5;05;056;Fay-de-Bretagne;3647;61;3708
52;Pays de la Loire;44;5;19;057;Fégréac;2395;63;2458
52;Pays de la Loire;44;5;06;058;Fercé;475;11;486
52;Pays de la Loire;44;3;23;061;Frossay;3218;57;3275
52;Pays de la Loire;44;5;03;062;Le Gâvre;1813;41;1854
52;Pays de la Loire;44;2;28;223;Geneston;3648;47;3695
52;Pays de la Loire;44;2;07;063;Gétigné;3691;88;3779
52;Pays de la Loire;44;2;07;064;Gorges;4752;363;5115
52;Pays de la Loire;44;5;06;065;Grand-Auverné;768;21;789
52;Pays de la Loire;44;5;05;066;Grandchamps-des-Fontaines;6182;112;6294
52;Pays de la Loire;44;5;08;224;La Grigonnais;1693;21;1714
52;Pays de la Loire;44;5;08;067;Guémené-Penfao;5207;81;5288
52;Pays de la Loire;44;3;19;068;Guenrouet;3357;54;3411
52;Pays de la Loire;44;3;09;069;Guérande;16107;574;16681
52;Pays de la Loire;44;2;31;070;La Haie-Fouassière;4675;111;4786
52;Pays de la Loire;44;2;29;071;Haute-Goulaine;5833;155;5988
52;Pays de la Loire;44;3;09;072;Herbignac;6930;125;7055
52;Pays de la Loire;44;5;18;073;Héric;6168;112;6280
52;Pays de la Loire;44;2;24;074;Indre;4037;45;4082
52;Pays de la Loire;44;5;06;075;Issé;1814;39;1853
52;Pays de la Loire;44;5;08;076;Jans;1378;21;1399
52;Pays de la Loire;44;5;18;077;Joué-sur-Erdre;2516;33;2549
52;Pays de la Loire;44;5;06;078;Juigné-des-Moutiers;338;3;341
52;Pays de la Loire;44;2;30;079;Le Landreau;3024;295;3319
52;Pays de la Loire;44;3;03;080;Lavau-sur-Loire;769;26;795
52;Pays de la Loire;44;2;28;081;Legé;4530;112;4642
52;Pays de la Loire;44;5;18;082;Ligné;5232;104;5336
52;Pays de la Loire;44;2;28;083;La Limouzinière;2442;29;2471
52;Pays de la Loire;44;5;01;213;Loireauxence;7501;132;7633
52;Pays de la Loire;44;2;30;084;Le Loroux-Bottereau;8327;134;8461
52;Pays de la Loire;44;5;06;085;Louisfert;1008;41;1049
52;Pays de la Loire;44;5;08;086;Lusanger;1058;21;1079
52;Pays de la Loire;44;2;10;087;Machecoul-Saint-Même;7553;235;7788
52;Pays de la Loire;44;2;07;088;Maisdon-sur-Sèvre;2982;43;3025
52;Pays de la Loire;44;3;03;089;Malville;3463;54;3517
52;Pays de la Loire;44;2;10;090;La Marne;1558;17;1575
52;Pays de la Loire;44;5;08;091;Marsac-sur-Don;1515;15;1530
52;Pays de la Loire;44;5;08;092;Massérac;691;13;704
52;Pays de la Loire;44;2;04;094;Mauves-sur-Loire;3230;64;3294
52;Pays de la Loire;44;5;06;095;La Meilleraye-de-Bretagne;1541;24;1565
52;Pays de la Loire;44;5;01;096;Mésanger;4697;80;4777
52;Pays de la Loire;44;3;09;097;Mesquer;1990;44;2034
52;Pays de la Loire;44;3;19;098;Missillac;5367;68;5435
52;Pays de la Loire;44;5;06;099;Moisdon-la-Rivière;1960;60;2020
52;Pays de la Loire;44;2;07;100;Monnières;2263;60;2323
52;Pays de la Loire;44;2;23;101;La Montagne;6261;144;6405
52;Pays de la Loire;44;2;28;102;Montbert;3153;54;3207
52;Pays de la Loire;44;3;27;103;Montoir-de-Bretagne;7148;79;7227
52;Pays de la Loire;44;5;01;104;Montrelais;844;11;855
52;Pays de la Loire;44;5;08;105;Mouais;378;7;385
52;Pays de la Loire;44;3;20;106;Les Moutiers-en-Retz;1703;20;1723
52;Pays de la Loire;44;5;18;107;Mouzeil;1908;25;1933
52;Pays de la Loire;44;2;30;108;Mouzillon;2847;54;2901
52;Pays de la Loire;44;2;96;109;Nantes;314138;5146;319284
52;Pays de la Loire;44;5;18;110;Nort-sur-Erdre;8925;191;9116
52;Pays de la Loire;44;5;18;111;Notre-Dame-des-Landes;2223;25;2248
52;Pays de la Loire;44;5;06;112;Noyal-sur-Brutz;591;11;602
52;Pays de la Loire;44;5;08;113;Nozay;4173;88;4261
52;Pays de la Loire;44;2;25;114;Orvault;26924;699;27623
52;Pays de la Loire;44;5;01;115;Oudon;3843;66;3909
52;Pays de la Loire;44;3;23;116;Paimbœuf;3056;111;3167
52;Pays de la Loire;44;2;30;117;Le Pallet;3248;50;3298
52;Pays de la Loire;44;5;01;118;Pannecé;1387;24;1411
52;Pays de la Loire;44;2;10;119;Paulx;1976;27;2003
52;Pays de la Loire;44;2;23;120;Le Pellerin;5149;198;5347
52;Pays de la Loire;44;5;06;121;Petit-Auverné;427;4;431
52;Pays de la Loire;44;5;18;122;Petit-Mars;3676;52;3728
52;Pays de la Loire;44;5;08;123;Pierric;989;17;1006
52;Pays de la Loire;44;5;01;124;Le Pin;753;15;768
52;Pays de la Loire;44;3;09;125;Piriac-sur-Mer;2239;50;2289
52;Pays de la Loire;44;3;20;126;La Plaine-sur-Mer;4369;86;4455
52;Pays de la Loire;44;2;07;127;La Planche;2670;31;2701
52;Pays de la Loire;44;5;19;128;Plessé;5257;120;5377
52;Pays de la Loire;44;2;28;130;Pont-Saint-Martin;6196;83;6279
52;Pays de la Loire;44;3;19;129;Pontchâteau;10771;250;11021
52;Pays de la Loire;44;3;20;131;Pornic;15570;432;16002
52;Pays de la Loire;44;3;02;132;Pornichet;10952;298;11250
52;Pays de la Loire;44;2;10;133;Port-Saint-Père;2911;44;2955
52;Pays de la Loire;44;5;01;134;Pouillé-les-Côteaux;1057;22;1079
52;Pays de la Loire;44;3;02;135;Le Pouliguen;4145;96;4241
52;Pays de la Loire;44;3;20;136;Préfailles;1242;27;1269
52;Pays de la Loire;44;3;03;137;Prinquiau;3442;66;3508
52;Pays de la Loire;44;5;08;138;Puceul;1140;17;1157
52;Pays de la Loire;44;3;03;139;Quilly;1385;10;1395
52;Pays de la Loire;44;2;30;140;La Regrippière;1529;25;1554
52;Pays de la Loire;44;2;30;141;La Remaudière;1287;13;1300
52;Pays de la Loire;44;2;07;142;Remouillé;1934;34;1968
52;Pays de la Loire;44;2;97;143;Rezé;42368;785;43153
52;Pays de la Loire;44;5;18;144;Riaillé;2342;57;2399
52;Pays de la Loire;44;5;01;222;La Roche-Blanche;1210;21;1231
52;Pays de la Loire;44;2;10;145;Rouans;3015;37;3052
52;Pays de la Loire;44;5;06;146;Rougé;2215;42;2257
52;Pays de la Loire;44;5;06;148;Ruffigné;697;8;705
52;Pays de la Loire;44;5;08;149;Saffré;3947;49;3996
52;Pays de la Loire;44;2;21;150;Saint-Aignan-Grandlieu;3960;59;4019
52;Pays de la Loire;44;3;02;151;Saint-André-des-Eaux;6558;173;6731
52;Pays de la Loire;44;5;06;153;Saint-Aubin-des-Châteaux;1784;53;1837
52;Pays de la Loire;44;3;23;154;Saint-Brevin-les-Pins;14118;312;14430
52;Pays de la Loire;44;2;28;155;Saint-Colomban;3386;74;3460
52;Pays de la Loire;44;2;10;157;Saint-Étienne-de-Mer-Morte;1730;22;1752
52;Pays de la Loire;44;2;03;158;Saint-Étienne-de-Montluc;7300;188;7488
52;Pays de la Loire;44;2;31;159;Saint-Fiacre-sur-Maine;1225;23;1248
52;Pays de la Loire;44;3;19;161;Saint-Gildas-des-Bois;3771;69;3840
52;Pays de la Loire;44;2;98;162;Saint-Herblain;46352;710;47062
52;Pays de la Loire;44;3;10;164;Saint-Hilaire-de-Chaléons;2304;45;2349
52;Pays de la Loire;44;2;07;165;Saint-Hilaire-de-Clisson;2303;47;2350
52;Pays de la Loire;44;2;23;166;Saint-Jean-de-Boiseau;5961;112;6073
52;Pays de la Loire;44;3;09;168;Saint-Joachim;4082;63;4145
52;Pays de la Loire;44;2;30;169;Saint-Julien-de-Concelles;7123;102;7225
52;Pays de la Loire;44;5;06;170;Saint-Julien-de-Vouvantes;976;22;998
52;Pays de la Loire;44;2;21;171;Saint-Léger-les-Vignes;1902;32;1934
52;Pays de la Loire;44;2;07;173;Saint-Lumine-de-Clisson;2098;46;2144
52;Pays de la Loire;44;2;28;174;Saint-Lumine-de-Coutais;2196;38;2234
52;Pays de la Loire;44;3;09;175;Saint-Lyphard;4768;93;4861
52;Pays de la Loire;44;3;27;176;Saint-Malo-de-Guersac;3181;54;3235
52;Pays de la Loire;44;2;10;178;Saint-Mars-de-Coutais;2591;42;2633
52;Pays de la Loire;44;5;18;179;Saint-Mars-du-Désert;5009;83;5092
52;Pays de la Loire;44;3;20;182;Saint-Michel-Chef-Chef;5173;88;5261
52;Pays de la Loire;44;3;09;183;Saint-Molf;2683;58;2741
52;Pays de la Loire;44;3;99;184;Saint-Nazaire;70619;1733;72352
52;Pays de la Loire;44;5;19;185;Saint-Nicolas-de-Redon;3211;66;3277
52;Pays de la Loire;44;3;23;187;Saint-Père-en-Retz;4570;152;4722
52;Pays de la Loire;44;2;28;188;Saint-Philbert-de-Grand-Lieu;8991;192;9183
52;Pays de la Loire;44;2;29;190;Saint-Sébastien-sur-Loire;27383;680;28063
52;Pays de la Loire;44;3;23;192;Saint-Viaud;2564;43;2607
52;Pays de la Loire;44;5;08;193;Saint-Vincent-des-Landes;1526;26;1552
52;Pays de la Loire;44;3;19;152;Sainte-Anne-sur-Brivet;2950;54;3004
52;Pays de la Loire;44;2;04;172;Sainte-Luce-sur-Loire;15238;272;15510
52;Pays de la Loire;44;2;10;186;Sainte-Pazanne;6889;130;7019
52;Pays de la Loire;44;3;19;189;Sainte-Reine-de-Bretagne;2385;34;2419
52;Pays de la Loire;44;2;24;194;Sautron;8451;164;8615
52;Pays de la Loire;44;3;03;195;Savenay;8872;182;9054
52;Pays de la Loire;44;3;19;196;Sévérac;1629;26;1655
52;Pays de la Loire;44;5;08;197;Sion-les-Mines;1608;33;1641
52;Pays de la Loire;44;2;31;198;Les Sorinières;8694;131;8825
52;Pays de la Loire;44;5;06;199;Soudan;1998;56;2054
52;Pays de la Loire;44;5;06;200;Soulvache;346;7;353
52;Pays de la Loire;44;5;05;201;Sucé-sur-Erdre;7087;197;7284
52;Pays de la Loire;44;5;18;202;Teillé;1797;25;1822
52;Pays de la Loire;44;2;03;203;Le Temple-de-Bretagne;2006;17;2023
52;Pays de la Loire;44;2;04;204;Thouaré-sur-Loire;10261;176;10437
52;Pays de la Loire;44;5;18;205;Les Touches;2476;29;2505
52;Pays de la Loire;44;2;28;206;Touvois;1851;25;1876
52;Pays de la Loire;44;5;18;207;Trans-sur-Erdre;1085;10;1095
52;Pays de la Loire;44;5;08;208;Treffieux;902;11;913
52;Pays de la Loire;44;5;05;209;Treillières;9459;242;9701
52;Pays de la Loire;44;3;27;210;Trignac;7926;80;8006
52;Pays de la Loire;44;3;09;211;La Turballe;4580;93;4673
52;Pays de la Loire;44;5;01;163;Vair-sur-Loire;4717;105;4822
52;Pays de la Loire;44;2;30;212;Vallet;9182;176;9358
52;Pays de la Loire;44;5;01;180;Vallons-de-l'Erdre ;6549;127;6676
52;Pays de la Loire;44;5;08;214;Vay;2033;29;2062
52;Pays de la Loire;44;2;31;215;Vertou;25045;588;25633
52;Pays de la Loire;44;2;07;216;Vieillevigne;3957;74;4031
52;Pays de la Loire;44;5;05;217;Vigneux-de-Bretagne;6097;128;6225
52;Pays de la Loire;44;3;10;021;Villeneuve-en-Retz;4911;87;4998
52;Pays de la Loire;44;5;06;218;Villepot;675;14;689
52;Pays de la Loire;44;2;10;220;Vue;1626;25;1651
24;Centre-Val de Loire;45;1;07;001;Adon;211;5;216
24;Centre-Val de Loire;45;1;08;002;Aillant-sur-Milleron;391;5;396
24;Centre-Val de Loire;45;1;02;004;Amilly;13099;590;13689
24;Centre-Val de Loire;45;3;17;005;Andonville;254;6;260
24;Centre-Val de Loire;45;2;05;006;Ardon;1092;28;1120
24;Centre-Val de Loire;45;2;10;008;Artenay;1920;30;1950
24;Centre-Val de Loire;45;3;17;009;Aschères-le-Marché;1141;30;1171
24;Centre-Val de Loire;45;3;09;010;Ascoux;1132;40;1172
24;Centre-Val de Loire;45;3;17;011;Attray;209;4;213
24;Centre-Val de Loire;45;3;17;012;Audeville;187;3;190
24;Centre-Val de Loire;45;3;09;013;Augerville-la-Rivière;230;8;238
24;Centre-Val de Loire;45;3;09;014;Aulnay-la-Rivière;502;13;515
24;Centre-Val de Loire;45;3;17;015;Autruy-sur-Juine;690;13;703
24;Centre-Val de Loire;45;1;07;016;Autry-le-Châtel;965;28;993
24;Centre-Val de Loire;45;1;08;017;Auvilliers-en-Gâtinais;350;3;353
24;Centre-Val de Loire;45;3;09;018;Auxy;979;18;997
24;Centre-Val de Loire;45;2;01;019;Baccon;672;28;700
24;Centre-Val de Loire;45;2;10;020;Le Bardon;1011;18;1029
24;Centre-Val de Loire;45;3;09;021;Barville-en-Gâtinais;318;6;324
24;Centre-Val de Loire;45;3;09;022;Batilly-en-Gâtinais;453;4;457
24;Centre-Val de Loire;45;1;07;023;Batilly-en-Puisaye;115;2;117
24;Centre-Val de Loire;45;2;01;024;Baule;2067;39;2106
24;Centre-Val de Loire;45;3;17;025;Bazoches-les-Gallerandes;1545;21;1566
24;Centre-Val de Loire;45;1;04;026;Bazoches-sur-le-Betz;957;15;972
24;Centre-Val de Loire;45;1;08;027;Beauchamps-sur-Huillard;398;8;406
24;Centre-Val de Loire;45;2;01;028;Beaugency;7322;186;7508
24;Centre-Val de Loire;45;1;07;029;Beaulieu-sur-Loire;1793;21;1814
24;Centre-Val de Loire;45;3;09;030;Beaune-la-Rolande;2015;129;2144
24;Centre-Val de Loire;45;1;08;031;Bellegarde;1537;86;1623
24;Centre-Val de Loire;45;1;04;032;Le Bignon-Mirabeau;320;8;328
24;Centre-Val de Loire;45;3;09;033;Boësses;377;20;397
24;Centre-Val de Loire;45;2;18;034;Boigny-sur-Bionne;2111;50;2161
24;Centre-Val de Loire;45;3;09;035;Boiscommun;1137;23;1160
24;Centre-Val de Loire;45;1;07;036;Boismorand;832;28;860
24;Centre-Val de Loire;45;3;17;037;Boisseaux;500;10;510
24;Centre-Val de Loire;45;3;09;038;Bondaroy;411;12;423
24;Centre-Val de Loire;45;2;21;039;Bonnée;713;16;729
24;Centre-Val de Loire;45;1;07;040;Bonny-sur-Loire;1909;26;1935
24;Centre-Val de Loire;45;3;09;041;Bordeaux-en-Gâtinais;109;3;112
24;Centre-Val de Loire;45;2;21;042;Les Bordes;1911;46;1957
24;Centre-Val de Loire;45;2;18;043;Bou;980;24;1004
24;Centre-Val de Loire;45;2;17;044;Bougy-lez-Neuville;160;7;167
24;Centre-Val de Loire;45;3;09;045;Bouilly-en-Gâtinais;316;12;328
24;Centre-Val de Loire;45;2;10;046;Boulay-les-Barres;1018;18;1036
24;Centre-Val de Loire;45;3;09;047;Bouzonville-aux-Bois;421;13;434
24;Centre-Val de Loire;45;2;03;049;Bouzy-la-Forêt;1219;31;1250
24;Centre-Val de Loire;45;3;09;050;Boynes;1339;38;1377
24;Centre-Val de Loire;45;2;21;051;Bray-Saint-Aignan;1734;34;1768
24;Centre-Val de Loire;45;1;07;052;Breteau;96;0;96
24;Centre-Val de Loire;45;1;07;053;Briare;5207;95;5302
24;Centre-Val de Loire;45;3;09;054;Briarres-sur-Essonne;546;10;556
24;Centre-Val de Loire;45;2;10;055;Bricy;552;15;567
24;Centre-Val de Loire;45;3;09;056;Bromeilles;326;6;332
24;Centre-Val de Loire;45;2;10;058;Bucy-le-Roi;174;7;181
24;Centre-Val de Loire;45;2;10;059;Bucy-Saint-Liphard;186;1;187
24;Centre-Val de Loire;45;1;07;060;La Bussière;795;18;813
24;Centre-Val de Loire;45;1;02;061;Cepoy;2381;53;2434
24;Centre-Val de Loire;45;2;10;062;Cercottes;1479;24;1503
24;Centre-Val de Loire;45;2;21;063;Cerdon;938;19;957
24;Centre-Val de Loire;45;1;07;064;Cernoy-en-Berry;450;10;460
24;Centre-Val de Loire;45;3;17;065;Césarville-Dossainville;257;3;260
24;Centre-Val de Loire;45;1;08;066;Chailly-en-Gâtinais;682;11;693
24;Centre-Val de Loire;45;2;10;067;Chaingy;3775;111;3886
24;Centre-Val de Loire;45;1;02;068;Châlette-sur-Loing;12790;261;13051
24;Centre-Val de Loire;45;3;09;069;Chambon-la-Forêt;953;14;967
24;Centre-Val de Loire;45;1;07;070;Champoulet;61;0;61
24;Centre-Val de Loire;45;2;06;072;Chanteau;1508;21;1529
24;Centre-Val de Loire;45;1;04;073;Chantecoq;491;8;499
24;Centre-Val de Loire;45;2;10;074;La Chapelle-Onzerain;120;2;122
24;Centre-Val de Loire;45;2;19;075;La Chapelle-Saint-Mesmin;10205;221;10426
24;Centre-Val de Loire;45;1;04;076;La Chapelle-Saint-Sépulcre;237;7;244
24;Centre-Val de Loire;45;1;08;077;La Chapelle-sur-Aveyron;630;6;636
24;Centre-Val de Loire;45;1;08;078;Chapelon;255;1;256
24;Centre-Val de Loire;45;1;08;079;Le Charme;153;0;153
24;Centre-Val de Loire;45;3;17;080;Charmont-en-Beauce;358;15;373
24;Centre-Val de Loire;45;2;10;081;Charsonville;615;16;631
24;Centre-Val de Loire;45;1;04;083;Château-Renard;2153;35;2188
24;Centre-Val de Loire;45;2;03;082;Châteauneuf-sur-Loire;8176;119;8295
24;Centre-Val de Loire;45;1;08;084;Châtenoy;458;9;467
24;Centre-Val de Loire;45;1;08;085;Châtillon-Coligny;1881;26;1907
24;Centre-Val de Loire;45;3;17;086;Châtillon-le-Roi;276;8;284
24;Centre-Val de Loire;45;1;07;087;Châtillon-sur-Loire;3126;52;3178
24;Centre-Val de Loire;45;3;17;088;Chaussy;305;10;315
24;Centre-Val de Loire;45;2;18;089;Chécy;8636;174;8810
24;Centre-Val de Loire;45;1;04;091;Chevannes;320;13;333
24;Centre-Val de Loire;45;1;11;092;Chevillon-sur-Huillard;1442;35;1477
24;Centre-Val de Loire;45;2;10;093;Chevilly;2660;39;2699
24;Centre-Val de Loire;45;1;04;094;Chevry-sous-le-Bignon;224;2;226
24;Centre-Val de Loire;45;3;09;095;Chilleurs-aux-Bois;2027;41;2068
24;Centre-Val de Loire;45;1;07;096;Les Choux;519;8;527
24;Centre-Val de Loire;45;1;04;097;Chuelles;1202;13;1215
24;Centre-Val de Loire;45;2;01;098;Cléry-Saint-André;3434;67;3501
24;Centre-Val de Loire;45;2;10;099;Coinces;524;9;533
24;Centre-Val de Loire;45;2;18;100;Combleux;493;21;514
24;Centre-Val de Loire;45;2;03;101;Combreux;276;6;282
24;Centre-Val de Loire;45;1;02;102;Conflans-sur-Loing;360;10;370
24;Centre-Val de Loire;45;1;04;103;Corbeilles;1547;19;1566
24;Centre-Val de Loire;45;1;02;104;Corquilleroy;2798;55;2853
24;Centre-Val de Loire;45;1;08;105;Cortrat;76;2;78
24;Centre-Val de Loire;45;1;08;107;Coudroy;320;0;320
24;Centre-Val de Loire;45;1;21;108;Coullons;2309;36;2345
24;Centre-Val de Loire;45;2;10;109;Coulmiers;542;11;553
24;Centre-Val de Loire;45;1;08;112;La Cour-Marigny;344;11;355
24;Centre-Val de Loire;45;3;09;110;Courcelles-le-Roi;310;2;312
24;Centre-Val de Loire;45;3;09;111;Courcy-aux-Loges;447;3;450
24;Centre-Val de Loire;45;1;04;113;Courtemaux;258;5;263
24;Centre-Val de Loire;45;1;04;114;Courtempierre;235;5;240
24;Centre-Val de Loire;45;1;04;115;Courtenay;3966;66;4032
24;Centre-Val de Loire;45;2;01;116;Cravant;966;24;990
24;Centre-Val de Loire;45;3;17;118;Crottes-en-Pithiverais;339;6;345
24;Centre-Val de Loire;45;3;17;119;Dadonville;2424;65;2489
24;Centre-Val de Loire;45;1;07;120;Dammarie-en-Puisaye;173;2;175
24;Centre-Val de Loire;45;1;08;121;Dammarie-sur-Loing;480;9;489
24;Centre-Val de Loire;45;2;21;122;Dampierre-en-Burly;1480;37;1517
24;Centre-Val de Loire;45;2;03;123;Darvoy;1857;31;1888
24;Centre-Val de Loire;45;3;09;124;Desmonts;174;3;177
24;Centre-Val de Loire;45;3;09;125;Dimancheville;114;3;117
24;Centre-Val de Loire;45;2;03;126;Donnery;2861;39;2900
24;Centre-Val de Loire;45;1;04;127;Dordives;3287;36;3323
24;Centre-Val de Loire;45;1;04;129;Douchy-Montcorbon;1372;29;1401
24;Centre-Val de Loire;45;2;01;130;Dry;1392;34;1426
24;Centre-Val de Loire;45;3;09;131;Échilleuses;393;10;403
24;Centre-Val de Loire;45;3;09;132;Égry;352;5;357
24;Centre-Val de Loire;45;3;17;133;Engenville;563;18;581
24;Centre-Val de Loire;45;2;10;134;Épieds-en-Beauce;1435;27;1462
24;Centre-Val de Loire;45;3;17;135;Erceville;309;5;314
24;Centre-Val de Loire;45;1;04;136;Ervauville;540;5;545
24;Centre-Val de Loire;45;3;09;137;Escrennes;727;17;744
24;Centre-Val de Loire;45;1;07;138;Escrignelles;51;0;51
24;Centre-Val de Loire;45;3;09;139;Estouy;503;17;520
24;Centre-Val de Loire;45;1;07;141;Faverelles;156;1;157
24;Centre-Val de Loire;45;2;03;142;Fay-aux-Loges;3755;67;3822
24;Centre-Val de Loire;45;1;07;143;Feins-en-Gâtinais;34;1;35
24;Centre-Val de Loire;45;2;20;144;Férolles;1146;85;1231
24;Centre-Val de Loire;45;1;04;145;Ferrières-en-Gâtinais;3691;81;3772
24;Centre-Val de Loire;45;2;05;146;La Ferté-Saint-Aubin;7437;161;7598
24;Centre-Val de Loire;45;2;06;147;Fleury-les-Aubrais;21070;269;21339
24;Centre-Val de Loire;45;1;04;148;Fontenay-sur-Loing;1724;13;1737
24;Centre-Val de Loire;45;1;04;149;Foucherolles;277;2;279
24;Centre-Val de Loire;45;1;08;150;Fréville-du-Gâtinais;180;4;184
24;Centre-Val de Loire;45;3;09;151;Gaubertin;254;8;262
24;Centre-Val de Loire;45;2;10;152;Gémigny;209;4;213
24;Centre-Val de Loire;45;2;21;153;Germigny-des-Prés;721;24;745
24;Centre-Val de Loire;45;2;10;154;Gidy;2030;34;2064
24;Centre-Val de Loire;45;1;07;155;Gien;13732;412;14144
24;Centre-Val de Loire;45;1;04;156;Girolles;611;17;628
24;Centre-Val de Loire;45;3;09;157;Givraines;414;6;420
24;Centre-Val de Loire;45;1;04;158;Gondreville;328;10;338
24;Centre-Val de Loire;45;3;09;159;Grangermont;193;3;196
24;Centre-Val de Loire;45;3;17;160;Greneville-en-Beauce;703;8;711
24;Centre-Val de Loire;45;1;04;161;Griselles;786;19;805
24;Centre-Val de Loire;45;3;17;162;Guigneville;527;14;541
24;Centre-Val de Loire;45;2;21;164;Guilly;645;16;661
24;Centre-Val de Loire;45;1;04;165;Gy-les-Nonains;620;9;629
24;Centre-Val de Loire;45;2;10;166;Huêtre;284;8;292
24;Centre-Val de Loire;45;2;10;167;Huisseau-sur-Mauves;1679;28;1707
24;Centre-Val de Loire;45;2;03;168;Ingrannes;546;4;550
24;Centre-Val de Loire;45;2;19;169;Ingré;9284;232;9516
24;Centre-Val de Loire;45;3;17;170;Intville-la-Guétard;152;2;154
24;Centre-Val de Loire;45;2;21;171;Isdes;552;14;566
24;Centre-Val de Loire;45;2;03;173;Jargeau;4606;49;4655
24;Centre-Val de Loire;45;3;17;174;Jouy-en-Pithiverais;269;6;275
24;Centre-Val de Loire;45;2;01;175;Jouy-le-Potier;1357;31;1388
24;Centre-Val de Loire;45;3;09;176;Juranville;435;4;439
24;Centre-Val de Loire;45;3;09;177;Laas;234;4;238
24;Centre-Val de Loire;45;1;08;178;Ladon;1388;22;1410
24;Centre-Val de Loire;45;2;01;179;Lailly-en-Val;3104;47;3151
24;Centre-Val de Loire;45;1;07;180;Langesse;82;0;82
24;Centre-Val de Loire;45;3;17;181;Léouville;85;2;87
24;Centre-Val de Loire;45;2;05;182;Ligny-le-Ribault;1227;27;1254
24;Centre-Val de Loire;45;2;10;183;Lion-en-Beauce;139;1;140
24;Centre-Val de Loire;45;2;21;184;Lion-en-Sullias;401;6;407
24;Centre-Val de Loire;45;1;11;185;Lombreuil;302;10;312
24;Centre-Val de Loire;45;3;09;186;Lorcy;570;13;583
24;Centre-Val de Loire;45;1;08;187;Lorris;2958;61;3019
24;Centre-Val de Loire;45;2;06;188;Loury;2446;60;2506
24;Centre-Val de Loire;45;1;04;189;Louzouer;254;6;260
24;Centre-Val de Loire;45;3;09;191;Le Malesherbois;8142;169;8311
24;Centre-Val de Loire;45;2;05;193;Marcilly-en-Villette;2131;47;2178
24;Centre-Val de Loire;45;2;18;194;Mardié;2872;56;2928
24;Centre-Val de Loire;45;3;09;195;Mareau-aux-Bois;570;14;584
24;Centre-Val de Loire;45;2;01;196;Mareau-aux-Prés;1429;24;1453
24;Centre-Val de Loire;45;2;06;197;Marigny-les-Usages;1627;36;1663
24;Centre-Val de Loire;45;3;09;198;Marsainvilliers;299;9;308
24;Centre-Val de Loire;45;1;04;199;Melleroy;505;4;509
24;Centre-Val de Loire;45;2;05;200;Ménestreau-en-Villette;1446;40;1486
24;Centre-Val de Loire;45;1;04;201;Mérinville;182;3;185
24;Centre-Val de Loire;45;2;01;202;Messas;963;14;977
24;Centre-Val de Loire;45;2;10;203;Meung-sur-Loire;6527;95;6622
24;Centre-Val de Loire;45;1;08;205;Mézières-en-Gâtinais;267;5;272
24;Centre-Val de Loire;45;2;01;204;Mézières-lez-Cléry;819;20;839
24;Centre-Val de Loire;45;1;04;206;Mignères;322;4;326
24;Centre-Val de Loire;45;1;04;207;Mignerette;403;9;412
24;Centre-Val de Loire;45;1;11;208;Montargis;14789;536;15325
24;Centre-Val de Loire;45;3;09;209;Montbarrois;308;5;313
24;Centre-Val de Loire;45;1;08;210;Montbouy;737;18;755
24;Centre-Val de Loire;45;1;08;212;Montcresson;1276;26;1302
24;Centre-Val de Loire;45;1;08;213;Montereau;618;14;632
24;Centre-Val de Loire;45;2;17;214;Montigny;242;4;246
24;Centre-Val de Loire;45;3;09;215;Montliard;238;3;241
24;Centre-Val de Loire;45;1;11;216;Mormant-sur-Vernisson;125;2;127
24;Centre-Val de Loire;45;3;17;217;Morville-en-Beauce;167;5;172
24;Centre-Val de Loire;45;1;07;218;Le Moulinet-sur-Solin;118;1;119
24;Centre-Val de Loire;45;1;08;219;Moulon;195;1;196
24;Centre-Val de Loire;45;3;09;220;Nancray-sur-Rimarde;587;17;604
24;Centre-Val de Loire;45;1;04;222;Nargis;1490;38;1528
24;Centre-Val de Loire;45;1;08;223;Nesploy;363;7;370
24;Centre-Val de Loire;45;2;17;224;Neuville-aux-Bois;4858;76;4934
24;Centre-Val de Loire;45;3;09;225;La Neuville-sur-Essonne;372;14;386
24;Centre-Val de Loire;45;2;21;226;Neuvy-en-Sullias;1361;27;1388
24;Centre-Val de Loire;45;1;07;227;Nevoy;1166;23;1189
24;Centre-Val de Loire;45;3;09;228;Nibelle;1187;11;1198
24;Centre-Val de Loire;45;1;08;229;Nogent-sur-Vernisson;2573;37;2610
24;Centre-Val de Loire;45;1;08;230;Noyers;743;5;748
24;Centre-Val de Loire;45;3;17;231;Oison;130;9;139
24;Centre-Val de Loire;45;2;12;232;Olivet;22168;471;22639
24;Centre-Val de Loire;45;3;09;233;Ondreville-sur-Essonne;405;3;408
24;Centre-Val de Loire;45;2;99;234;Orléans;116238;2359;118597
24;Centre-Val de Loire;45;2;15;235;Ormes;4150;78;4228
24;Centre-Val de Loire;45;3;09;237;Orville;122;1;123
24;Centre-Val de Loire;45;1;07;238;Ousson-sur-Loire;732;13;745
24;Centre-Val de Loire;45;1;08;239;Oussoy-en-Gâtinais;411;6;417
24;Centre-Val de Loire;45;3;17;240;Outarville;1322;23;1345
24;Centre-Val de Loire;45;2;20;241;Ouvrouer-les-Champs;547;11;558
24;Centre-Val de Loire;45;1;08;242;Ouzouer-des-Champs;255;5;260
24;Centre-Val de Loire;45;1;08;243;Ouzouer-sous-Bellegarde;313;6;319
24;Centre-Val de Loire;45;2;21;244;Ouzouer-sur-Loire;2690;83;2773
24;Centre-Val de Loire;45;1;07;245;Ouzouer-sur-Trézée;1121;20;1141
24;Centre-Val de Loire;45;3;17;246;Pannecières;136;1;137
24;Centre-Val de Loire;45;1;11;247;Pannes;3691;66;3757
24;Centre-Val de Loire;45;2;10;248;Patay;2210;37;2247
24;Centre-Val de Loire;45;1;02;249;Paucourt;904;24;928
24;Centre-Val de Loire;45;1;04;250;Pers-en-Gâtinais;253;2;255
24;Centre-Val de Loire;45;1;07;251;Pierrefitte-ès-Bois;313;4;317
24;Centre-Val de Loire;45;3;17;252;Pithiviers;8935;143;9078
24;Centre-Val de Loire;45;3;17;253;Pithiviers-le-Vieil;1791;42;1833
24;Centre-Val de Loire;45;1;21;254;Poilly-lez-Gien;2402;62;2464
24;Centre-Val de Loire;45;1;04;255;Préfontaines;445;9;454
24;Centre-Val de Loire;45;1;08;256;Presnoy;245;6;251
24;Centre-Val de Loire;45;1;08;257;Pressigny-les-Pins;501;7;508
24;Centre-Val de Loire;45;3;09;258;Puiseaux;3417;58;3475
24;Centre-Val de Loire;45;1;08;259;Quiers-sur-Bézonde;1145;22;1167
24;Centre-Val de Loire;45;3;09;260;Ramoulu;251;7;258
24;Centre-Val de Loire;45;2;06;261;Rebréchien;1316;16;1332
24;Centre-Val de Loire;45;2;10;262;Rouvray-Sainte-Croix;141;2;143
24;Centre-Val de Loire;45;3;17;263;Rouvres-Saint-Jean;291;8;299
24;Centre-Val de Loire;45;2;10;264;Rozières-en-Beauce;188;5;193
24;Centre-Val de Loire;45;1;04;265;Rozoy-le-Vieil;414;5;419
24;Centre-Val de Loire;45;2;10;266;Ruan;204;1;205
24;Centre-Val de Loire;45;2;21;268;Saint-Aignan-le-Jaillard;607;8;615
24;Centre-Val de Loire;45;2;10;269;Saint-Ay;3507;70;3577
24;Centre-Val de Loire;45;2;21;270;Saint-Benoît-sur-Loire;2017;51;2068
24;Centre-Val de Loire;45;1;21;271;Saint-Brisson-sur-Loire;975;23;998
24;Centre-Val de Loire;45;2;05;272;Saint-Cyr-en-Val;3302;76;3378
24;Centre-Val de Loire;45;2;03;273;Saint-Denis-de-l'Hôtel;3033;40;3073
24;Centre-Val de Loire;45;2;20;274;Saint-Denis-en-Val;7545;190;7735
24;Centre-Val de Loire;45;1;04;275;Saint-Firmin-des-Bois;457;4;461
24;Centre-Val de Loire;45;1;07;276;Saint-Firmin-sur-Loire;508;5;513
24;Centre-Val de Loire;45;2;21;277;Saint-Florent;455;12;467
24;Centre-Val de Loire;45;1;04;279;Saint-Germain-des-Prés;1914;18;1932
24;Centre-Val de Loire;45;1;21;280;Saint-Gondon;1100;19;1119
24;Centre-Val de Loire;45;1;04;281;Saint-Hilaire-les-Andrésis;935;18;953
24;Centre-Val de Loire;45;2;12;282;Saint-Hilaire-Saint-Mesmin;3056;84;3140
24;Centre-Val de Loire;45;1;08;283;Saint-Hilaire-sur-Puiseaux;170;6;176
24;Centre-Val de Loire;45;2;18;284;Saint-Jean-de-Braye;21054;589;21643
24;Centre-Val de Loire;45;2;19;285;Saint-Jean-de-la-Ruelle;16445;297;16742
24;Centre-Val de Loire;45;2;20;286;Saint-Jean-le-Blanc;8810;227;9037
24;Centre-Val de Loire;45;3;09;288;Saint-Loup-des-Vignes;397;10;407
24;Centre-Val de Loire;45;2;17;289;Saint-Lyé-la-Forêt;1186;18;1204
24;Centre-Val de Loire;45;2;03;290;Saint-Martin-d'Abbat;1764;27;1791
24;Centre-Val de Loire;45;1;21;291;Saint-Martin-sur-Ocre;1237;47;1284
24;Centre-Val de Loire;45;1;08;292;Saint-Maurice-sur-Aveyron;859;12;871
24;Centre-Val de Loire;45;1;11;293;Saint-Maurice-sur-Fessard;1169;25;1194
24;Centre-Val de Loire;45;3;09;294;Saint-Michel;129;1;130
24;Centre-Val de Loire;45;2;10;296;Saint-Péravy-la-Colombe;756;15;771
24;Centre-Val de Loire;45;2;21;297;Saint-Père-sur-Loire;1040;16;1056
24;Centre-Val de Loire;45;2;12;298;Saint-Pryvé-Saint-Mesmin;5939;100;6039
24;Centre-Val de Loire;45;2;10;299;Saint-Sigismond;265;1;266
24;Centre-Val de Loire;45;1;08;278;Sainte-Geneviève-des-Bois;1065;65;1130
24;Centre-Val de Loire;45;2;20;300;Sandillon;4043;99;4142
24;Centre-Val de Loire;45;3;09;301;Santeau;412;3;415
24;Centre-Val de Loire;45;2;15;302;Saran;16344;205;16549
24;Centre-Val de Loire;45;1;04;303;Sceaux-du-Gâtinais;633;13;646
24;Centre-Val de Loire;45;2;03;305;Seichebrières;211;1;212
24;Centre-Val de Loire;45;1;04;306;La Selle-en-Hermoy;794;14;808
24;Centre-Val de Loire;45;1;04;307;Selle-sur-le-Bied ;1099;24;1123
24;Centre-Val de Loire;45;2;18;308;Semoy;3182;75;3257
24;Centre-Val de Loire;45;2;05;309;Sennely;712;6;718
24;Centre-Val de Loire;45;3;17;310;Sermaises;1663;24;1687
24;Centre-Val de Loire;45;2;20;311;Sigloy;672;17;689
24;Centre-Val de Loire;45;1;11;312;Solterre;472;8;480
24;Centre-Val de Loire;45;2;10;313;Sougy;816;13;829
24;Centre-Val de Loire;45;2;03;314;Sully-la-Chapelle;440;9;449
24;Centre-Val de Loire;45;2;21;315;Sully-sur-Loire;5286;66;5352
24;Centre-Val de Loire;45;2;03;316;Sury-aux-Bois;791;23;814
24;Centre-Val de Loire;45;2;01;317;Tavers;1350;36;1386
24;Centre-Val de Loire;45;3;17;320;Thignonville;409;11;420
24;Centre-Val de Loire;45;1;08;321;Thimory;724;20;744
24;Centre-Val de Loire;45;1;04;322;Thorailles;180;4;184
24;Centre-Val de Loire;45;1;07;323;Thou;224;4;228
24;Centre-Val de Loire;45;2;20;324;Tigy;2325;51;2376
24;Centre-Val de Loire;45;3;17;325;Tivernon;286;4;290
24;Centre-Val de Loire;45;2;10;326;Tournoisis;399;9;408
24;Centre-Val de Loire;45;2;06;327;Traînou;3393;81;3474
24;Centre-Val de Loire;45;1;04;328;Treilles-en-Gâtinais;292;5;297
24;Centre-Val de Loire;45;1;04;329;Triguères;1288;25;1313
24;Centre-Val de Loire;45;2;10;330;Trinay;221;4;225
24;Centre-Val de Loire;45;2;20;331;Vannes-sur-Cosson;610;9;619
24;Centre-Val de Loire;45;1;08;332;Varennes-Changy;1492;26;1518
24;Centre-Val de Loire;45;2;06;333;Vennecy;1887;38;1925
24;Centre-Val de Loire;45;1;08;334;Vieilles-Maisons-sur-Joudry;636;8;644
24;Centre-Val de Loire;45;2;20;335;Vienne-en-Val;1941;44;1985
24;Centre-Val de Loire;45;2;21;336;Viglain;867;13;880
24;Centre-Val de Loire;45;2;10;337;Villamblain;287;8;295
24;Centre-Val de Loire;45;1;11;338;Villemandeur;6767;366;7133
24;Centre-Val de Loire;45;1;08;339;Villemoutiers;486;7;493
24;Centre-Val de Loire;45;2;21;340;Villemurlin;581;6;587
24;Centre-Val de Loire;45;2;10;341;Villeneuve-sur-Conie;203;6;209
24;Centre-Val de Loire;45;2;17;342;Villereau;385;3;388
24;Centre-Val de Loire;45;1;04;343;Villevoques;210;6;216
24;Centre-Val de Loire;45;2;01;344;Villorceau;1116;22;1138
24;Centre-Val de Loire;45;1;11;345;Vimory;1151;35;1186
24;Centre-Val de Loire;45;2;03;346;Vitry-aux-Loges;2216;39;2255
24;Centre-Val de Loire;45;3;09;347;Vrigny;815;16;831
24;Centre-Val de Loire;45;3;09;348;Yèvre-la-Ville;699;17;716
76;Occitanie;46;1;12;001;Albas;522;14;536
76;Occitanie;46;2;10;002;Albiac;67;2;69
76;Occitanie;46;3;10;003;Alvignac;706;25;731
76;Occitanie;46;2;11;004;Anglars;219;6;225
76;Occitanie;46;1;12;005;Anglars-Juillac;329;9;338
76;Occitanie;46;3;09;006;Anglars-Nozac;377;4;381
76;Occitanie;46;1;02;007;Arcambal;988;23;1011
76;Occitanie;46;3;15;008;Les Arques;203;3;206
76;Occitanie;46;2;11;009;Assier;642;18;660
76;Occitanie;46;1;13;010;Aujols;367;10;377
76;Occitanie;46;2;16;011;Autoire;358;9;367
76;Occitanie;46;2;16;012;Aynac;551;12;563
76;Occitanie;46;1;13;013;Bach;178;2;180
76;Occitanie;46;2;08;015;Bagnac-sur-Célé;1469;38;1507
76;Occitanie;46;3;14;016;Baladou;393;15;408
76;Occitanie;46;2;16;017;Bannes;142;4;146
76;Occitanie;46;1;12;263;Barguelonne-en-Quercy ;690;17;707
76;Occitanie;46;3;10;018;Le Bastit;141;3;144
76;Occitanie;46;1;13;020;Beauregard;232;12;244
76;Occitanie;46;2;07;021;Béduer;709;26;735
76;Occitanie;46;1;12;022;Bélaye;217;1;218
76;Occitanie;46;1;13;023;Belfort-du-Quercy;517;6;523
76;Occitanie;46;1;02;156;Bellefont-La Rauze ;1234;24;1258
76;Occitanie;46;2;06;024;Belmont-Bretenoux;404;12;416
76;Occitanie;46;1;13;026;Belmont-Sainte-Foi;108;3;111
76;Occitanie;46;1;05;027;Berganty;117;2;119
76;Occitanie;46;2;11;338;Bessonies;79;1;80
76;Occitanie;46;3;14;028;Bétaille;1035;28;1063
76;Occitanie;46;2;06;029;Biars-sur-Cère;2090;58;2148
76;Occitanie;46;3;10;030;Bio;344;13;357
76;Occitanie;46;3;05;031;Blars;134;3;137
76;Occitanie;46;1;04;032;Boissières;400;5;405
76;Occitanie;46;2;11;034;Le Bourg;323;9;332
76;Occitanie;46;2;07;035;Boussac;184;8;192
76;Occitanie;46;2;11;036;Le Bouyssou;132;2;134
76;Occitanie;46;1;05;037;Bouziès;88;1;89
76;Occitanie;46;2;05;039;Brengues;215;5;220
76;Occitanie;46;2;06;038;Bretenoux;1359;29;1388
76;Occitanie;46;1;05;040;Cabrerets;228;8;236
76;Occitanie;46;2;05;041;Cadrieu;157;8;165
76;Occitanie;46;1;98;042;Cahors;19907;937;20844
76;Occitanie;46;2;06;043;Cahus;205;1;206
76;Occitanie;46;1;12;044;Caillac;593;22;615
76;Occitanie;46;2;05;045;Cajarc;1120;33;1153
76;Occitanie;46;1;04;046;Calamane;457;10;467
76;Occitanie;46;3;17;047;Calès;168;6;174
76;Occitanie;46;2;05;049;Calvignac;205;3;208
76;Occitanie;46;1;12;050;Cambayrac;147;4;151
76;Occitanie;46;2;07;051;Cambes;373;10;383
76;Occitanie;46;2;07;052;Camboulit;257;5;262
76;Occitanie;46;2;07;053;Camburat;423;13;436
76;Occitanie;46;3;05;054;Caniac-du-Causse;378;2;380
76;Occitanie;46;2;08;055;Capdenac;1103;25;1128
76;Occitanie;46;2;05;056;Carayac;105;5;110
76;Occitanie;46;2;11;057;Cardaillac;610;13;623
76;Occitanie;46;3;14;058;Carennac;411;15;426
76;Occitanie;46;3;10;059;Carlucet;222;10;232
76;Occitanie;46;1;12;060;Carnac-Rouffiac;223;1;224
76;Occitanie;46;1;15;061;Cassagnes;180;4;184
76;Occitanie;46;1;12;062;Castelfranc;428;8;436
76;Occitanie;46;1;13;063;Castelnau Montratier-Sainte Alauzie;1856;38;1894
76;Occitanie;46;1;04;064;Catus;878;7;885
76;Occitanie;46;3;14;065;Cavagnac;449;14;463
76;Occitanie;46;3;09;066;Cazals;632;5;637
76;Occitanie;46;1;05;068;Cénevières;171;3;174
76;Occitanie;46;1;13;069;Cézac;168;2;170
76;Occitanie;46;1;03;070;Cieurac;569;14;583
76;Occitanie;46;3;04;072;Concorès;309;6;315
76;Occitanie;46;1;13;073;Concots;421;17;438
76;Occitanie;46;3;14;074;Condat;413;8;421
76;Occitanie;46;2;07;075;Corn;231;5;236
76;Occitanie;46;2;06;076;Cornac;346;9;355
76;Occitanie;46;3;10;078;Couzou;97;2;99
76;Occitanie;46;3;05;079;Cras;102;2;104
76;Occitanie;46;1;04;080;Crayssac;768;14;782
76;Occitanie;46;1;05;081;Crégols;76;3;79
76;Occitanie;46;1;13;082;Cremps;359;9;368
76;Occitanie;46;3;14;083;Cressensac-Sarrazac ;1129;23;1152
76;Occitanie;46;3;14;084;Creysse;314;8;322
76;Occitanie;46;2;08;085;Cuzac;238;6;244
76;Occitanie;46;3;14;086;Cuzance;620;13;633
76;Occitanie;46;3;89;138;Cœur de Causse;936;21;957
76;Occitanie;46;3;09;087;Dégagnac;662;17;679
76;Occitanie;46;1;12;088;Douelle;819;22;841
76;Occitanie;46;1;15;089;Duravel;957;7;964
76;Occitanie;46;2;10;090;Durbans;144;2;146
76;Occitanie;46;1;13;091;Escamps;210;4;214
76;Occitanie;46;1;05;092;Esclauzels;222;3;225
76;Occitanie;46;2;05;093;Espagnac-Sainte-Eulalie;89;2;91
76;Occitanie;46;2;05;094;Espédaillac;268;5;273
76;Occitanie;46;1;04;095;Espère;1045;25;1070
76;Occitanie;46;2;11;096;Espeyroux;97;2;99
76;Occitanie;46;2;06;097;Estal;108;6;114
76;Occitanie;46;3;17;098;Fajoles;294;7;301
76;Occitanie;46;2;07;100;Faycelles;672;27;699
76;Occitanie;46;2;08;101;Felzins;452;7;459
76;Occitanie;46;2;99;102;Figeac;9778;678;10456
76;Occitanie;46;2;10;104;Flaujac-Gare;96;6;102
76;Occitanie;46;1;03;105;Flaujac-Poujols;776;17;793
76;Occitanie;46;3;14;106;Floirac;250;8;258
76;Occitanie;46;1;15;107;Floressas;166;5;171
76;Occitanie;46;2;07;108;Fons;405;19;424
76;Occitanie;46;1;13;109;Fontanes;488;9;497
76;Occitanie;46;2;07;111;Fourmagnac;165;4;169
76;Occitanie;46;1;04;112;Francoulès;231;5;236
76;Occitanie;46;3;04;113;Frayssinet;305;6;311
76;Occitanie;46;3;15;114;Frayssinet-le-Gélat;360;7;367
76;Occitanie;46;2;16;115;Frayssinhes;165;7;172
76;Occitanie;46;2;05;116;Frontenac;71;6;77
76;Occitanie;46;2;06;117;Gagnac-sur-Cère;670;43;713
76;Occitanie;46;3;17;118;Gignac;671;15;686
76;Occitanie;46;1;04;119;Gigouzac;285;0;285
76;Occitanie;46;3;09;120;Gindou;329;4;333
76;Occitanie;46;3;04;121;Ginouillac;150;3;153
76;Occitanie;46;2;06;122;Gintrac;104;4;108
76;Occitanie;46;2;06;123;Girac;371;7;378
76;Occitanie;46;2;06;124;Glanes;304;12;316
76;Occitanie;46;2;11;125;Gorses;327;10;337
76;Occitanie;46;3;15;126;Goujounac;226;4;230
76;Occitanie;46;3;09;127;Gourdon;3985;127;4112
76;Occitanie;46;3;10;128;Gramat;3468;58;3526
76;Occitanie;46;2;05;129;Gréalou;286;10;296
76;Occitanie;46;1;15;130;Grézels;223;5;228
76;Occitanie;46;2;05;131;Grèzes;172;5;177
76;Occitanie;46;2;10;132;Issendolus;519;21;540
76;Occitanie;46;2;11;133;Issepts;253;3;256
76;Occitanie;46;1;15;134;Les Junies;273;6;279
76;Occitanie;46;2;11;135;Labastide-du-Haut-Mont;49;1;50
76;Occitanie;46;1;04;136;Labastide-du-Vert;269;7;276
76;Occitanie;46;1;03;137;Labastide-Marnhac;1235;22;1257
76;Occitanie;46;2;11;139;Labathude;205;7;212
76;Occitanie;46;1;13;140;Laburgade;354;14;368
76;Occitanie;46;1;15;142;Lacapelle-Cabanac;166;2;168
76;Occitanie;46;2;11;143;Lacapelle-Marival;1270;32;1302
76;Occitanie;46;3;17;144;Lacave;259;13;272
76;Occitanie;46;3;17;145;Lachapelle-Auzac;795;13;808
76;Occitanie;46;2;16;146;Ladirat;96;1;97
76;Occitanie;46;1;15;147;Lagardelle;126;0;126
76;Occitanie;46;1;13;148;Lalbenque;1735;45;1780
76;Occitanie;46;1;02;149;Lamagdelaine;697;21;718
76;Occitanie;46;3;04;151;Lamothe-Cassel;123;3;126
76;Occitanie;46;3;17;152;Lamothe-Fénelon;301;4;305
76;Occitanie;46;3;17;153;Lanzac;586;16;602
76;Occitanie;46;1;13;154;Laramière;350;13;363
76;Occitanie;46;2;05;155;Larnagol;139;1;140
76;Occitanie;46;2;05;157;Larroque-Toirac;134;5;139
76;Occitanie;46;2;16;159;Latouille-Lentillac;223;12;235
76;Occitanie;46;2;11;160;Latronquière;432;15;447
76;Occitanie;46;2;11;161;Lauresses;256;6;262
76;Occitanie;46;3;05;162;Lauzès;199;6;205
76;Occitanie;46;2;06;163;Laval-de-Cère;291;4;295
76;Occitanie;46;3;09;164;Lavercantière;248;11;259
76;Occitanie;46;3;10;165;Lavergne;453;11;464
76;Occitanie;46;1;12;262;Lendou-en-Quercy ;638;14;652
76;Occitanie;46;3;05;167;Lentillac-du-Causse;103;0;103
76;Occitanie;46;2;08;168;Lentillac-Saint-Blaise;185;1;186
76;Occitanie;46;3;09;169;Léobard;205;7;212
76;Occitanie;46;2;16;170;Leyme;930;23;953
76;Occitanie;46;1;15;171;Lherm;228;3;231
76;Occitanie;46;1;13;172;Lhospitalet;500;16;516
76;Occitanie;46;1;13;173;Limogne-en-Quercy;735;17;752
76;Occitanie;46;2;08;174;Linac;232;8;240
76;Occitanie;46;2;07;175;Lissac-et-Mouret;918;33;951
76;Occitanie;46;2;11;176;Livernon;690;13;703
76;Occitanie;46;2;16;177;Loubressac;525;20;545
76;Occitanie;46;3;17;178;Loupiac;260;1;261
76;Occitanie;46;1;13;179;Lugagnac;128;5;133
76;Occitanie;46;2;08;180;Lunan;580;25;605
76;Occitanie;46;3;05;181;Lunegarde;99;4;103
76;Occitanie;46;1;12;182;Luzech;1802;26;1828
76;Occitanie;46;2;05;183;Marcilhac-sur-Célé;203;2;205
76;Occitanie;46;3;09;184;Marminiac;356;12;368
76;Occitanie;46;3;14;185;Martel;1611;45;1656
76;Occitanie;46;3;17;186;Masclat;362;7;369
76;Occitanie;46;1;15;187;Mauroux;530;10;540
76;Occitanie;46;1;04;188;Maxou;304;10;314
76;Occitanie;46;3;17;337;Mayrac;256;7;263
76;Occitanie;46;2;16;189;Mayrinhac-Lentour;505;16;521
76;Occitanie;46;1;04;190;Mechmont;127;3;130
76;Occitanie;46;1;01;191;Mercuès;1127;20;1147
76;Occitanie;46;3;17;192;Meyronne;273;8;281
76;Occitanie;46;3;10;193;Miers;457;11;468
76;Occitanie;46;3;09;194;Milhac;182;3;185
76;Occitanie;46;2;16;195;Molières;358;9;367
76;Occitanie;46;3;04;196;Montamel;104;1;105
76;Occitanie;46;1;03;197;Le Montat;1049;122;1171
76;Occitanie;46;2;05;198;Montbrun;105;1;106
76;Occitanie;46;1;15;199;Montcabrier;352;6;358
76;Occitanie;46;3;15;200;Montcléra;267;5;272
76;Occitanie;46;1;12;201;Montcuq-en-Quercy-Blanc;1739;48;1787
76;Occitanie;46;1;13;202;Montdoumerc;543;5;548
76;Occitanie;46;2;11;203;Montet-et-Bouxal;215;6;221
76;Occitanie;46;3;04;204;Montfaucon;596;9;605
76;Occitanie;46;1;04;205;Montgesty;332;2;334
76;Occitanie;46;1;12;206;Montlauzun;122;6;128
76;Occitanie;46;2;08;207;Montredon;300;5;305
76;Occitanie;46;3;14;208;Montvalent;289;11;300
76;Occitanie;46;3;17;209;Nadaillac-de-Rouge;158;8;166
76;Occitanie;46;3;05;210;Nadillac;65;1;66
76;Occitanie;46;1;04;211;Nuzéjouls;363;2;365
76;Occitanie;46;3;05;212;Orniac;71;3;74
76;Occitanie;46;3;10;213;Padirac;155;10;165
76;Occitanie;46;1;12;214;Parnac;381;9;390
76;Occitanie;46;3;17;215;Payrac;623;17;640
76;Occitanie;46;3;09;216;Payrignac;665;30;695
76;Occitanie;46;3;05;252;Les Pechs du Vers;311;8;319
76;Occitanie;46;1;13;217;Pern;443;11;454
76;Occitanie;46;1;15;218;Pescadoires;188;3;191
76;Occitanie;46;3;04;219;Peyrilles;350;13;363
76;Occitanie;46;3;17;220;Pinsac;782;24;806
76;Occitanie;46;2;07;221;Planioles;529;9;538
76;Occitanie;46;3;15;222;Pomarède;190;3;193
76;Occitanie;46;1;04;223;Pontcirq;167;1;168
76;Occitanie;46;1;  ;033;Porte-du-Quercy ;577;8;585
76;Occitanie;46;1;01;224;Pradines;3515;101;3616
76;Occitanie;46;1;15;225;Prayssac;2394;76;2470
76;Occitanie;46;2;08;226;Prendeignes;230;7;237
76;Occitanie;46;1;13;227;Promilhanes;224;4;228
76;Occitanie;46;2;06;228;Prudhomat;719;15;734
76;Occitanie;46;1;15;231;Puy-l'Évêque;1965;30;1995
76;Occitanie;46;2;06;229;Puybrun;1010;18;1028
76;Occitanie;46;2;05;230;Puyjourdes;87;4;91
76;Occitanie;46;2;05;233;Quissac;110;1;111
76;Occitanie;46;3;09;234;Rampoux;99;2;101
76;Occitanie;46;2;10;235;Reilhac;171;4;175
76;Occitanie;46;3;17;236;Reilhaguet;136;0;136
76;Occitanie;46;2;11;237;Reyrevignes;379;10;389
76;Occitanie;46;3;10;238;Rignac;272;9;281
76;Occitanie;46;3;17;239;Le Roc;216;5;221
76;Occitanie;46;3;10;240;Rocamadour;611;19;630
76;Occitanie;46;3;09;241;Rouffilhac;188;4;192
76;Occitanie;46;2;11;242;Rudelle;176;5;181
76;Occitanie;46;2;11;243;Rueyres;195;1;196
76;Occitanie;46;2;11;244;Sabadel-Latronquière;95;1;96
76;Occitanie;46;3;05;245;Sabadel-Lauzès;78;1;79
76;Occitanie;46;2;16;246;Saignes;76;1;77
76;Occitanie;46;1;13;247;Saillac;156;5;161
76;Occitanie;46;2;11;249;Saint-Bressou;117;5;122
76;Occitanie;46;3;15;250;Saint-Caprais;79;2;81
76;Occitanie;46;2;16;251;Saint-Céré;3479;162;3641
76;Occitanie;46;3;04;253;Saint-Chamarand;178;2;180
76;Occitanie;46;2;05;254;Saint-Chels;141;5;146
76;Occitanie;46;2;11;255;Saint-Cirgues;342;13;355
76;Occitanie;46;1;05;256;Saint-Cirq-Lapopie;198;2;200
76;Occitanie;46;3;09;257;Saint-Cirq-Madelon;124;3;127
76;Occitanie;46;3;09;258;Saint-Cirq-Souillaguet;161;1;162
76;Occitanie;46;3;09;259;Saint-Clair;142;2;144
76;Occitanie;46;1;04;264;Saint-Denis-Catus;191;7;198
76;Occitanie;46;3;14;265;Saint-Denis-lès-Martel;329;7;336
76;Occitanie;46;2;08;266;Saint-Félix;529;8;537
76;Occitanie;46;3;04;267;Saint-Germain-du-Bel-Air;565;12;577
76;Occitanie;46;1;88;268;Saint Géry-Vers;878;19;897
76;Occitanie;46;2;11;269;Saint-Hilaire;63;2;65
76;Occitanie;46;2;05;270;Saint-Jean-de-Laur;242;3;245
76;Occitanie;46;2;16;339;Saint-Jean-Lagineste;352;8;360
76;Occitanie;46;2;16;271;Saint-Jean-Lespinasse;398;17;415
76;Occitanie;46;2;08;272;Saint-Jean-Mirabel;256;4;260
76;Occitanie;46;2;16;273;Saint-Laurent-les-Tours;868;26;894
76;Occitanie;46;1;05;276;Saint-Martin-Labouval;185;5;190
76;Occitanie;46;1;15;277;Saint-Martin-le-Redon;208;4;212
76;Occitanie;46;2;11;279;Saint-Maurice-en-Quercy;214;3;217
76;Occitanie;46;1;04;280;Saint-Médard;178;5;183
76;Occitanie;46;2;16;281;Saint-Médard-de-Presque;204;7;211
76;Occitanie;46;2;11;282;Saint-Médard-Nicourby;94;0;94
76;Occitanie;46;3;14;283;Saint-Michel-de-Bannières;317;8;325
76;Occitanie;46;2;06;284;Saint-Michel-Loubéjou;403;8;411
76;Occitanie;46;2;16;286;Saint-Paul-de-Vern;178;5;183
76;Occitanie;46;1;13;103;Saint-Paul-Flaugnac;1000;26;1026
76;Occitanie;46;2;08;288;Saint-Perdoux;211;10;221
76;Occitanie;46;1;04;340;Saint-Pierre-Lafeuille;365;12;377
76;Occitanie;46;2;05;289;Saint-Pierre-Toirac;158;0;158
76;Occitanie;46;3;09;290;Saint-Projet;338;8;346
76;Occitanie;46;2;11;292;Saint-Simon;179;6;185
76;Occitanie;46;3;17;293;Saint-Sozy;475;12;487
76;Occitanie;46;2;05;294;Saint-Sulpice;142;3;145
76;Occitanie;46;2;16;295;Saint-Vincent-du-Pendit;201;4;205
76;Occitanie;46;1;12;296;Saint-Vincent-Rive-d'Olt;442;16;458
76;Occitanie;46;2;11;260;Sainte-Colombe;214;9;223
76;Occitanie;46;3;09;297;Salviac;1208;25;1233
76;Occitanie;46;2;05;299;Sauliac-sur-Célé;120;4;124
76;Occitanie;46;1;12;301;Sauzet;514;5;519
76;Occitanie;46;2;11;302;Sénaillac-Latronquière;138;2;140
76;Occitanie;46;3;05;303;Sénaillac-Lauzès;128;3;131
76;Occitanie;46;3;04;304;Séniergues;135;1;136
76;Occitanie;46;1;15;305;Sérignac;303;2;305
76;Occitanie;46;2;11;306;Sonac;86;3;89
76;Occitanie;46;1;15;307;Soturac;640;7;647
76;Occitanie;46;3;04;308;Soucirac;102;1;103
76;Occitanie;46;3;17;309;Souillac;3243;354;3597
76;Occitanie;46;3;05;310;Soulomès;122;2;124
76;Occitanie;46;2;06;311;Sousceyrac-en-Quercy;1341;20;1361
76;Occitanie;46;3;14;312;Strenquels;272;2;274
76;Occitanie;46;2;06;313;Tauriac;430;9;439
76;Occitanie;46;2;11;314;Terrou;172;42;214
76;Occitanie;46;2;06;315;Teyssieu;170;3;173
76;Occitanie;46;3;04;316;Thédirac;293;5;298
76;Occitanie;46;3;10;317;Thégra;477;13;490
76;Occitanie;46;2;11;318;Thémines;226;11;237
76;Occitanie;46;2;11;319;Théminettes;170;5;175
76;Occitanie;46;1;05;320;Tour-de-Faure;320;16;336
76;Occitanie;46;1;15;321;Touzac;372;8;380
76;Occitanie;46;1;03;322;Trespoux-Rassiels;813;31;844
76;Occitanie;46;3;04;323;Ussel;97;2;99
76;Occitanie;46;3;04;324;Uzech;216;4;220
76;Occitanie;46;1;13;328;Varaire;324;11;335
76;Occitanie;46;1;13;329;Vaylats;325;2;327
76;Occitanie;46;3;14;330;Vayrac;1303;25;1328
76;Occitanie;46;2;08;332;Viazac;327;5;332
76;Occitanie;46;1;13;333;Vidaillac;175;4;179
76;Occitanie;46;3;09;334;Le Vigan;1585;57;1642
76;Occitanie;46;3;14;232;Vignon-en-Quercy ;1010;25;1035
76;Occitanie;46;1;12;335;Villesèque;397;16;413
76;Occitanie;46;1;15;336;Vire-sur-Lot;348;31;379
75;Nouvelle-Aquitaine;47;1;97;001;Agen;33012;875;33887
75;Nouvelle-Aquitaine;47;2;07;002;Agmé;105;4;109
75;Nouvelle-Aquitaine;47;2;19;003;Agnac;426;10;436
75;Nouvelle-Aquitaine;47;1;06;004;Aiguillon;4416;141;4557
75;Nouvelle-Aquitaine;47;2;19;005;Allemans-du-Dropt;490;5;495
75;Nouvelle-Aquitaine;47;3;12;006;Allez-et-Cazeneuve;584;13;597
75;Nouvelle-Aquitaine;47;4;08;007;Allons;163;6;169
75;Nouvelle-Aquitaine;47;4;11;008;Ambrus;111;4;115
75;Nouvelle-Aquitaine;47;4;05;009;Andiran;226;8;234
75;Nouvelle-Aquitaine;47;2;08;010;Antagnac;224;3;227
75;Nouvelle-Aquitaine;47;3;09;011;Anthé;200;7;207
75;Nouvelle-Aquitaine;47;4;08;012;Anzex;313;2;315
75;Nouvelle-Aquitaine;47;2;08;013;Argenton;320;11;331
75;Nouvelle-Aquitaine;47;2;19;014;Armillac;200;7;207
75;Nouvelle-Aquitaine;47;1;17;015;Astaffort;2044;39;2083
75;Nouvelle-Aquitaine;47;1;15;016;Aubiac;1135;25;1160
75;Nouvelle-Aquitaine;47;3;16;017;Auradou;410;9;419
75;Nouvelle-Aquitaine;47;2;07;018;Auriac-sur-Dropt;175;6;181
75;Nouvelle-Aquitaine;47;1;01;019;Bajamont;981;20;1001
75;Nouvelle-Aquitaine;47;2;07;020;Baleyssagues;179;8;187
75;Nouvelle-Aquitaine;47;4;11;021;Barbaste;1522;93;1615
75;Nouvelle-Aquitaine;47;1;06;022;Bazens;543;9;552
75;Nouvelle-Aquitaine;47;3;10;023;Beaugas;358;5;363
75;Nouvelle-Aquitaine;47;2;13;024;Beaupuy;1640;41;1681
75;Nouvelle-Aquitaine;47;1;16;025;Beauville;558;6;564
75;Nouvelle-Aquitaine;47;4;08;026;Beauziac;235;8;243
75;Nouvelle-Aquitaine;47;3;21;027;Bias;3014;55;3069
75;Nouvelle-Aquitaine;47;2;14;028;Birac-sur-Trec;836;18;854
75;Nouvelle-Aquitaine;47;3;09;029;Blanquefort-sur-Briolance;484;12;496
75;Nouvelle-Aquitaine;47;1;16;030;Blaymont;209;6;215
75;Nouvelle-Aquitaine;47;1;02;031;Boé;5589;93;5682
75;Nouvelle-Aquitaine;47;1;02;032;Bon-Encontre;6182;146;6328
75;Nouvelle-Aquitaine;47;3;10;033;Boudy-de-Beauregard;415;3;418
75;Nouvelle-Aquitaine;47;2;08;034;Bouglon;625;13;638
75;Nouvelle-Aquitaine;47;2;19;035;Bourgougnague;325;80;405
75;Nouvelle-Aquitaine;47;3;09;036;Bourlens;377;6;383
75;Nouvelle-Aquitaine;47;3;10;037;Bournel;250;4;254
75;Nouvelle-Aquitaine;47;1;06;038;Bourran;614;24;638
75;Nouvelle-Aquitaine;47;4;08;039;Boussès;37;0;37
75;Nouvelle-Aquitaine;47;1;15;040;Brax;2079;46;2125
75;Nouvelle-Aquitaine;47;4;11;041;Bruch;747;15;762
75;Nouvelle-Aquitaine;47;2;18;042;Brugnac;185;6;191
75;Nouvelle-Aquitaine;47;4;11;043;Buzet-sur-Baïse;1277;14;1291
75;Nouvelle-Aquitaine;47;3;19;044;Cahuzac;309;3;312
75;Nouvelle-Aquitaine;47;4;05;045;Calignac;478;5;483
75;Nouvelle-Aquitaine;47;2;08;046;Calonges;630;13;643
75;Nouvelle-Aquitaine;47;2;07;047;Cambes;182;5;187
75;Nouvelle-Aquitaine;47;3;10;048;Cancon;1332;19;1351
75;Nouvelle-Aquitaine;47;3;12;049;Casseneuil;2411;48;2459
75;Nouvelle-Aquitaine;47;1;16;050;Cassignas;127;2;129
75;Nouvelle-Aquitaine;47;1;17;051;Castelculier;2392;48;2440
75;Nouvelle-Aquitaine;47;4;08;052;Casteljaloux;4533;56;4589
75;Nouvelle-Aquitaine;47;1;16;053;Castella;373;7;380
75;Nouvelle-Aquitaine;47;2;18;054;Castelmoron-sur-Lot;1756;23;1779
75;Nouvelle-Aquitaine;47;2;07;056;Castelnau-sur-Gupie;892;32;924
75;Nouvelle-Aquitaine;47;3;10;055;Castelnaud-de-Gratecambe;518;7;525
75;Nouvelle-Aquitaine;47;3;19;057;Castillonnès;1394;21;1415
75;Nouvelle-Aquitaine;47;4;08;058;Caubeyres;256;1;257
75;Nouvelle-Aquitaine;47;2;07;059;Caubon-Saint-Sauveur;258;4;262
75;Nouvelle-Aquitaine;47;1;17;060;Caudecoste;1091;19;1110
75;Nouvelle-Aquitaine;47;2;14;061;Caumont-sur-Garonne;750;7;757
75;Nouvelle-Aquitaine;47;1;16;062;Cauzac;420;4;424
75;Nouvelle-Aquitaine;47;3;19;063;Cavarc;160;2;162
75;Nouvelle-Aquitaine;47;3;09;064;Cazideroque;234;7;241
75;Nouvelle-Aquitaine;47;2;18;065;Clairac;2608;196;2804
75;Nouvelle-Aquitaine;47;1;06;066;Clermont-Dessous;900;12;912
75;Nouvelle-Aquitaine;47;1;17;067;Clermont-Soubiran;388;8;396
75;Nouvelle-Aquitaine;47;2;13;068;Cocumont;1066;22;1088
75;Nouvelle-Aquitaine;47;1;15;069;Colayrac-Saint-Cirq;3106;49;3155
75;Nouvelle-Aquitaine;47;3;09;070;Condezaygues;852;23;875
75;Nouvelle-Aquitaine;47;2;18;071;Coulx;240;3;243
75;Nouvelle-Aquitaine;47;3;09;072;Courbiac;109;3;112
75;Nouvelle-Aquitaine;47;1;06;073;Cours;200;5;205
75;Nouvelle-Aquitaine;47;2;13;074;Couthures-sur-Garonne;350;6;356
75;Nouvelle-Aquitaine;47;1;16;075;La Croix-Blanche;1071;23;1094
75;Nouvelle-Aquitaine;47;1;17;076;Cuq;275;5;280
75;Nouvelle-Aquitaine;47;3;09;077;Cuzorn;850;18;868
75;Nouvelle-Aquitaine;47;4;11;078;Damazan;1361;46;1407
75;Nouvelle-Aquitaine;47;3;16;079;Dausse;513;17;530
75;Nouvelle-Aquitaine;47;3;10;080;Dévillac;134;3;137
75;Nouvelle-Aquitaine;47;3;12;081;Dolmayrac;714;15;729
75;Nouvelle-Aquitaine;47;1;16;082;Dondas;214;1;215
75;Nouvelle-Aquitaine;47;3;10;083;Doudrac;97;1;98
75;Nouvelle-Aquitaine;47;3;19;084;Douzains;270;6;276
75;Nouvelle-Aquitaine;47;4;08;085;Durance;295;3;298
75;Nouvelle-Aquitaine;47;2;07;086;Duras;1251;20;1271
75;Nouvelle-Aquitaine;47;1;16;087;Engayrac;166;9;175
75;Nouvelle-Aquitaine;47;2;07;088;Escassefort;610;9;619
75;Nouvelle-Aquitaine;47;2;07;089;Esclottes;150;2;152
75;Nouvelle-Aquitaine;47;4;05;090;Espiens;370;8;378
75;Nouvelle-Aquitaine;47;1;15;091;Estillac;2100;40;2140
75;Nouvelle-Aquitaine;47;1;17;092;Fals;386;6;392
75;Nouvelle-Aquitaine;47;4;08;093;Fargues-sur-Ourbise;346;9;355
75;Nouvelle-Aquitaine;47;2;14;094;Fauguerolles;805;15;820
75;Nouvelle-Aquitaine;47;2;18;095;Fauillet;857;19;876
75;Nouvelle-Aquitaine;47;3;19;096;Ferrensac;207;5;212
75;Nouvelle-Aquitaine;47;4;11;097;Feugarolles;1001;21;1022
75;Nouvelle-Aquitaine;47;4;05;098;Fieux;352;9;361
75;Nouvelle-Aquitaine;47;3;12;099;Fongrave;626;16;642
75;Nouvelle-Aquitaine;47;1;01;100;Foulayronnes;5445;219;5664
75;Nouvelle-Aquitaine;47;2;14;101;Fourques-sur-Garonne;1317;28;1345
75;Nouvelle-Aquitaine;47;4;05;102;Francescas;742;11;753
75;Nouvelle-Aquitaine;47;4;05;103;Fréchou;232;4;236
75;Nouvelle-Aquitaine;47;1;06;104;Frégimont;256;4;260
75;Nouvelle-Aquitaine;47;3;16;105;Frespech;283;5;288
75;Nouvelle-Aquitaine;47;3;09;106;Fumel;4801;92;4893
75;Nouvelle-Aquitaine;47;1;06;107;Galapian;310;6;316
75;Nouvelle-Aquitaine;47;2;13;108;Gaujac;251;7;258
75;Nouvelle-Aquitaine;47;3;10;109;Gavaudun;287;5;292
75;Nouvelle-Aquitaine;47;2;14;110;Gontaud-de-Nogaret;1673;29;1702
75;Nouvelle-Aquitaine;47;1;06;111;Granges-sur-Lot;585;17;602
75;Nouvelle-Aquitaine;47;2;18;112;Grateloup-Saint-Gayrand;422;13;435
75;Nouvelle-Aquitaine;47;1;17;113;Grayssas;136;3;139
75;Nouvelle-Aquitaine;47;2;08;114;Grézet-Cavagnan;389;1;390
75;Nouvelle-Aquitaine;47;2;08;115;Guérin;253;7;260
75;Nouvelle-Aquitaine;47;3;21;117;Hautefage-la-Tour;1010;16;1026
75;Nouvelle-Aquitaine;47;2;18;118;Hautesvignes;180;1;181
75;Nouvelle-Aquitaine;47;4;08;119;Houeillès;562;8;570
75;Nouvelle-Aquitaine;47;2;07;120;Jusix;109;3;112
75;Nouvelle-Aquitaine;47;2;08;121;Labastide-Castel-Amouroux;305;0;305
75;Nouvelle-Aquitaine;47;2;18;122;Labretonie;180;2;182
75;Nouvelle-Aquitaine;47;3;09;123;Lacapelle-Biron;420;5;425
75;Nouvelle-Aquitaine;47;3;10;124;Lacaussade;214;6;220
75;Nouvelle-Aquitaine;47;1;06;125;Lacépède;317;7;324
75;Nouvelle-Aquitaine;47;2;07;126;Lachapelle;90;1;91
75;Nouvelle-Aquitaine;47;2;18;127;Lafitte-sur-Lot;823;13;836
75;Nouvelle-Aquitaine;47;1;17;128;Lafox;1128;29;1157
75;Nouvelle-Aquitaine;47;1;06;129;Lagarrigue;276;6;282
75;Nouvelle-Aquitaine;47;2;08;130;Lagruère;329;5;334
75;Nouvelle-Aquitaine;47;2;07;131;Lagupie;707;15;722
75;Nouvelle-Aquitaine;47;3;19;132;Lalandusse;222;4;226
75;Nouvelle-Aquitaine;47;4;05;133;Lamontjoie;604;8;612
75;Nouvelle-Aquitaine;47;4;05;134;Lannes;369;9;378
75;Nouvelle-Aquitaine;47;2;18;135;Laparade;376;8;384
75;Nouvelle-Aquitaine;47;2;19;136;Laperche;132;2;134
75;Nouvelle-Aquitaine;47;1;15;137;Laplume;1354;32;1386
75;Nouvelle-Aquitaine;47;1;16;138;Laroque-Timbaut;1680;25;1705
75;Nouvelle-Aquitaine;47;4;05;139;Lasserre;82;1;83
75;Nouvelle-Aquitaine;47;1;06;140;Laugnac;681;15;696
75;Nouvelle-Aquitaine;47;3;10;141;Laussou;289;7;296
75;Nouvelle-Aquitaine;47;2;19;142;Lauzun;752;6;758
75;Nouvelle-Aquitaine;47;4;11;143;Lavardac;2267;59;2326
75;Nouvelle-Aquitaine;47;2;19;144;Lavergne;583;21;604
75;Nouvelle-Aquitaine;47;1;17;145;Layrac;3635;55;3690
75;Nouvelle-Aquitaine;47;3;20;146;Lédat;1404;29;1433
75;Nouvelle-Aquitaine;47;2;07;147;Lévignac-de-Guyenne;683;11;694
75;Nouvelle-Aquitaine;47;4;08;148;Leyritz-Moncassin;205;1;206
75;Nouvelle-Aquitaine;47;2;14;150;Longueville;366;6;372
75;Nouvelle-Aquitaine;47;2;07;151;Loubès-Bernac;417;3;420
75;Nouvelle-Aquitaine;47;3;19;152;Lougratte;403;10;413
75;Nouvelle-Aquitaine;47;1;06;154;Lusignan-Petit;369;4;373
75;Nouvelle-Aquitaine;47;1;06;155;Madaillan;651;16;667
75;Nouvelle-Aquitaine;47;2;13;156;Marcellus;859;8;867
75;Nouvelle-Aquitaine;47;2;98;157;Marmande;17534;587;18121
75;Nouvelle-Aquitaine;47;1;15;158;Marmont-Pachas;170;3;173
75;Nouvelle-Aquitaine;47;2;08;159;Le Mas-d'Agenais;1487;34;1521
75;Nouvelle-Aquitaine;47;3;09;160;Masquières;182;2;184
75;Nouvelle-Aquitaine;47;3;16;161;Massels;115;1;116
75;Nouvelle-Aquitaine;47;3;16;162;Massoulès;216;5;221
75;Nouvelle-Aquitaine;47;2;07;163;Mauvezin-sur-Gupie;598;8;606
75;Nouvelle-Aquitaine;47;3;10;164;Mazières-Naresse;120;3;123
75;Nouvelle-Aquitaine;47;2;13;165;Meilhan-sur-Garonne;1319;59;1378
75;Nouvelle-Aquitaine;47;4;05;167;Mézin;1511;27;1538
75;Nouvelle-Aquitaine;47;2;19;168;Miramont-de-Guyenne;3123;102;3225
75;Nouvelle-Aquitaine;47;1;15;169;Moirax;1167;53;1220
75;Nouvelle-Aquitaine;47;3;10;170;Monbahus;606;23;629
75;Nouvelle-Aquitaine;47;1;16;171;Monbalen;429;8;437
75;Nouvelle-Aquitaine;47;4;05;172;Moncaut;604;18;622
75;Nouvelle-Aquitaine;47;3;12;173;Monclar;876;11;887
75;Nouvelle-Aquitaine;47;4;05;174;Moncrabeau;738;17;755
75;Nouvelle-Aquitaine;47;3;10;175;Monflanquin;2321;54;2375
75;Nouvelle-Aquitaine;47;4;11;176;Mongaillard;177;12;189
75;Nouvelle-Aquitaine;47;4;11;177;Monheurt;191;4;195
75;Nouvelle-Aquitaine;47;3;10;178;Monségur;401;8;409
75;Nouvelle-Aquitaine;47;3;09;179;Monsempron-Libos;2087;29;2116
75;Nouvelle-Aquitaine;47;4;05;180;Montagnac-sur-Auvignon;635;14;649
75;Nouvelle-Aquitaine;47;3;10;181;Montagnac-sur-Lède;273;3;276
75;Nouvelle-Aquitaine;47;3;12;182;Montastruc;251;1;252
75;Nouvelle-Aquitaine;47;3;19;183;Montauriol;168;6;174
75;Nouvelle-Aquitaine;47;3;10;184;Montaut;258;4;262
75;Nouvelle-Aquitaine;47;3;09;185;Montayral;2666;69;2735
75;Nouvelle-Aquitaine;47;4;11;186;Montesquieu;775;12;787
75;Nouvelle-Aquitaine;47;2;07;187;Monteton;328;2;330
75;Nouvelle-Aquitaine;47;2;19;188;Montignac-de-Lauzun;287;4;291
75;Nouvelle-Aquitaine;47;2;07;189;Montignac-Toupinerie;149;0;149
75;Nouvelle-Aquitaine;47;1;06;190;Montpezat;551;45;596
75;Nouvelle-Aquitaine;47;2;13;191;Montpouillan;813;9;822
75;Nouvelle-Aquitaine;47;3;10;192;Monviel;79;1;80
75;Nouvelle-Aquitaine;47;3;10;193;Moulinet;199;4;203
75;Nouvelle-Aquitaine;47;2;07;194;Moustier;324;5;329
75;Nouvelle-Aquitaine;47;4;05;195;Nérac;6849;507;7356
75;Nouvelle-Aquitaine;47;1;06;196;Nicole;219;3;222
75;Nouvelle-Aquitaine;47;4;05;197;Nomdieu;254;2;256
75;Nouvelle-Aquitaine;47;3;10;198;Pailloles;340;6;346
75;Nouvelle-Aquitaine;47;2;07;199;Pardaillan;313;5;318
75;Nouvelle-Aquitaine;47;3;10;200;Parranquet;115;1;116
75;Nouvelle-Aquitaine;47;1;04;201;Le Passage;9447;171;9618
75;Nouvelle-Aquitaine;47;3;10;202;Paulhiac;308;7;315
75;Nouvelle-Aquitaine;47;3;16;203;Penne-d'Agenais;2338;49;2387
75;Nouvelle-Aquitaine;47;2;19;204;Peyrière;281;3;284
75;Nouvelle-Aquitaine;47;4;08;205;Pindères;205;8;213
75;Nouvelle-Aquitaine;47;3;12;206;Pinel-Hauterive;568;5;573
75;Nouvelle-Aquitaine;47;4;11;207;Pompiey;207;5;212
75;Nouvelle-Aquitaine;47;4;08;208;Pompogne;204;6;210
75;Nouvelle-Aquitaine;47;1;01;209;Pont-du-Casse;4176;119;4295
75;Nouvelle-Aquitaine;47;1;06;210;Port-Sainte-Marie;1889;30;1919
75;Nouvelle-Aquitaine;47;4;05;211;Poudenas;238;8;246
75;Nouvelle-Aquitaine;47;2;08;212;Poussignac;282;6;288
75;Nouvelle-Aquitaine;47;1;06;213;Prayssas;996;27;1023
75;Nouvelle-Aquitaine;47;4;11;214;Puch-d'Agenais;698;13;711
75;Nouvelle-Aquitaine;47;3;21;215;Pujols;3663;138;3801
75;Nouvelle-Aquitaine;47;2;07;216;Puymiclan;668;13;681
75;Nouvelle-Aquitaine;47;1;17;217;Puymirol;925;15;940
75;Nouvelle-Aquitaine;47;2;19;218;Puysserampion;242;4;246
75;Nouvelle-Aquitaine;47;3;10;219;Rayet;180;2;182
75;Nouvelle-Aquitaine;47;4;11;220;Razimet;296;5;301
75;Nouvelle-Aquitaine;47;4;05;221;Réaup-Lisse;609;18;627
75;Nouvelle-Aquitaine;47;4;08;222;La Réunion;492;9;501
75;Nouvelle-Aquitaine;47;3;10;223;Rives;212;7;219
75;Nouvelle-Aquitaine;47;2;08;224;Romestaing;163;6;169
75;Nouvelle-Aquitaine;47;1;15;225;Roquefort;1969;37;2006
75;Nouvelle-Aquitaine;47;2;19;226;Roumagne;533;9;542
75;Nouvelle-Aquitaine;47;2;08;227;Ruffiac;178;2;180
75;Nouvelle-Aquitaine;47;3;21;228;Saint-Antoine-de-Ficalba;720;10;730
75;Nouvelle-Aquitaine;47;2;07;229;Saint-Astier;223;5;228
75;Nouvelle-Aquitaine;47;3;10;230;Saint-Aubin;402;9;411
75;Nouvelle-Aquitaine;47;2;07;231;Saint-Avit;172;2;174
75;Nouvelle-Aquitaine;47;2;07;232;Saint-Barthélemy-d'Agenais;523;3;526
75;Nouvelle-Aquitaine;47;1;17;234;Saint-Caprais-de-Lerm;664;20;684
75;Nouvelle-Aquitaine;47;2;19;235;Saint-Colomb-de-Lauzun;476;4;480
75;Nouvelle-Aquitaine;47;3;12;239;Saint-Étienne-de-Fougères;839;13;852
75;Nouvelle-Aquitaine;47;3;10;240;Saint-Étienne-de-Villeréal;289;11;300
75;Nouvelle-Aquitaine;47;3;10;241;Saint-Eutrope-de-Born;678;18;696
75;Nouvelle-Aquitaine;47;3;09;242;Saint-Front-sur-Lémance;524;13;537
75;Nouvelle-Aquitaine;47;3;09;328;Saint-Georges;547;19;566
75;Nouvelle-Aquitaine;47;2;07;245;Saint-Géraud;94;2;96
75;Nouvelle-Aquitaine;47;1;15;246;Saint-Hilaire-de-Lusignan;1484;39;1523
75;Nouvelle-Aquitaine;47;2;07;247;Saint-Jean-de-Duras;244;10;254
75;Nouvelle-Aquitaine;47;1;17;248;Saint-Jean-de-Thurac;570;7;577
75;Nouvelle-Aquitaine;47;4;11;249;Saint-Laurent;525;4;529
75;Nouvelle-Aquitaine;47;4;11;250;Saint-Léger;128;4;132
75;Nouvelle-Aquitaine;47;4;11;251;Saint-Léon;322;5;327
75;Nouvelle-Aquitaine;47;4;08;254;Saint-Martin-Curton;311;8;319
75;Nouvelle-Aquitaine;47;1;16;255;Saint-Martin-de-Beauville;176;3;179
75;Nouvelle-Aquitaine;47;3;10;256;Saint-Martin-de-Villeréal;104;4;108
75;Nouvelle-Aquitaine;47;2;07;257;Saint-Martin-Petit;606;8;614
75;Nouvelle-Aquitaine;47;3;10;259;Saint-Maurice-de-Lestapel;104;4;108
75;Nouvelle-Aquitaine;47;1;16;260;Saint-Maurin;435;5;440
75;Nouvelle-Aquitaine;47;1;17;262;Saint-Nicolas-de-la-Balerme;416;4;420
75;Nouvelle-Aquitaine;47;2;14;263;Saint-Pardoux-du-Breuil;615;15;630
75;Nouvelle-Aquitaine;47;2;19;264;Saint-Pardoux-Isaac;1120;19;1139
75;Nouvelle-Aquitaine;47;3;12;265;Saint-Pastour;382;8;390
75;Nouvelle-Aquitaine;47;4;05;266;Saint-Pé-Saint-Simon;205;2;207
75;Nouvelle-Aquitaine;47;4;11;267;Saint-Pierre-de-Buzet;296;2;298
75;Nouvelle-Aquitaine;47;1;17;269;Saint-Pierre-de-Clairac;854;19;873
75;Nouvelle-Aquitaine;47;2;07;271;Saint-Pierre-sur-Dropt;349;3;352
75;Nouvelle-Aquitaine;47;3;19;272;Saint-Quentin-du-Dropt;196;7;203
75;Nouvelle-Aquitaine;47;1;16;273;Saint-Robert;185;6;191
75;Nouvelle-Aquitaine;47;1;17;274;Saint-Romain-le-Noble;403;6;409
75;Nouvelle-Aquitaine;47;1;06;275;Saint-Salvy;200;1;201
75;Nouvelle-Aquitaine;47;1;06;276;Saint-Sardos;298;7;305
75;Nouvelle-Aquitaine;47;2;13;277;Saint-Sauveur-de-Meilhan;335;1;336
75;Nouvelle-Aquitaine;47;2;07;278;Saint-Sernin;454;9;463
75;Nouvelle-Aquitaine;47;1;17;279;Saint-Sixte;356;6;362
75;Nouvelle-Aquitaine;47;3;16;280;Saint-Sylvestre-sur-Lot;2310;52;2362
75;Nouvelle-Aquitaine;47;1;17;281;Saint-Urcisse;243;1;244
75;Nouvelle-Aquitaine;47;4;05;282;Saint-Vincent-de-Lamontjoie;238;7;245
75;Nouvelle-Aquitaine;47;3;09;283;Saint-Vite;1163;30;1193
75;Nouvelle-Aquitaine;47;2;13;233;Sainte-Bazeille;3146;103;3249
75;Nouvelle-Aquitaine;47;2;07;236;Sainte-Colombe-de-Duras;105;1;106
75;Nouvelle-Aquitaine;47;3;21;237;Sainte-Colombe-de-Villeneuve;496;11;507
75;Nouvelle-Aquitaine;47;1;15;238;Sainte-Colombe-en-Bruilhois;1624;54;1678
75;Nouvelle-Aquitaine;47;2;08;244;Sainte-Gemme-Martaillac;399;5;404
75;Nouvelle-Aquitaine;47;3;12;252;Sainte-Livrade-sur-Lot;6458;175;6633
75;Nouvelle-Aquitaine;47;2;08;253;Sainte-Marthe;622;5;627
75;Nouvelle-Aquitaine;47;4;05;258;Sainte-Maure-de-Peyriac;322;10;332
75;Nouvelle-Aquitaine;47;3;10;284;Salles;295;7;302
75;Nouvelle-Aquitaine;47;2;14;285;Samazan;884;18;902
75;Nouvelle-Aquitaine;47;4;08;286;Sauméjan;109;0;109
75;Nouvelle-Aquitaine;47;4;05;287;Saumont;262;3;265
75;Nouvelle-Aquitaine;47;1;17;288;Sauvagnas;525;14;539
75;Nouvelle-Aquitaine;47;1;16;289;La Sauvetat-de-Savères;533;11;544
75;Nouvelle-Aquitaine;47;2;07;290;La Sauvetat-du-Dropt;542;6;548
75;Nouvelle-Aquitaine;47;3;10;291;La Sauvetat-sur-Lède;639;16;655
75;Nouvelle-Aquitaine;47;3;09;292;Sauveterre-la-Lémance;557;6;563
75;Nouvelle-Aquitaine;47;1;17;293;Sauveterre-Saint-Denis;387;17;404
75;Nouvelle-Aquitaine;47;2;07;294;Savignac-de-Duras;219;1;220
75;Nouvelle-Aquitaine;47;3;10;295;Savignac-sur-Leyze;304;6;310
75;Nouvelle-Aquitaine;47;2;19;296;Ségalas;155;2;157
75;Nouvelle-Aquitaine;47;3;06;297;Sembas;142;3;145
75;Nouvelle-Aquitaine;47;2;08;298;Sénestis;211;3;214
75;Nouvelle-Aquitaine;47;3;19;299;Sérignac-Péboudou;173;5;178
75;Nouvelle-Aquitaine;47;1;15;300;Sérignac-sur-Garonne;1166;20;1186
75;Nouvelle-Aquitaine;47;2;07;301;Seyches;1052;11;1063
75;Nouvelle-Aquitaine;47;4;05;302;Sos;657;7;664
75;Nouvelle-Aquitaine;47;2;07;303;Soumensac;230;9;239
75;Nouvelle-Aquitaine;47;2;14;304;Taillebourg;63;2;65
75;Nouvelle-Aquitaine;47;1;16;305;Tayrac;392;6;398
75;Nouvelle-Aquitaine;47;3;12;306;Le Temple-sur-Lot;1038;19;1057
75;Nouvelle-Aquitaine;47;3;09;307;Thézac;199;5;204
75;Nouvelle-Aquitaine;47;4;11;308;Thouars-sur-Garonne;222;3;225
75;Nouvelle-Aquitaine;47;3;12;309;Tombebœuf;457;4;461
75;Nouvelle-Aquitaine;47;2;18;310;Tonneins;9107;226;9333
75;Nouvelle-Aquitaine;47;3;10;311;Tourliac;135;8;143
75;Nouvelle-Aquitaine;47;3;09;312;Tournon-d'Agenais;760;13;773
75;Nouvelle-Aquitaine;47;3;12;313;Tourtrès;137;1;138
75;Nouvelle-Aquitaine;47;3;16;314;Trémons;395;10;405
75;Nouvelle-Aquitaine;47;3;09;315;Trentels;885;27;912
75;Nouvelle-Aquitaine;47;2;18;316;Varès;671;8;679
75;Nouvelle-Aquitaine;47;2;18;317;Verteuil-d'Agenais;588;6;594
75;Nouvelle-Aquitaine;47;4;11;318;Vianne;1009;15;1024
75;Nouvelle-Aquitaine;47;3;12;319;Villebramar;104;3;107
75;Nouvelle-Aquitaine;47;4;08;320;Villefranche-du-Queyran;389;1;390
75;Nouvelle-Aquitaine;47;2;07;321;Villeneuve-de-Duras;317;5;322
75;Nouvelle-Aquitaine;47;3;99;323;Villeneuve-sur-Lot;21915;685;22600
75;Nouvelle-Aquitaine;47;3;10;324;Villeréal;1290;30;1320
75;Nouvelle-Aquitaine;47;2;08;325;Villeton;457;6;463
75;Nouvelle-Aquitaine;47;2;14;326;Virazeil;1689;34;1723
75;Nouvelle-Aquitaine;47;4;11;327;Xaintrailles;408;12;420
76;Occitanie;48;2;01;001;Albaret-le-Comtal;175;4;179
76;Occitanie;48;2;12;002;Albaret-Sainte-Marie;565;21;586
76;Occitanie;48;2;06;003;Allenc;248;5;253
76;Occitanie;48;2;13;004;Altier;207;10;217
76;Occitanie;48;2;08;005;Antrenas;331;8;339
76;Occitanie;48;2;01;007;Arzenc-d'Apcher;50;0;50
76;Occitanie;48;2;06;008;Arzenc-de-Randon;194;9;203
76;Occitanie;48;2;07;010;Auroux;378;6;384
76;Occitanie;48;2;06;013;Badaroux;974;41;1015
76;Occitanie;48;2;03;016;Balsièges;555;18;573
76;Occitanie;48;2;02;017;Banassac-Canilhac;1056;36;1092
76;Occitanie;48;2;03;018;Barjac;751;18;769
76;Occitanie;48;1;04;019;Barre-des-Cévennes;203;9;212
76;Occitanie;48;1;04;020;Bassurels;63;0;63
76;Occitanie;48;2;13;021;La Bastide-Puylaurent;155;3;158
76;Occitanie;48;1;13;050;Bédouès-Cocurès;461;15;476
76;Occitanie;48;2;06;038;Bel-Air-Val-d'Ance ;534;7;541
76;Occitanie;48;2;01;025;Les Bessons;432;26;458
76;Occitanie;48;2;12;026;Blavignac;261;1;262
76;Occitanie;48;1;13;028;Les Bondons;143;10;153
76;Occitanie;48;2;06;029;Le Born;147;0;147
76;Occitanie;48;2;03;099;Bourgs sur Colagne;2115;49;2164
76;Occitanie;48;2;13;030;Brenoux;384;8;392
76;Occitanie;48;2;01;031;Brion;78;3;81
76;Occitanie;48;2;01;032;Le Buisson;223;6;229
76;Occitanie;48;2;02;034;La Canourgue;2146;99;2245
76;Occitanie;48;1;04;166;Cans et Cévennes;286;11;297
76;Occitanie;48;1;04;036;Cassagnas;125;2;127
76;Occitanie;48;2;06;037;Chadenet;119;2;121
76;Occitanie;48;2;02;039;Chanac;1459;33;1492
76;Occitanie;48;2;07;041;Chastanier;77;0;77
76;Occitanie;48;2;11;042;Chastel-Nouvel;889;34;923
76;Occitanie;48;2;06;043;Châteauneuf-de-Randon;538;8;546
76;Occitanie;48;2;01;044;Chauchailles;87;2;89
76;Occitanie;48;2;06;045;Chaudeyrac;299;11;310
76;Occitanie;48;2;11;046;Chaulhac;68;2;70
76;Occitanie;48;2;07;048;Cheylard-l'Évêque;63;3;66
76;Occitanie;48;1;04;051;Le Collet-de-Dèze;719;49;768
76;Occitanie;48;2;13;053;Cubières;184;8;192
76;Occitanie;48;2;13;054;Cubiérettes;51;5;56
76;Occitanie;48;2;03;055;Cultures;174;4;178
76;Occitanie;48;2;03;056;Esclanèdes;398;9;407
76;Occitanie;48;2;01;058;La Fage-Montivernoux;155;5;160
76;Occitanie;48;2;01;059;La Fage-Saint-Julien;306;5;311
76;Occitanie;48;1;05;061;Florac Trois Rivières ;2072;43;2115
76;Occitanie;48;2;11;063;Fontans;223;3;226
76;Occitanie;48;2;01;064;Fournels;369;9;378
76;Occitanie;48;1;04;065;Fraissinet-de-Fourques;80;0;80
76;Occitanie;48;1;04;067;Gabriac;100;2;102
76;Occitanie;48;2;03;068;Gabrias;155;6;161
76;Occitanie;48;1;05;069;Gatuzières;53;0;53
76;Occitanie;48;1;88;146;Gorges du Tarn Causses;931;33;964
76;Occitanie;48;2;06;070;Grandrieu;752;15;767
76;Occitanie;48;2;01;071;Grandvals;69;1;70
76;Occitanie;48;2;03;072;Grèzes;230;6;236
76;Occitanie;48;2;01;073;Les Hermaux;97;4;101
76;Occitanie;48;1;05;074;Hures-la-Parade;234;11;245
76;Occitanie;48;1;05;075;Ispagnac;893;27;920
76;Occitanie;48;2;11;077;Julianges;50;2;52
76;Occitanie;48;2;08;126;Lachamp-Ribennes ;352;12;364
76;Occitanie;48;2;11;079;Lajo;110;3;113
76;Occitanie;48;2;07;080;Langogne;2886;193;3079
76;Occitanie;48;2;13;081;Lanuéjols;319;10;329
76;Occitanie;48;2;06;082;Laubert;98;3;101
76;Occitanie;48;2;11;083;Les Laubies;153;4;157
76;Occitanie;48;2;02;085;Laval-du-Tarn;95;4;99
76;Occitanie;48;2;07;086;Luc;213;5;218
76;Occitanie;48;1;02;088;La Malène;137;5;142
76;Occitanie;48;2;11;089;Le Malzieu-Forain;484;11;495
76;Occitanie;48;2;11;090;Le Malzieu-Ville;725;14;739
76;Occitanie;48;2;01;091;Marchastel;53;3;56
76;Occitanie;48;2;08;092;Marvejols;4667;244;4911
76;Occitanie;48;1;05;141;Mas-Saint-Chély;110;6;116
76;Occitanie;48;1;02;094;Massegros Causses Gorges;975;28;1003
76;Occitanie;48;2;99;095;Mende;12227;822;13049
76;Occitanie;48;1;05;096;Meyrueis;821;124;945
76;Occitanie;48;1;04;097;Moissac-Vallée-Française;217;9;226
76;Occitanie;48;1;04;098;Molezon;95;4;99
76;Occitanie;48;2;  ;027;Mont Lozère et Goulet ;1039;49;1088
76;Occitanie;48;2;06;100;Montbel;116;3;119
76;Occitanie;48;2;03;103;Montrodat;1210;75;1285
76;Occitanie;48;2;  ;127;Monts-de-Randon ;1293;21;1314
76;Occitanie;48;2;01;012;Les Monts-Verts;354;12;366
76;Occitanie;48;2;01;104;Nasbinals;542;31;573
76;Occitanie;48;2;07;105;Naussac-Fontanes;362;18;380
76;Occitanie;48;2;01;106;Noalhac;98;7;105
76;Occitanie;48;2;03;107;Palhers;180;7;187
76;Occitanie;48;2;06;108;La Panouse;75;2;77
76;Occitanie;48;2;11;110;Paulhac-en-Margeride;101;5;106
76;Occitanie;48;2;06;111;Pelouse;234;8;242
76;Occitanie;48;2;01;009;Peyre en Aubrac ;2287;82;2369
76;Occitanie;48;2;13;015;Pied-de-Borne;180;12;192
76;Occitanie;48;2;06;112;Pierrefiche;164;5;169
76;Occitanie;48;1;04;115;Le Pompidou;160;7;167
76;Occitanie;48;1;13;116;Pont de Montvert - Sud Mont Lozère;573;24;597
76;Occitanie;48;2;13;117;Pourcharesses;120;2;122
76;Occitanie;48;2;13;119;Prévenchères;252;13;265
76;Occitanie;48;2;01;087;Prinsuéjols-Malbouzon;272;10;282
76;Occitanie;48;2;12;121;Prunières;248;11;259
76;Occitanie;48;2;01;123;Recoules-d'Aubrac;179;6;185
76;Occitanie;48;2;08;124;Recoules-de-Fumas;104;0;104
76;Occitanie;48;2;12;128;Rimeize;586;21;607
76;Occitanie;48;2;07;129;Rocles;231;6;237
76;Occitanie;48;1;04;130;Rousses;121;1;122
76;Occitanie;48;1;05;131;Le Rozier;132;7;139
76;Occitanie;48;2;11;132;Saint-Alban-sur-Limagnole;1364;33;1397
76;Occitanie;48;2;13;135;Saint-André-Capcèze;183;0;183
76;Occitanie;48;1;04;136;Saint-André-de-Lancize;142;2;144
76;Occitanie;48;2;13;137;Saint-Bauzile;623;25;648
76;Occitanie;48;2;03;138;Saint-Bonnet-de-Chirac;66;2;68
76;Occitanie;48;2;07;139;Saint Bonnet-Laval ;252;2;254
76;Occitanie;48;2;12;140;Saint-Chély-d'Apcher;4183;588;4771
76;Occitanie;48;2;11;145;Saint-Denis-en-Margeride;164;7;171
76;Occitanie;48;2;13;147;Saint-Étienne-du-Valdonnez;645;54;699
76;Occitanie;48;1;04;148;Saint-Étienne-Vallée-Française;507;29;536
76;Occitanie;48;2;07;150;Saint-Flour-de-Mercoire;190;14;204
76;Occitanie;48;2;06;151;Saint-Frézal-d'Albuges;66;3;69
76;Occitanie;48;2;11;153;Saint-Gal;86;5;91
76;Occitanie;48;1;04;155;Saint-Germain-de-Calberte;456;6;462
76;Occitanie;48;2;03;156;Saint-Germain-du-Teil;879;23;902
76;Occitanie;48;1;04;158;Saint-Hilaire-de-Lavit;110;4;114
76;Occitanie;48;2;06;160;Saint-Jean-la-Fouillouse;157;7;164
76;Occitanie;48;2;01;161;Saint-Juéry;68;2;70
76;Occitanie;48;1;04;163;Saint-Julien-des-Points;112;3;115
76;Occitanie;48;2;01;165;Saint-Laurent-de-Muret;183;10;193
76;Occitanie;48;2;01;167;Saint-Laurent-de-Veyrès;37;1;38
76;Occitanie;48;2;08;168;Saint-Léger-de-Peyre;189;5;194
76;Occitanie;48;2;11;169;Saint-Léger-du-Malzieu;212;11;223
76;Occitanie;48;1;04;170;Saint-Martin-de-Boubaux;191;5;196
76;Occitanie;48;1;04;171;Saint-Martin-de-Lansuscle;190;2;192
76;Occitanie;48;1;04;173;Saint-Michel-de-Dèze;237;3;240
76;Occitanie;48;2;06;174;Saint-Paul-le-Froid;139;3;142
76;Occitanie;48;2;01;175;Saint-Pierre-de-Nogaret;178;10;188
76;Occitanie;48;1;05;176;Saint-Pierre-des-Tripiers;89;4;93
76;Occitanie;48;2;12;177;Saint-Pierre-le-Vieux;321;9;330
76;Occitanie;48;1;04;178;Saint-Privat-de-Vallongue;221;6;227
76;Occitanie;48;2;11;179;Saint-Privat-du-Fau;118;2;120
76;Occitanie;48;2;02;181;Saint-Saturnin;63;4;67
76;Occitanie;48;2;06;182;Saint-Sauveur-de-Ginestoux;57;2;59
76;Occitanie;48;1;04;144;Sainte-Croix-Vallée-Française;272;9;281
76;Occitanie;48;2;11;149;Sainte-Eulalie;36;2;38
76;Occitanie;48;2;06;157;Sainte-Hélène;104;4;108
76;Occitanie;48;2;01;187;Les Salces;99;1;100
76;Occitanie;48;2;03;185;Les Salelles;165;5;170
76;Occitanie;48;2;11;188;Serverette;251;5;256
76;Occitanie;48;2;01;190;Termes;213;8;221
76;Occitanie;48;2;02;191;La Tieule;93;3;96
76;Occitanie;48;2;01;192;Trélans;91;2;93
76;Occitanie;48;1;04;193;Vebron;209;1;210
76;Occitanie;48;1;04;152;Ventalon en Cévennes;252;5;257
76;Occitanie;48;1;13;194;Vialas;427;48;475
76;Occitanie;48;2;13;198;Villefort;546;12;558
52;Pays de la Loire;49;3;15;002;Allonnes;3003;54;3057
52;Pays de la Loire;49;1;98;007;Angers;154508;3069;157577
52;Pays de la Loire;49;4;20;008;Angrie;940;25;965
52;Pays de la Loire;49;3;14;009;Antoigné;464;4;468
52;Pays de la Loire;49;4;20;010;Armaillé;317;5;322
52;Pays de la Loire;49;3;19;011;Artannes-sur-Thouet;428;17;445
52;Pays de la Loire;49;1;11;012;Aubigné-sur-Layon;368;11;379
52;Pays de la Loire;49;1;04;015;Avrillé;14065;355;14420
52;Pays de la Loire;49;1;21;017;Baracé;588;6;594
52;Pays de la Loire;49;3;08;018;Baugé-en-Anjou ;11802;258;12060
52;Pays de la Loire;49;1;03;020;Beaucouzé;5298;104;5402
52;Pays de la Loire;49;3;08;021;Beaufort-en-Anjou ;7211;154;7365
52;Pays de la Loire;49;1;11;022;Beaulieu-sur-Layon;1370;29;1399
52;Pays de la Loire;49;2;09;023;Beaupréau-en-Mauges ;23407;708;24115
52;Pays de la Loire;49;4;10;026;Bécon-les-Granits;2796;104;2900
52;Pays de la Loire;49;2;09;027;Bégrolles-en-Mauges;2089;42;2131
52;Pays de la Loire;49;1;03;028;Béhuard;125;6;131
52;Pays de la Loire;49;1;11;345;Bellevigne-en-Layon;5740;114;5854
52;Pays de la Loire;49;3;  ;060;Bellevigne-les-Châteaux ;3498;80;3578
52;Pays de la Loire;49;1;17;029;Blaison-Saint-Sulpice;1271;28;1299
52;Pays de la Loire;49;3;15;030;Blou;995;32;1027
52;Pays de la Loire;49;3;08;138;Les Bois d'Anjou;2629;58;2687
52;Pays de la Loire;49;1;02;035;Bouchemaine;6796;141;6937
52;Pays de la Loire;49;4;20;036;Bouillé-Ménard;752;20;772
52;Pays de la Loire;49;4;20;038;Bourg-l'Évêque;245;5;250
52;Pays de la Loire;49;3;15;041;Brain-sur-Allonnes;2021;35;2056
52;Pays de la Loire;49;3;15;045;La Breille-les-Pins;600;13;613
52;Pays de la Loire;49;1;05;048;Briollay;3036;40;3076
52;Pays de la Loire;49;1;  ;050;Brissac Loire Aubance ;10859;273;11132
52;Pays de la Loire;49;3;14;053;Brossay;357;4;361
52;Pays de la Loire;49;4;20;054;Candé;2830;62;2892
52;Pays de la Loire;49;1;05;055;Cantenay-Épinard;2317;35;2352
52;Pays de la Loire;49;4;20;056;Carbay;264;6;270
52;Pays de la Loire;49;2;13;057;Cernusson;345;5;350
52;Pays de la Loire;49;2;13;058;Les Cerqueux;881;9;890
52;Pays de la Loire;49;4;20;061;Challain-la-Potherie;800;19;819
52;Pays de la Loire;49;1;10;063;Chalonnes-sur-Loire;6527;173;6700
52;Pays de la Loire;49;4;21;064;Chambellay;400;12;412
52;Pays de la Loire;49;1;10;068;Champtocé-sur-Loire;1870;31;1901
52;Pays de la Loire;49;2;13;070;Chanteloup-les-Bois;690;10;700
52;Pays de la Loire;49;1;06;076;La Chapelle-Saint-Laud;765;7;772
52;Pays de la Loire;49;1;10;082;Chaudefonds-sur-Layon;945;17;962
52;Pays de la Loire;49;4;20;089;Chazé-sur-Argos;1052;28;1080
52;Pays de la Loire;49;1;21;090;Cheffes;973;12;985
52;Pays de la Loire;49;2;11;092;Chemillé-en-Anjou ;20985;598;21583
52;Pays de la Loire;49;4;21;067;Chenillé-Champteussé ;345;9;354
52;Pays de la Loire;49;2;99;099;Cholet;54186;1941;56127
52;Pays de la Loire;49;3;14;100;Cizay-la-Madeleine;469;17;486
52;Pays de la Loire;49;2;13;102;Cléré-sur-Layon;340;6;346
52;Pays de la Loire;49;1;06;107;Cornillé-les-Caves;468;16;484
52;Pays de la Loire;49;2;13;109;Coron;1588;30;1618
52;Pays de la Loire;49;1;06;110;Corzé;1866;31;1897
52;Pays de la Loire;49;3;14;112;Le Coudray-Macouard;935;27;962
52;Pays de la Loire;49;3;14;113;Courchamps;515;9;524
52;Pays de la Loire;49;3;15;114;Courléon;146;4;150
52;Pays de la Loire;49;1;10;120;Denée;1388;23;1411
52;Pays de la Loire;49;3;14;121;Dénezé-sous-Doué;473;9;482
52;Pays de la Loire;49;3;19;123;Distré;1723;56;1779
52;Pays de la Loire;49;3;14;125;Doué-en-Anjou ;11100;256;11356
52;Pays de la Loire;49;1;21;127;Durtal;3372;75;3447
52;Pays de la Loire;49;1;05;129;Écouflant;4249;56;4305
52;Pays de la Loire;49;1;05;130;Écuillé;653;7;660
52;Pays de la Loire;49;3;14;131;Épieds;747;7;754
52;Pays de la Loire;49;4;87;367;Erdre-en-Anjou;5743;84;5827
52;Pays de la Loire;49;1;21;132;Étriché;1552;17;1569
52;Pays de la Loire;49;1;05;135;Feneu;2171;38;2209
52;Pays de la Loire;49;3;19;140;Fontevraud-l'Abbaye;1540;26;1566
52;Pays de la Loire;49;1;17;167;Les Garennes sur Loire;4521;110;4631
52;Pays de la Loire;49;3;85;261;Gennes-Val-de-Loire;8661;170;8831
52;Pays de la Loire;49;4;21;155;Grez-Neuville;1433;40;1473
52;Pays de la Loire;49;4;21;080;Hauts-d'Anjou ;8762;185;8947
52;Pays de la Loire;49;1;06;174;Huillé-Lézigné ;1318;21;1339
52;Pays de la Loire;49;1;10;160;Ingrandes-Le Fresne sur Loire;2644;58;2702
52;Pays de la Loire;49;4;21;161;La Jaille-Yvon;326;6;332
52;Pays de la Loire;49;1;06;163;Jarzé Villages;2746;28;2774
52;Pays de la Loire;49;4;21;170;Juvardeil;812;12;824
52;Pays de la Loire;49;3;15;171;La Lande-Chasles;123;0;123
52;Pays de la Loire;49;4;21;176;Le Lion-d'Angers;4974;75;5049
52;Pays de la Loire;49;4;20;178;Loiré;870;21;891
52;Pays de la Loire;49;1;07;307;Loire-Authion ;15812;582;16394
52;Pays de la Loire;49;3;15;180;Longué-Jumelles;6809;120;6929
52;Pays de la Loire;49;1;89;200;Longuenée-en-Anjou;6312;171;6483
52;Pays de la Loire;49;3;14;182;Louresse-Rochemenier;872;16;888
52;Pays de la Loire;49;2;13;373;Lys-Haut-Layon;7830;178;8008
52;Pays de la Loire;49;1;06;188;Marcé;840;15;855
52;Pays de la Loire;49;2;16;244;Mauges-sur-Loire ;18018;471;18489
52;Pays de la Loire;49;2;13;192;Maulévrier;3190;78;3268
52;Pays de la Loire;49;2;18;193;Le May-sur-Èvre;3812;89;3901
52;Pays de la Loire;49;3;08;194;Mazé-Milon ;5815;103;5918
52;Pays de la Loire;49;2;13;195;Mazières-en-Mauges;1200;28;1228
52;Pays de la Loire;49;3;07;201;La Ménitré;2056;35;2091
52;Pays de la Loire;49;4;21;205;Miré;974;11;985
52;Pays de la Loire;49;1;21;209;Montigné-lès-Rairies;432;3;435
52;Pays de la Loire;49;2;13;211;Montilliers;1219;30;1249
52;Pays de la Loire;49;3;14;215;Montreuil-Bellay;3740;251;3991
52;Pays de la Loire;49;1;04;214;Montreuil-Juigné;7521;148;7669
52;Pays de la Loire;49;1;06;216;Montreuil-sur-Loir;578;6;584
52;Pays de la Loire;49;4;21;217;Montreuil-sur-Maine;774;11;785
52;Pays de la Loire;49;2;09;218;Montrevault-sur-Èvre ;15787;319;16106
52;Pays de la Loire;49;3;19;219;Montsoreau;438;6;444
52;Pays de la Loire;49;1;21;220;Morannes sur Sarthe-Daumeray ;3677;57;3734
52;Pays de la Loire;49;3;15;221;Mouliherne;835;23;858
52;Pays de la Loire;49;1;11;222;Mozé-sur-Louet;1999;45;2044
52;Pays de la Loire;49;1;17;223;Mûrs-Erigné;5642;101;5743
52;Pays de la Loire;49;3;15;224;Neuillé;994;10;1004
52;Pays de la Loire;49;3;08;228;Noyant-Villages ;5589;171;5760
52;Pays de la Loire;49;2;13;231;Nuaillé;1463;37;1500
52;Pays de la Loire;49;4;20;248;Ombrée d'Anjou ;8962;251;9213
52;Pays de la Loire;49;2;16;069;Orée d'Anjou ;16354;278;16632
52;Pays de la Loire;49;3;19;235;Parnay;431;15;446
52;Pays de la Loire;49;2;13;236;Passavant-sur-Layon;124;5;129
52;Pays de la Loire;49;3;08;237;La Pellerine;135;2;137
52;Pays de la Loire;49;2;13;240;La Plaine;1003;31;1034
52;Pays de la Loire;49;1;07;241;Le Plessis-Grammoire;2450;58;2508
52;Pays de la Loire;49;1;17;246;Les Ponts-de-Cé;12811;543;13354
52;Pays de la Loire;49;1;10;247;La Possonnière;2445;42;2487
52;Pays de la Loire;49;3;14;253;Le Puy-Notre-Dame;1188;21;1209
52;Pays de la Loire;49;1;21;257;Les Rairies;1019;16;1035
52;Pays de la Loire;49;1;06;377;Rives-du-Loir-en-Anjou ;5618;91;5709
52;Pays de la Loire;49;1;10;259;Rochefort-sur-Loire;2339;61;2400
52;Pays de la Loire;49;2;18;260;La Romagne;1913;88;2001
52;Pays de la Loire;49;3;19;262;Rou-Marson;658;9;667
52;Pays de la Loire;49;4;10;266;Saint-Augustin-des-Bois;1222;29;1251
52;Pays de la Loire;49;1;06;267;Saint-Barthélemy-d'Anjou;9203;233;9436
52;Pays de la Loire;49;2;18;269;Saint-Christophe-du-Bois;2766;60;2826
52;Pays de la Loire;49;1;03;271;Saint-Clément-de-la-Place;2102;28;2130
52;Pays de la Loire;49;3;15;272;Saint-Clément-des-Levées;1098;20;1118
52;Pays de la Loire;49;1;10;283;Saint-Georges-sur-Loire;3649;39;3688
52;Pays de la Loire;49;1;10;284;Saint-Germain-des-Prés;1397;23;1420
52;Pays de la Loire;49;1;17;288;Saint-Jean-de-la-Croix;229;6;235
52;Pays de la Loire;49;3;14;291;Saint-Just-sur-Dive;383;5;388
52;Pays de la Loire;49;1;03;294;Saint-Lambert-la-Potherie;2880;30;2910
52;Pays de la Loire;49;1;03;298;Saint-Léger-de-Linières ;3637;62;3699
52;Pays de la Loire;49;2;18;299;Saint-Léger-sous-Cholet;2974;69;3043
52;Pays de la Loire;49;3;14;302;Saint-Macaire-du-Bois;453;5;458
52;Pays de la Loire;49;1;03;306;Saint-Martin-du-Fouilloux;1674;36;1710
52;Pays de la Loire;49;1;17;308;Saint-Melaine-sur-Aubance;2086;53;2139
52;Pays de la Loire;49;2;13;310;Saint-Paul-du-Bois;593;20;613
52;Pays de la Loire;49;3;15;311;Saint-Philbert-du-Peuple;1320;28;1348
52;Pays de la Loire;49;4;10;321;Saint-Sigismond;384;8;392
52;Pays de la Loire;49;1;02;278;Sainte-Gemmes-sur-Loire;3396;253;3649
52;Pays de la Loire;49;1;07;326;Sarrigné;818;19;837
52;Pays de la Loire;49;3;19;328;Saumur;26599;985;27584
52;Pays de la Loire;49;1;03;329;Savennières;1336;50;1386
52;Pays de la Loire;49;4;21;330;Sceaux-d'Anjou;1186;18;1204
52;Pays de la Loire;49;4;20;331;Segré-en-Anjou Bleu ;17474;832;18306
52;Pays de la Loire;49;2;18;332;La Séguinière;4173;112;4285
52;Pays de la Loire;49;1;06;333;Seiches-sur-le-Loir;2945;62;3007
52;Pays de la Loire;49;1;06;334;Sermaise;327;5;332
52;Pays de la Loire;49;2;18;301;Sèvremoine ;25330;565;25895
52;Pays de la Loire;49;2;13;336;Somloire;881;16;897
52;Pays de la Loire;49;1;17;338;Soulaines-sur-Aubance;1428;28;1456
52;Pays de la Loire;49;1;05;339;Soulaire-et-Bourg;1494;39;1533
52;Pays de la Loire;49;3;19;341;Souzay-Champigny;755;23;778
52;Pays de la Loire;49;1;11;086;Terranjou ;3979;83;4062
52;Pays de la Loire;49;2;13;343;La Tessoualle;3198;72;3270
52;Pays de la Loire;49;4;21;344;Thorigné-d'Anjou;1231;25;1256
52;Pays de la Loire;49;1;21;347;Tiercé;4407;73;4480
52;Pays de la Loire;49;2;13;352;Toutlemonde;1328;33;1361
52;Pays de la Loire;49;1;07;353;Trélazé;14759;165;14924
52;Pays de la Loire;49;2;13;355;Trémentines;3048;52;3100
52;Pays de la Loire;49;3;14;003;Tuffalun;1761;37;1798
52;Pays de la Loire;49;3;19;358;Turquant;568;14;582
52;Pays de la Loire;49;3;14;359;Les Ulmes;578;15;593
52;Pays de la Loire;49;4;10;183;Val d'Erdre-Auxence;4897;84;4981
52;Pays de la Loire;49;1;88;292;Val-du-Layon;3407;48;3455
52;Pays de la Loire;49;3;15;361;Varennes-sur-Loire;1835;37;1872
52;Pays de la Loire;49;3;19;362;Varrains;1223;50;1273
52;Pays de la Loire;49;3;14;364;Vaudelnay;1143;22;1165
52;Pays de la Loire;49;3;15;368;Vernantes;1992;38;2030
52;Pays de la Loire;49;3;15;369;Vernoil-le-Fourrier;1264;21;1285
52;Pays de la Loire;49;3;19;370;Verrie;478;7;485
52;Pays de la Loire;49;1;06;323;Verrières-en-Anjou;7365;294;7659
52;Pays de la Loire;49;2;13;371;Vezins;1721;30;1751
52;Pays de la Loire;49;3;15;374;Villebernier;1464;33;1497
52;Pays de la Loire;49;3;15;378;Vivy;2559;35;2594
52;Pays de la Loire;49;2;13;381;Yzernay;1827;30;1857
28;Normandie;50;4;22;002;Agneaux;4061;446;4507
28;Normandie;50;3;01;003;Agon-Coutainville;2790;95;2885
28;Normandie;50;4;18;004;Airel;550;3;553
28;Normandie;50;4;18;006;Amigny;150;5;155
28;Normandie;50;1;03;008;Anctoville-sur-Boscq;446;18;464
28;Normandie;50;2;26;013;Anneville-en-Saire;387;9;396
28;Normandie;50;3;20;015;Annoville;662;13;675
28;Normandie;50;3;05;016;Appeville;179;2;181
28;Normandie;50;1;19;019;Aucey-la-Plaine;423;6;429
28;Normandie;50;2;05;021;Audouville-la-Hubert;77;1;78
28;Normandie;50;2;26;022;Aumeville-Lestre;112;3;115
28;Normandie;50;4;05;023;Auvers;676;10;686
28;Normandie;50;3;01;024;Auxais;172;3;175
28;Normandie;50;1;  ;025;Avranches ;10246;554;10800
28;Normandie;50;2;25;026;Azeville;80;1;81
28;Normandie;50;1;02;027;Bacilly;951;27;978
28;Normandie;50;3;20;028;La Baleine;96;3;99
28;Normandie;50;1;16;029;Barenton;1171;65;1236
28;Normandie;50;2;26;030;Barfleur;564;8;572
28;Normandie;50;2;17;031;Barneville-Carteret;2235;56;2291
28;Normandie;50;4;23;032;La Barre-de-Semilly;1021;39;1060
28;Normandie;50;2;17;033;Baubigny;142;4;146
28;Normandie;50;4;23;034;Baudre;544;18;562
28;Normandie;50;3;05;036;Baupte;430;8;438
28;Normandie;50;1;03;038;Beauchamps;414;11;425
28;Normandie;50;4;09;039;Beaucoudray;131;4;135
28;Normandie;50;1;16;040;Beauficel;126;6;132
28;Normandie;50;1;19;042;Beauvoir;428;5;433
28;Normandie;50;3;20;044;Belval;318;2;320
28;Normandie;50;2;17;045;Benoîtville;613;23;636
28;Normandie;50;4;18;046;Bérigny;429;6;435
28;Normandie;50;4;27;048;Beslon;558;9;567
28;Normandie;50;2;04;049;Besneville;663;19;682
28;Normandie;50;4;09;050;Beuvrigny;138;0;138
28;Normandie;50;2;05;052;Beuzeville-la-Bastille;144;2;146
28;Normandie;50;4;09;054;Biéville;189;4;193
28;Normandie;50;2;04;055;Biniville;114;2;116
28;Normandie;50;3;01;058;Blainville-sur-Mer;1637;46;1683
28;Normandie;50;2;05;059;Blosville;317;1;318
28;Normandie;50;4;27;060;La Bloutière;432;8;440
28;Normandie;50;1;27;062;Boisyvon;114;0;114
28;Normandie;50;2;04;064;La Bonneville;178;7;185
28;Normandie;50;4;27;069;Bourguenolles;344;12;356
28;Normandie;50;4;23;546;Bourgvallées ;3240;68;3308
28;Normandie;50;2;05;070;Boutteville;74;5;79
28;Normandie;50;3;10;072;Brainville;213;6;219
28;Normandie;50;1;15;074;Brécey;2139;146;2285
28;Normandie;50;1;03;076;Bréhal;3438;87;3525
28;Normandie;50;2;24;077;Bretteville;1055;45;1100
28;Normandie;50;3;11;078;Bretteville-sur-Ay;395;7;402
28;Normandie;50;2;04;079;Breuville;415;9;424
28;Normandie;50;1;03;081;Bréville-sur-Mer;774;29;803
28;Normandie;50;2;04;082;Bricquebec-en-Cotentin ;5869;151;6020
28;Normandie;50;2;17;083;Bricquebosq;594;7;601
28;Normandie;50;3;10;084;Bricqueville-la-Blouette;548;18;566
28;Normandie;50;1;03;085;Bricqueville-sur-Mer;1221;41;1262
28;Normandie;50;2;26;086;Brillevast;323;5;328
28;Normandie;50;2;25;087;Brix;2157;53;2210
28;Normandie;50;1;16;088;Brouains;136;2;138
28;Normandie;50;1;21;090;Buais-Les-Monts;617;10;627
28;Normandie;50;3;10;092;Cambernon;699;15;714
28;Normandie;50;3;20;093;Cametours;423;5;428
28;Normandie;50;3;10;094;Camprond;409;9;418
28;Normandie;50;4;23;095;Canisy;1785;57;1842
28;Normandie;50;2;26;096;Canteloup;208;8;216
28;Normandie;50;2;11;097;Canville-la-Rocque;125;2;127
28;Normandie;50;4;23;098;Carantilly;632;15;647
28;Normandie;50;4;  ;099;Carentan-les-Marais ;10084;182;10266
28;Normandie;50;2;26;101;Carneville;235;6;241
28;Normandie;50;1;02;102;Carolles;747;16;763
28;Normandie;50;2;04;105;Catteville;98;5;103
28;Normandie;50;4;18;106;Cavigny;263;2;265
28;Normandie;50;1;19;108;Céaux;415;12;427
28;Normandie;50;1;03;109;Cérences;1792;39;1831
28;Normandie;50;4;18;110;Cerisy-la-Forêt;1031;19;1050
28;Normandie;50;3;20;111;Cerisy-la-Salle;1023;16;1039
28;Normandie;50;1;15;112;La Chaise-Baudouin;470;7;477
28;Normandie;50;1;02;117;Champeaux;355;12;367
28;Normandie;50;4;27;118;Champrepus;333;6;339
28;Normandie;50;1;03;120;Chanteloup;358;4;362
28;Normandie;50;1;27;121;La Chapelle-Cécelin;246;4;250
28;Normandie;50;1;15;124;La Chapelle-Urée;162;3;165
28;Normandie;50;1;16;514;Chaulieu;303;1;304
28;Normandie;50;1;02;126;Chavoy;129;7;136
28;Normandie;50;2;  ;129;Cherbourg-en-Cotentin ;79144;2377;81521
28;Normandie;50;4;27;130;Chérencé-le-Héron;419;6;425
28;Normandie;50;2;26;135;Clitourps;217;3;220
28;Normandie;50;4;27;137;La Colombe;628;14;642
28;Normandie;50;2;04;138;Colomby;546;10;556
28;Normandie;50;4;09;139;Condé-sur-Vire ;4033;160;4193
28;Normandie;50;1;03;143;Coudeville-sur-Mer;858;34;892
28;Normandie;50;1;27;144;Coulouvray-Boisbenâtre;549;5;554
28;Normandie;50;3;10;145;Courcy;593;13;606
28;Normandie;50;1;19;146;Courtils;230;2;232
28;Normandie;50;3;10;147;Coutances;8454;1187;9641
28;Normandie;50;4;18;148;Couvains;525;4;529
28;Normandie;50;2;08;149;Couville;1165;17;1182
28;Normandie;50;2;26;150;Crasville;230;3;233
28;Normandie;50;3;11;151;Créances;2105;29;2134
28;Normandie;50;1;15;152;Les Cresnays;227;3;230
28;Normandie;50;1;19;155;Crollon;300;13;313
28;Normandie;50;2;04;156;Crosville-sur-Douve;64;0;64
28;Normandie;50;1;15;158;Cuves;281;9;290
28;Normandie;50;4;23;159;Dangy;677;15;692
28;Normandie;50;4;18;161;Le Dézert;593;9;602
28;Normandie;50;2;24;162;Digosville;1572;44;1616
28;Normandie;50;4;09;164;Domjean;1013;26;1039
28;Normandie;50;1;13;165;Donville-les-Bains;3138;74;3212
28;Normandie;50;3;11;166;Doville;324;15;339
28;Normandie;50;1;02;167;Dragey-Ronthon;814;21;835
28;Normandie;50;1;19;168;Ducey-Les Chéris;2792;61;2853
28;Normandie;50;2;25;169;Écausseville;103;1;104
28;Normandie;50;2;25;172;Émondeville;351;8;359
28;Normandie;50;1;03;174;Équilly;195;9;204
28;Normandie;50;2;25;175;Éroudeville;209;9;218
28;Normandie;50;2;04;176;L' Étang-Bertrand;343;14;357
28;Normandie;50;2;04;177;Étienville;369;6;375
28;Normandie;50;2;26;178;Fermanville;1274;24;1298
28;Normandie;50;3;01;181;Feugères;332;8;340
28;Normandie;50;3;11;182;La Feuillie;279;8;287
28;Normandie;50;2;17;183;Fierville-les-Mines;343;6;349
28;Normandie;50;2;17;184;Flamanville;1766;22;1788
28;Normandie;50;4;27;185;Fleury;1039;24;1063
28;Normandie;50;2;25;186;Flottemanville;207;8;215
28;Normandie;50;1;03;188;Folligny;1093;26;1119
28;Normandie;50;2;25;190;Fontenay-sur-Mer;175;3;178
28;Normandie;50;4;09;192;Fourneaux;138;0;138
28;Normandie;50;1;16;193;Le Fresne-Poret;217;3;220
28;Normandie;50;2;25;194;Fresville;368;8;376
28;Normandie;50;1;16;195;Gathemo;249;2;251
28;Normandie;50;2;26;196;Gatteville-le-Phare;488;19;507
28;Normandie;50;3;20;197;Gavray-sur-Sienne ;1963;25;1988
28;Normandie;50;3;01;198;Geffosses;455;10;465
28;Normandie;50;1;02;199;Genêts;441;4;445
28;Normandie;50;1;16;200;Ger;805;8;813
28;Normandie;50;1;15;205;La Godefroy;280;7;287
28;Normandie;50;2;04;207;Golleville;175;2;177
28;Normandie;50;3;01;208;Gonfreville;154;1;155
28;Normandie;50;2;26;209;Gonneville-Le Theil;1532;45;1577
28;Normandie;50;3;01;210;Gorges;344;8;352
28;Normandie;50;4;09;214;Gouvets;273;6;279
28;Normandie;50;3;  ;215;Gouville-sur-Mer ;3198;87;3285
28;Normandie;50;4;18;216;Graignes-Mesnil-Angot;808;89;897
28;Normandie;50;1;15;217;Le Grand-Celland;594;11;605
28;Normandie;50;1;21;391;Grandparigny ;2659;92;2751
28;Normandie;50;1;13;218;Granville;12567;676;13243
28;Normandie;50;3;10;219;Gratot;661;12;673
28;Normandie;50;3;20;221;Grimesnil;60;2;62
28;Normandie;50;1;03;115;Le Grippon;377;11;388
28;Normandie;50;2;17;222;Grosville;786;21;807
28;Normandie;50;4;27;225;Le Guislain;139;1;140
28;Normandie;50;2;14;041;Hague ;11387;336;11723
28;Normandie;50;2;25;227;Le Ham;309;5;314
28;Normandie;50;3;20;228;Hambye;1127;32;1159
28;Normandie;50;1;21;229;Hamelin;89;1;90
28;Normandie;50;2;08;230;Hardinvast;881;34;915
28;Normandie;50;3;01;232;Hauteville-la-Guichard;469;18;487
28;Normandie;50;3;20;231;Hauteville-sur-Mer;690;23;713
28;Normandie;50;2;04;233;Hautteville-Bocage;157;5;162
28;Normandie;50;3;11;236;La Haye;3989;118;4107
28;Normandie;50;4;27;234;La Haye-Bellefond;80;0;80
28;Normandie;50;2;17;235;La Haye-d'Ectot;266;5;271
28;Normandie;50;1;03;237;La Haye-Pesnel;1294;26;1320
28;Normandie;50;2;17;238;Héauville;463;6;469
28;Normandie;50;2;17;240;Helleville;536;8;544
28;Normandie;50;2;25;241;Hémevez;181;5;186
28;Normandie;50;3;10;243;Heugueville-sur-Sienne;526;17;543
28;Normandie;50;2;05;246;Hiesville;67;1;68
28;Normandie;50;1;03;247;Hocquigny;183;5;188
28;Normandie;50;2;25;251;Huberville;368;10;378
28;Normandie;50;1;03;252;Hudimesnil;905;16;921
28;Normandie;50;1;19;253;Huisnes-sur-Mer;178;7;185
28;Normandie;50;1;15;256;Isigny-le-Buat;3272;103;3375
28;Normandie;50;2;25;258;Joganville;112;3;115
28;Normandie;50;1;19;259;Juilley;640;26;666
28;Normandie;50;1;02;066;Jullouville;2338;78;2416
28;Normandie;50;1;15;260;Juvigny les Vallées;1695;41;1736
28;Normandie;50;4;09;261;Lamberville;172;2;174
28;Normandie;50;4;27;262;La Lande-d'Airou;524;6;530
28;Normandie;50;1;21;263;Lapenty;367;10;377
28;Normandie;50;3;11;265;Laulne;192;2;194
28;Normandie;50;3;20;266;Lengronne;420;10;430
28;Normandie;50;3;11;267;Lessay;2231;55;2286
28;Normandie;50;2;25;268;Lestre;249;5;254
28;Normandie;50;2;05;269;Liesville-sur-Douve;204;6;210
28;Normandie;50;2;25;270;Lieusaint;408;12;420
28;Normandie;50;1;15;271;Lingeard;84;1;85
28;Normandie;50;3;20;272;Lingreville;1015;19;1034
28;Normandie;50;1;21;274;Les Loges-Marchis;1002;156;1158
28;Normandie;50;1;15;275;Les Loges-sur-Brécey;128;7;135
28;Normandie;50;1;02;276;Lolif;574;19;593
28;Normandie;50;1;03;277;Longueville;596;15;611
28;Normandie;50;1;03;278;Le Loreur;277;6;283
28;Normandie;50;4;22;279;Le Lorey;607;14;621
28;Normandie;50;1;03;281;La Lucerne-d'Outremer;776;19;795
28;Normandie;50;1;03;282;Le Luot;282;9;291
28;Normandie;50;4;23;283;La Luzerne;74;1;75
28;Normandie;50;2;04;285;Magneville;322;4;326
28;Normandie;50;1;02;288;Marcey-les-Grèves;1291;29;1320
28;Normandie;50;3;01;289;Marchésieux;719;12;731
28;Normandie;50;1;19;290;Marcilly;325;7;332
28;Normandie;50;4;27;291;Margueray;126;4;130
28;Normandie;50;4;22;292;Marigny-Le-Lozon;2656;58;2714
28;Normandie;50;2;08;294;Martinvast;1286;38;1324
28;Normandie;50;4;27;295;Maupertuis;140;2;142
28;Normandie;50;2;26;296;Maupertus-sur-Mer;219;9;228
28;Normandie;50;4;18;297;La Meauffe;1026;30;1056
28;Normandie;50;4;05;298;Méautis;647;13;660
28;Normandie;50;2;17;299;Le Mesnil;220;7;227
28;Normandie;50;1;15;300;Le Mesnil-Adelée;166;7;173
28;Normandie;50;4;22;302;Le Mesnil-Amey;281;7;288
28;Normandie;50;2;24;305;Le Mesnil-au-Val;729;18;747
28;Normandie;50;1;03;304;Le Mesnil-Aubert;192;7;199
28;Normandie;50;4;22;310;Le Mesnil-Eury;173;3;176
28;Normandie;50;3;20;311;Le Mesnil-Garnier;226;8;234
28;Normandie;50;1;15;312;Le Mesnil-Gilbert;135;4;139
28;Normandie;50;1;19;317;Le Mesnil-Ozenne;270;3;273
28;Normandie;50;4;18;321;Le Mesnil-Rouxelin;504;21;525
28;Normandie;50;4;18;324;Le Mesnil-Véneron;118;2;120
28;Normandie;50;3;20;326;Le Mesnil-Villeman;235;1;236
28;Normandie;50;1;21;315;Le Mesnillard;249;8;257
28;Normandie;50;1;03;327;La Meurdraquière;179;6;185
28;Normandie;50;3;11;328;Millières;788;14;802
28;Normandie;50;2;17;332;Les Moitiers-d'Allonne;704;15;719
28;Normandie;50;1;19;353;Le Mont-Saint-Michel;30;0;30
28;Normandie;50;4;27;334;Montabot;277;3;280
28;Normandie;50;2;25;335;Montaigu-la-Brisette;505;9;514
28;Normandie;50;3;20;336;Montaigu-les-Bois;227;3;230
28;Normandie;50;4;27;338;Montbray;302;4;306
28;Normandie;50;3;01;340;Montcuit;187;4;191
28;Normandie;50;2;25;341;Montebourg;2100;104;2204
28;Normandie;50;2;26;342;Montfarville;805;27;832
28;Normandie;50;3;10;345;Monthuchon;685;20;705
28;Normandie;50;1;21;347;Montjoie-Saint-Martin;237;4;241
28;Normandie;50;3;20;349;Montmartin-sur-Mer;1356;34;1390
28;Normandie;50;3;20;350;Montpinchon;524;9;533
28;Normandie;50;4;09;351;Montrabot;88;2;90
28;Normandie;50;4;22;352;Montreuil-sur-Lozon;332;7;339
28;Normandie;50;3;11;273;Montsenelle;1410;20;1430
28;Normandie;50;4;18;356;Moon-sur-Elle;823;21;844
28;Normandie;50;4;27;357;Morigny;78;1;79
28;Normandie;50;1;16;359;Mortain-Bocage ;2940;267;3207
28;Normandie;50;2;04;360;Morville;274;12;286
28;Normandie;50;1;03;361;La Mouche;241;5;246
28;Normandie;50;1;21;362;Moulines;288;5;293
28;Normandie;50;4;09;363;Moyon Villages;1453;35;1488
28;Normandie;50;3;01;364;Muneville-le-Bingard;699;7;706
28;Normandie;50;1;03;365;Muneville-sur-Mer;481;10;491
28;Normandie;50;3;01;368;Nay;69;2;71
28;Normandie;50;2;04;369;Négreville;815;25;840
28;Normandie;50;2;04;370;Néhou;620;4;624
28;Normandie;50;1;16;371;Le Neufbourg;410;12;422
28;Normandie;50;3;11;372;Neufmesnil;187;3;190
28;Normandie;50;2;05;373;Neuville-au-Plain;90;4;94
28;Normandie;50;2;04;374;Neuville-en-Beaumont;31;1;32
28;Normandie;50;3;10;376;Nicorps;399;14;413
28;Normandie;50;3;20;378;Notre-Dame-de-Cenilly;634;9;643
28;Normandie;50;1;15;379;Notre-Dame-de-Livoye;153;3;156
28;Normandie;50;2;08;382;Nouainville;628;19;647
28;Normandie;50;2;26;384;Octeville-l'Avenel;219;3;222
28;Normandie;50;2;04;387;Orglandes;365;6;371
28;Normandie;50;3;10;388;Orval sur Sienne ;1155;38;1193
28;Normandie;50;3;20;389;Ouville;448;12;460
28;Normandie;50;2;25;390;Ozeville;155;3;158
28;Normandie;50;1;88;535;Le Parc;916;26;942
28;Normandie;50;4;27;393;Percy-en-Normandie;2588;105;2693
28;Normandie;50;3;01;394;Périers;2263;31;2294
28;Normandie;50;2;26;395;La Pernelle;265;4;269
28;Normandie;50;1;16;397;Perriers-en-Beauficel;213;6;219
28;Normandie;50;4;09;398;Le Perron;203;2;205
28;Normandie;50;1;15;399;Le Petit-Celland;178;4;182
28;Normandie;50;2;  ;400;Picauville ;3270;38;3308
28;Normandie;50;2;17;401;Pierreville;741;13;754
28;Normandie;50;2;17;402;Les Pieux;3222;88;3310
28;Normandie;50;3;11;403;Pirou;1432;37;1469
28;Normandie;50;3;11;405;Le Plessis-Lastelle;237;8;245
28;Normandie;50;1;19;407;Poilley;916;36;952
28;Normandie;50;4;18;409;Pont-Hébert ;1932;210;2142
28;Normandie;50;1;19;408;Pontaubault;562;13;575
28;Normandie;50;1;19;410;Pontorson;4330;78;4408
28;Normandie;50;1;02;411;Ponts;668;15;683
28;Normandie;50;2;  ;412;Port-Bail-sur-Mer ;2567;68;2635
28;Normandie;50;1;19;413;Précey;567;6;573
28;Normandie;50;2;26;417;Quettehou ;1789;30;1819
28;Normandie;50;3;20;419;Quettreville-sur-Sienne ;3187;65;3252
28;Normandie;50;4;23;420;Quibou;889;24;913
28;Normandie;50;2;25;421;Quinéville;270;6;276
28;Normandie;50;3;01;422;Raids;193;0;193
28;Normandie;50;4;18;423;Rampan;203;6;209
28;Normandie;50;2;04;425;Rauville-la-Bigot;1134;28;1162
28;Normandie;50;2;04;426;Rauville-la-Place;373;6;379
28;Normandie;50;1;15;428;Reffuveille;508;4;512
28;Normandie;50;3;10;429;Regnéville-sur-Mer;738;32;770
28;Normandie;50;2;04;430;Reigneville-Bocage;38;3;41
28;Normandie;50;4;85;431;Remilly Les Marais;1086;12;1098
28;Normandie;50;2;26;433;Réville;1019;22;1041
28;Normandie;50;2;04;435;Rocheville;592;15;607
28;Normandie;50;1;16;436;Romagny Fontenay;1298;44;1342
28;Normandie;50;3;20;437;Roncey;797;10;807
28;Normandie;50;2;17;442;Le Rozel;251;6;257
28;Normandie;50;1;19;443;Sacey;516;10;526
28;Normandie;50;4;09;444;Saint-Amand-Villages;2502;57;2559
28;Normandie;50;4;05;445;Saint-André-de-Bohon;346;12;358
28;Normandie;50;4;18;446;Saint-André-de-l'Épine;547;13;560
28;Normandie;50;1;21;448;Saint-Aubin-de-Terregatte;672;18;690
28;Normandie;50;1;03;447;Saint-Aubin-des-Préaux;444;13;457
28;Normandie;50;1;16;450;Saint-Barthélemy;334;7;341
28;Normandie;50;1;15;451;Saint-Brice;129;2;131
28;Normandie;50;1;21;452;Saint-Brice-de-Landelles;676;22;698
28;Normandie;50;2;17;454;Saint-Christophe-du-Foc;424;9;433
28;Normandie;50;4;18;455;Saint-Clair-sur-l'Elle;957;19;976
28;Normandie;50;1;16;456;Saint-Clément-Rancoudray;549;9;558
28;Normandie;50;2;25;461;Saint-Cyr;189;8;197
28;Normandie;50;1;16;462;Saint-Cyr-du-Bailleul;384;9;393
28;Normandie;50;3;20;463;Saint-Denis-le-Gast;526;10;536
28;Normandie;50;3;20;464;Saint-Denis-le-Vêtu;626;5;631
28;Normandie;50;2;25;467;Saint-Floxel;493;13;506
28;Normandie;50;4;18;468;Saint-Fromond;769;15;784
28;Normandie;50;4;18;473;Saint-Georges-d'Elle;396;7;403
28;Normandie;50;2;17;471;Saint-Georges-de-la-Rivière;284;11;295
28;Normandie;50;1;15;472;Saint-Georges-de-Livoye;201;10;211
28;Normandie;50;1;16;474;Saint-Georges-de-Rouelley;546;11;557
28;Normandie;50;4;18;475;Saint-Georges-Montcocq;924;44;968
28;Normandie;50;4;18;476;Saint-Germain-d'Elle;224;1;225
28;Normandie;50;2;25;478;Saint-Germain-de-Tournebut;434;7;441
28;Normandie;50;2;05;479;Saint-Germain-de-Varreville;112;4;116
28;Normandie;50;2;17;480;Saint-Germain-le-Gaillard;749;22;771
28;Normandie;50;3;11;481;Saint-Germain-sur-Ay;905;18;923
28;Normandie;50;3;01;482;Saint-Germain-sur-Sèves;164;3;167
28;Normandie;50;4;22;483;Saint-Gilles;933;28;961
28;Normandie;50;1;21;484;Saint-Hilaire-du-Harcouët;5932;357;6289
28;Normandie;50;2;04;486;Saint-Jacques-de-Néhou;614;9;623
28;Normandie;50;1;21;487;Saint-James;4902;109;5011
28;Normandie;50;4;89;492;Saint-Jean-d'Elle;2479;55;2534
28;Normandie;50;4;18;488;Saint-Jean-de-Daye;635;5;640
28;Normandie;50;1;02;489;Saint-Jean-de-la-Haize;523;14;537
28;Normandie;50;2;17;490;Saint-Jean-de-la-Rivière;352;9;361
28;Normandie;50;4;18;491;Saint-Jean-de-Savigny;444;6;450
28;Normandie;50;1;03;493;Saint-Jean-des-Champs;1430;37;1467
28;Normandie;50;1;15;495;Saint-Jean-du-Corail-des-Bois;73;5;78
28;Normandie;50;1;02;496;Saint-Jean-le-Thomas;378;8;386
28;Normandie;50;2;25;498;Saint-Joseph;795;26;821
28;Normandie;50;1;15;499;Saint-Laurent-de-Cuves;483;7;490
28;Normandie;50;1;21;500;Saint-Laurent-de-Terregatte;647;12;659
28;Normandie;50;4;99;502;Saint-Lô;19024;914;19938
28;Normandie;50;4;09;504;Saint-Louet-sur-Vire;206;1;207
28;Normandie;50;1;15;505;Saint-Loup;694;36;730
28;Normandie;50;3;01;506;Saint-Malo-de-la-Lande;477;4;481
28;Normandie;50;2;25;507;Saint-Marcouf;342;7;349
28;Normandie;50;3;01;510;Saint-Martin-d'Aubigny;595;4;599
28;Normandie;50;2;25;511;Saint-Martin-d'Audouville;130;4;134
28;Normandie;50;4;23;512;Saint-Martin-de-Bonfossé;528;9;537
28;Normandie;50;3;20;513;Saint-Martin-de-Cenilly;179;3;182
28;Normandie;50;2;05;517;Saint-Martin-de-Varreville;174;5;179
28;Normandie;50;1;27;518;Saint-Martin-le-Bouillant;324;4;328
28;Normandie;50;2;08;519;Saint-Martin-le-Gréard;541;8;549
28;Normandie;50;1;27;521;Saint-Maur-des-Bois;153;4;157
28;Normandie;50;2;17;522;Saint-Maurice-en-Cotentin;256;7;263
28;Normandie;50;1;15;525;Saint-Michel-de-Montjoie;321;1;322
28;Normandie;50;3;11;528;Saint-Nicolas-de-Pierrepont;307;12;319
28;Normandie;50;1;15;529;Saint-Nicolas-des-Bois;84;2;86
28;Normandie;50;1;19;531;Saint-Ovin;768;35;803
28;Normandie;50;1;13;532;Saint-Pair-sur-Mer;4053;148;4201
28;Normandie;50;3;11;533;Saint-Patrice-de-Claids;179;3;182
28;Normandie;50;2;17;536;Saint-Pierre-d'Arthéglise;149;0;149
28;Normandie;50;3;10;537;Saint-Pierre-de-Coutances;410;19;429
28;Normandie;50;4;18;538;Saint-Pierre-de-Semilly;449;8;457
28;Normandie;50;2;26;539;Saint-Pierre-Église;1807;25;1832
28;Normandie;50;1;02;540;Saint-Pierre-Langers;611;18;629
28;Normandie;50;1;03;541;Saint-Planchers;1374;46;1420
28;Normandie;50;1;27;542;Saint-Pois;501;7;508
28;Normandie;50;1;19;543;Saint-Quentin-sur-le-Homme;1320;31;1351
28;Normandie;50;3;11;548;Saint-Sauveur-de-Pierrepont;123;3;126
28;Normandie;50;1;03;549;Saint-Sauveur-la-Pommeraye;393;6;399
28;Normandie;50;2;04;551;Saint-Sauveur-le-Vicomte;2099;40;2139
28;Normandie;50;3;  ;550;Saint-Sauveur-Villages ;3593;147;3740
28;Normandie;50;3;01;552;Saint-Sébastien-de-Raids;329;6;335
28;Normandie;50;1;21;553;Saint-Senier-de-Beuvron;356;2;358
28;Normandie;50;1;15;554;Saint-Senier-sous-Avranches;1433;88;1521
28;Normandie;50;2;26;562;Saint-Vaast-la-Hougue;1729;30;1759
28;Normandie;50;4;09;563;Saint-Vigor-des-Monts;282;8;290
28;Normandie;50;4;27;453;Sainte-Cécile;800;18;818
28;Normandie;50;2;04;457;Sainte-Colombe;203;5;208
28;Normandie;50;2;26;469;Sainte-Geneviève;315;7;322
28;Normandie;50;2;05;509;Sainte-Marie-du-Mont;713;18;731
28;Normandie;50;2;05;523;Sainte-Mère-Église ;3074;50;3124
28;Normandie;50;4;23;556;Sainte-Suzanne-sur-Vire;691;10;701
28;Normandie;50;1;87;565;Sartilly-Baie-Bocage;2813;57;2870
28;Normandie;50;2;25;567;Saussemesnil;880;22;902
28;Normandie;50;3;10;568;Saussey;462;15;477
28;Normandie;50;3;20;569;Savigny;448;8;456
28;Normandie;50;1;21;570;Savigny-le-Vieux;438;7;445
28;Normandie;50;2;05;571;Sébeville;34;1;35
28;Normandie;50;2;17;572;Sénoville;194;8;202
28;Normandie;50;1;19;574;Servon;275;11;286
28;Normandie;50;2;08;575;Sideville;767;13;780
28;Normandie;50;2;17;576;Siouville-Hague;992;32;1024
28;Normandie;50;2;25;578;Sortosville;82;1;83
28;Normandie;50;2;17;577;Sortosville-en-Beaumont;313;8;321
28;Normandie;50;2;04;579;Sottevast;1418;29;1447
28;Normandie;50;2;17;580;Sotteville;465;9;474
28;Normandie;50;1;16;582;Sourdeval ;3165;64;3229
28;Normandie;50;1;03;584;Subligny;400;6;406
28;Normandie;50;2;17;585;Surtainville;1166;28;1194
28;Normandie;50;2;04;587;Taillepied;18;1;19
28;Normandie;50;2;25;588;Tamerville;669;22;691
28;Normandie;50;1;19;589;Tanis;290;12;302
28;Normandie;50;1;27;590;Le Tanu;405;5;410
28;Normandie;50;1;16;591;Le Teilleul;1681;27;1708
28;Normandie;50;4;05;564;Terre-et-Marais;1299;28;1327
28;Normandie;50;4;09;592;Tessy-Bocage;2317;45;2362
28;Normandie;50;2;26;593;Teurthéville-Bocage;590;8;598
28;Normandie;50;2;08;594;Teurthéville-Hague;1050;23;1073
28;Normandie;50;4;22;239;Thèreval;1792;45;1837
28;Normandie;50;2;26;596;Théville;333;12;345
28;Normandie;50;1;15;597;Tirepied-sur-Sée ;952;23;975
28;Normandie;50;2;26;598;Tocqueville;274;3;277
28;Normandie;50;2;08;599;Tollevast;1533;43;1576
28;Normandie;50;4;09;601;Torigny-les-Villes;4379;55;4434
28;Normandie;50;3;10;603;Tourville-sur-Sienne;781;24;805
28;Normandie;50;2;17;604;Tréauville;742;13;755
28;Normandie;50;4;18;606;Tribehou;527;5;532
28;Normandie;50;4;27;607;La Trinité;392;6;398
28;Normandie;50;2;05;609;Turqueville;132;3;135
28;Normandie;50;2;25;610;Urville;209;6;215
28;Normandie;50;1;02;612;Vains;733;76;809
28;Normandie;50;1;19;616;Le Val-Saint-Père;2007;72;2079
28;Normandie;50;2;26;613;Valcanville;409;9;418
28;Normandie;50;2;25;615;Valognes;6827;268;7095
28;Normandie;50;3;11;617;Varenguebec;326;2;328
28;Normandie;50;2;26;618;Varouville;255;12;267
28;Normandie;50;2;26;619;Le Vast;328;10;338
28;Normandie;50;2;25;621;Vaudreville;73;0;73
28;Normandie;50;3;10;624;La Vendelée;472;24;496
28;Normandie;50;3;20;626;Ver;376;8;384
28;Normandie;50;1;15;628;Vernix;155;4;159
28;Normandie;50;3;11;629;Vesly;731;4;735
28;Normandie;50;2;26;633;Le Vicel;120;3;123
28;Normandie;50;2;26;142;Vicq-sur-Mer;1038;13;1051
28;Normandie;50;2;26;634;Videcosville;83;1;84
28;Normandie;50;4;27;637;Villebaudon;313;3;316
28;Normandie;50;4;27;639;Villedieu-les-Poêles-Rouffigny;3865;75;3940
28;Normandie;50;4;18;641;Villiers-Fossard;650;15;665
28;Normandie;50;2;08;643;Virandeville;788;24;812
28;Normandie;50;1;13;647;Yquelon;1113;42;1155
28;Normandie;50;2;25;648;Yvetot-Bocage;1163;31;1194
44;Grand Est;51;4;23;001;Ablancourt;164;1;165
44;Grand Est;51;1;04;003;Aigny;275;5;280
44;Grand Est;51;2;22;004;Allemanche-Launay-et-Soyer;115;4;119
44;Grand Est;51;2;21;005;Allemant;170;3;173
44;Grand Est;51;4;20;006;Alliancelles;145;4;149
44;Grand Est;51;2;07;007;Ambonnay;963;25;988
44;Grand Est;51;4;20;008;Ambrières;222;6;228
44;Grand Est;51;2;22;009;Anglure;857;11;868
44;Grand Est;51;2;22;010;Angluzelles-et-Courcelles;140;4;144
44;Grand Est;51;3;06;012;Anthenay;71;0;71
44;Grand Est;51;3;06;013;Aougny;99;5;104
44;Grand Est;51;3;09;014;Arcis-le-Ponsart;306;6;312
44;Grand Est;51;1;01;015;Argers;115;1;116
44;Grand Est;51;4;20;016;Arrigny;238;4;242
44;Grand Est;51;4;23;017;Arzillières-Neuville;326;6;332
44;Grand Est;51;2;22;018;Athis;892;20;912
44;Grand Est;51;3;10;019;Aubérive;245;8;253
44;Grand Est;51;3;09;020;Aubilly;53;3;56
44;Grand Est;51;4;23;022;Aulnay-l'Aître;185;5;190
44;Grand Est;51;1;04;023;Aulnay-sur-Marne;262;6;268
44;Grand Est;51;3;02;025;Auménancourt;1065;10;1075
44;Grand Est;51;1;01;027;Auve;302;21;323
44;Grand Est;51;2;07;028;Avenay-Val-d'Or;1030;12;1042
44;Grand Est;51;2;08;029;Avize;1752;160;1912
44;Grand Est;51;2;07;030;Aÿ-Champagne;5451;88;5539
44;Grand Est;51;1;10;031;Baconnes;269;10;279
44;Grand Est;51;2;22;032;Bagneux;437;5;442
44;Grand Est;51;2;06;033;Le Baizil;253;3;256
44;Grand Est;51;2;06;034;Bannay;20;0;20
44;Grand Est;51;2;22;035;Bannes;260;3;263
44;Grand Est;51;2;21;036;Barbonne-Fayel;511;7;518
44;Grand Est;51;3;09;037;Baslieux-lès-Fismes;332;2;334
44;Grand Est;51;2;06;038;Baslieux-sous-Châtillon;185;6;191
44;Grand Est;51;4;20;039;Bassu;99;5;104
44;Grand Est;51;4;20;040;Bassuet;254;3;257
44;Grand Est;51;2;22;041;Baudement;107;4;111
44;Grand Est;51;2;06;042;Baye;398;8;406
44;Grand Est;51;3;02;043;Bazancourt;2297;27;2324
44;Grand Est;51;3;10;044;Beaumont-sur-Vesle;811;17;828
44;Grand Est;51;2;06;045;Beaunay;103;0;103
44;Grand Est;51;3;02;046;Beine-Nauroy;1003;15;1018
44;Grand Est;51;1;01;047;Belval-en-Argonne;46;3;49
44;Grand Est;51;2;06;048;Belval-sous-Châtillon;154;0;154
44;Grand Est;51;2;22;049;Bergères-lès-Vertus;596;4;600
44;Grand Est;51;2;21;050;Bergères-sous-Montmirail;129;2;131
44;Grand Est;51;3;02;051;Berméricourt;213;2;215
44;Grand Est;51;3;02;052;Berru;594;4;598
44;Grand Est;51;1;01;053;Berzieux;75;7;82
44;Grand Est;51;3;10;054;Bétheniville;1281;14;1295
44;Grand Est;51;3;15;055;Bétheny;7039;108;7147
44;Grand Est;51;2;21;056;Bethon;268;3;271
44;Grand Est;51;4;20;057;Bettancourt-la-Longue;77;2;79
44;Grand Est;51;3;14;058;Bezannes;2550;64;2614
44;Grand Est;51;4;23;059;Bignicourt-sur-Marne;352;6;358
44;Grand Est;51;4;20;060;Bignicourt-sur-Saulx;181;3;184
44;Grand Est;51;3;10;061;Billy-le-Grand;120;2;122
44;Grand Est;51;1;01;062;Binarville;95;3;98
44;Grand Est;51;2;06;063;Binson-et-Orquigny;167;2;169
44;Grand Est;51;4;23;065;Blacy;645;13;658
44;Grand Est;51;4;23;066;Blaise-sous-Arzillières;336;3;339
44;Grand Est;51;2;22;612;Blancs-Coteaux ;3323;176;3499
44;Grand Est;51;4;20;068;Blesme;208;2;210
44;Grand Est;51;3;06;069;Bligny;120;1;121
44;Grand Est;51;2;21;070;Boissy-le-Repos;223;0;223
44;Grand Est;51;2;21;071;Bouchy-Saint-Genest;193;7;200
44;Grand Est;51;3;09;072;Bouilly;210;3;213
44;Grand Est;51;3;09;073;Bouleuse;217;3;220
44;Grand Est;51;3;02;074;Boult-sur-Suippe;1710;26;1736
44;Grand Est;51;3;02;075;Bourgogne-Fresne;1409;33;1442
44;Grand Est;51;2;06;076;Boursault;446;9;455
44;Grand Est;51;3;09;077;Bouvancourt;187;4;191
44;Grand Est;51;1;10;078;Bouy;571;14;585
44;Grand Est;51;2;07;079;Bouzy;894;24;918
44;Grand Est;51;4;20;080;Brandonvillers;187;1;188
44;Grand Est;51;3;09;081;Branscourt;312;5;317
44;Grand Est;51;1;01;083;Braux-Saint-Remy;83;3;86
44;Grand Est;51;1;01;082;Braux-Sainte-Cohière;94;6;100
44;Grand Est;51;4;23;084;Bréban;79;1;80
44;Grand Est;51;2;06;085;Le Breuil;382;3;385
44;Grand Est;51;3;09;086;Breuil-sur-Vesle;338;11;349
44;Grand Est;51;1;05;087;Breuvery-sur-Coole;217;8;225
44;Grand Est;51;3;02;088;Brimont;442;7;449
44;Grand Est;51;3;06;089;Brouillet;75;4;79
44;Grand Est;51;2;22;090;Broussy-le-Grand;311;12;323
44;Grand Est;51;2;21;091;Broussy-le-Petit;132;7;139
44;Grand Est;51;2;21;092;Broyes;359;4;363
44;Grand Est;51;2;08;093;Brugny-Vaudancourt;446;14;460
44;Grand Est;51;4;20;094;Brusson;182;7;189
44;Grand Est;51;4;20;095;Le Buisson;93;3;96
44;Grand Est;51;1;01;097;Bussy-le-Château;173;4;177
44;Grand Est;51;4;20;098;Bussy-le-Repos;135;4;139
44;Grand Est;51;1;05;099;Bussy-Lettrée;331;9;340
44;Grand Est;51;2;06;100;La Caure;104;2;106
44;Grand Est;51;3;02;101;Caurel;672;8;680
44;Grand Est;51;3;02;102;Cauroy-lès-Hermonville;479;10;489
44;Grand Est;51;2;22;103;La Celle-sous-Chantemerle;142;1;143
44;Grand Est;51;1;01;104;Cernay-en-Dormois;144;4;148
44;Grand Est;51;3;18;105;Cernay-lès-Reims;1431;25;1456
44;Grand Est;51;1;05;106;Cernon;126;5;131
44;Grand Est;51;2;22;107;Chaintrix-Bierges;334;3;337
44;Grand Est;51;1;97;108;Châlons-en-Champagne;44246;1244;45490
44;Grand Est;51;3;09;109;Châlons-sur-Vesle;188;2;190
44;Grand Est;51;2;22;110;Chaltrait;57;1;58
44;Grand Est;51;3;06;111;Chambrecy;147;8;155
44;Grand Est;51;3;09;112;Chamery;426;6;432
44;Grand Est;51;2;06;113;Champaubert;121;2;123
44;Grand Est;51;3;14;115;Champfleury;561;3;564
44;Grand Est;51;2;21;116;Champguyon;277;4;281
44;Grand Est;51;1;04;117;Champigneul-Champagne;317;8;325
44;Grand Est;51;3;14;118;Champigny;1550;25;1575
44;Grand Est;51;2;07;119;Champillon;509;7;516
44;Grand Est;51;2;06;120;Champlat-et-Boujacourt;160;0;160
44;Grand Est;51;2;06;121;Champvoisy;250;3;253
44;Grand Est;51;4;20;122;Changy;117;5;122
44;Grand Est;51;2;21;124;Chantemerle;46;3;49
44;Grand Est;51;4;23;125;Chapelaine;50;1;51
44;Grand Est;51;1;01;126;La Chapelle-Felcourt;49;3;52
44;Grand Est;51;2;22;127;La Chapelle-Lasson;87;2;89
44;Grand Est;51;2;06;128;La Chapelle-sous-Orbais;54;2;56
44;Grand Est;51;2;21;129;Charleville;244;9;253
44;Grand Est;51;4;20;130;Charmont;231;5;236
44;Grand Est;51;1;01;132;Les Charmontois;118;0;118
44;Grand Est;51;1;01;133;Le Châtelier;62;0;62
44;Grand Est;51;4;23;134;Châtelraould-Saint-Louvent;239;8;247
44;Grand Est;51;4;20;135;Châtillon-sur-Broué;77;0;77
44;Grand Est;51;2;06;136;Châtillon-sur-Marne;645;78;723
44;Grand Est;51;2;21;137;Châtillon-sur-Morin;220;3;223
44;Grand Est;51;1;01;138;Châtrices;34;2;36
44;Grand Est;51;1;01;139;Chaudefontaine;318;13;331
44;Grand Est;51;3;06;140;Chaumuzy;387;2;389
44;Grand Est;51;4;23;141;La Chaussée-sur-Marne;784;15;799
44;Grand Est;51;2;08;142;Chavot-Courcourt;338;11;349
44;Grand Est;51;1;01;143;Le Chemin;53;0;53
44;Grand Est;51;4;20;144;Cheminon;606;10;616
44;Grand Est;51;3;09;145;Chenay;227;6;233
44;Grand Est;51;1;05;146;Cheniers;105;4;109
44;Grand Est;51;1;01;147;La Cheppe;332;13;345
44;Grand Est;51;1;05;148;Cheppes-la-Prairie;167;2;169
44;Grand Est;51;1;05;149;Chepy;430;13;443
44;Grand Est;51;1;04;150;Cherville;82;1;83
44;Grand Est;51;2;21;151;Chichey;174;3;177
44;Grand Est;51;3;10;152;Chigny-les-Roses;550;13;563
44;Grand Est;51;2;08;153;Chouilly;1018;31;1049
44;Grand Est;51;2;22;154;Clamanges;210;3;213
44;Grand Est;51;2;22;155;Clesles;617;10;627
44;Grand Est;51;4;20;156;Cloyes-sur-Marne;127;1;128
44;Grand Est;51;2;06;157;Coizard-Joches;73;1;74
44;Grand Est;51;1;03;160;Compertrix;1433;48;1481
44;Grand Est;51;1;04;161;Condé-sur-Marne;786;14;800
44;Grand Est;51;2;22;162;Conflans-sur-Seine;631;7;638
44;Grand Est;51;2;06;163;Congy;267;2;269
44;Grand Est;51;2;22;164;Connantray-Vaurefroy;150;3;153
44;Grand Est;51;2;22;165;Connantre;1060;31;1091
44;Grand Est;51;1;01;166;Contault;67;2;69
44;Grand Est;51;4;23;167;Coole;147;3;150
44;Grand Est;51;1;03;168;Coolus;222;8;230
44;Grand Est;51;4;23;169;Corbeil;93;5;98
44;Grand Est;51;2;21;170;Corfélix;111;2;113
44;Grand Est;51;3;02;171;Cormicy;1485;26;1511
44;Grand Est;51;3;18;172;Cormontreuil;6488;92;6580
44;Grand Est;51;2;06;173;Cormoyeux;121;1;122
44;Grand Est;51;2;06;174;Corribert;61;0;61
44;Grand Est;51;2;21;175;Corrobert;206;7;213
44;Grand Est;51;2;22;176;Corroy;157;7;164
44;Grand Est;51;3;09;177;Coulommes-la-Montagne;206;4;210
44;Grand Est;51;1;05;178;Coupetz;80;2;82
44;Grand Est;51;1;05;179;Coupéville;162;0;162
44;Grand Est;51;3;09;181;Courcelles-Sapicourt;386;11;397
44;Grand Est;51;2;22;182;Courcemain;99;3;102
44;Grand Est;51;3;02;183;Courcy;1132;18;1150
44;Grand Est;51;4;23;184;Courdemanges;393;13;406
44;Grand Est;51;2;21;185;Courgivaux;314;1;315
44;Grand Est;51;2;06;186;Courjeonnet;47;0;47
44;Grand Est;51;3;09;187;Courlandon;283;4;287
44;Grand Est;51;3;09;188;Courmas;212;8;220
44;Grand Est;51;3;09;190;Courtagnon;66;0;66
44;Grand Est;51;1;01;191;Courtémont;61;1;62
44;Grand Est;51;2;06;192;Courthiézy;354;5;359
44;Grand Est;51;1;01;193;Courtisols;2404;92;2496
44;Grand Est;51;3;09;194;Courville;454;6;460
44;Grand Est;51;4;23;195;Couvrot;829;23;852
44;Grand Est;51;2;08;196;Cramant;887;13;900
44;Grand Est;51;1;01;197;La Croix-en-Champagne;79;2;81
44;Grand Est;51;3;09;198;Crugny;657;6;663
44;Grand Est;51;2;06;199;Cuchery;406;6;412
44;Grand Est;51;2;08;200;Cuis;378;12;390
44;Grand Est;51;3;06;201;Cuisles;128;4;132
44;Grand Est;51;2;07;202;Cumières;751;12;763
44;Grand Est;51;1;01;203;Cuperly;223;2;225
44;Grand Est;51;2;06;204;Damery;1407;26;1433
44;Grand Est;51;1;10;205;Dampierre-au-Temple;272;4;276
44;Grand Est;51;1;01;206;Dampierre-le-Château;109;2;111
44;Grand Est;51;1;05;208;Dampierre-sur-Moivre;112;2;114
44;Grand Est;51;2;07;210;Dizy;1505;34;1539
44;Grand Est;51;1;01;211;Dommartin-Dampierre;67;0;67
44;Grand Est;51;1;05;212;Dommartin-Lettrée;154;1;155
44;Grand Est;51;1;01;213;Dommartin-sous-Hans;57;2;59
44;Grand Est;51;1;01;214;Dommartin-Varimont;138;8;146
44;Grand Est;51;4;20;215;Dompremy;136;3;139
44;Grand Est;51;3;10;216;Dontrien;268;4;272
44;Grand Est;51;2;06;217;Dormans;2919;43;2962
44;Grand Est;51;4;20;219;Drosnay;219;1;220
44;Grand Est;51;4;23;220;Drouilly;140;1;141
44;Grand Est;51;1;01;222;Éclaires;96;3;99
44;Grand Est;51;4;20;223;Écollemont;55;1;56
44;Grand Est;51;4;20;224;Écriennes;172;2;174
44;Grand Est;51;3;09;225;Écueil;304;2;306
44;Grand Est;51;2;22;226;Écury-le-Repos;56;1;57
44;Grand Est;51;1;05;227;Écury-sur-Coole;494;22;516
44;Grand Est;51;1;01;228;Élise-Daucourt;90;0;90
44;Grand Est;51;1;01;229;Épense;122;6;128
44;Grand Est;51;2;98;230;Épernay;22330;480;22810
44;Grand Est;51;1;05;231;L' Épine;650;15;665
44;Grand Est;51;3;10;232;Époye;422;6;428
44;Grand Est;51;2;21;233;Escardes;70;3;73
44;Grand Est;51;2;22;234;Esclavolles-Lurey;604;10;614
44;Grand Est;51;2;21;236;Les Essarts-le-Vicomte;139;3;142
44;Grand Est;51;2;21;235;Les Essarts-lès-Sézanne;251;10;261
44;Grand Est;51;2;21;237;Esternay;1832;30;1862
44;Grand Est;51;2;06;238;Étoges;478;8;486
44;Grand Est;51;2;22;239;Étréchy;107;1;108
44;Grand Est;51;4;20;240;Étrepy;133;3;136
44;Grand Est;51;2;22;241;Euvy;82;1;83
44;Grand Est;51;1;03;242;Fagnières;4838;109;4947
44;Grand Est;51;2;22;243;Faux-Fresnay;314;8;322
44;Grand Est;51;1;05;244;Faux-Vésigneul;242;8;250
44;Grand Est;51;3;09;245;Faverolles-et-Coëmy;570;10;580
44;Grand Est;51;4;20;246;Favresse;224;6;230
44;Grand Est;51;2;22;248;Fère-Champenoise;2152;41;2193
44;Grand Est;51;2;06;247;Fèrebrianges;144;3;147
44;Grand Est;51;2;06;249;Festigny;394;5;399
44;Grand Est;51;3;09;250;Fismes;5560;51;5611
44;Grand Est;51;2;08;251;Flavigny;168;5;173
44;Grand Est;51;2;06;252;Fleury-la-Rivière;520;8;528
44;Grand Est;51;1;01;253;Florent-en-Argonne;231;5;236
44;Grand Est;51;2;21;254;Fontaine-Denis-Nuisy;233;2;235
44;Grand Est;51;1;01;255;Fontaine-en-Dormois;12;0;12
44;Grand Est;51;2;07;256;Fontaine-sur-Ay;340;8;348
44;Grand Est;51;2;21;258;La Forestière;213;13;226
44;Grand Est;51;1;05;259;Francheville;202;7;209
44;Grand Est;51;1;05;260;Le Fresne;76;3;79
44;Grand Est;51;4;23;262;Frignicourt;1846;34;1880
44;Grand Est;51;2;21;263;Fromentières;378;7;385
44;Grand Est;51;2;21;264;Le Gault-Soigny;521;15;536
44;Grand Est;51;2;21;265;Gaye;586;12;598
44;Grand Est;51;2;07;266;Germaine;520;16;536
44;Grand Est;51;3;09;267;Germigny;178;2;180
44;Grand Est;51;2;22;268;Germinon;174;4;178
44;Grand Est;51;4;20;269;Giffaumont-Champaubert;273;1;274
44;Grand Est;51;4;20;270;Gigny-Bussy;233;5;238
44;Grand Est;51;1;01;272;Givry-en-Argonne;450;5;455
44;Grand Est;51;2;22;273;Givry-lès-Loisy;71;4;75
44;Grand Est;51;1;01;274;Gizaucourt;116;3;119
44;Grand Est;51;4;23;275;Glannes;188;3;191
44;Grand Est;51;2;22;276;Gourgançon;146;7;153
44;Grand Est;51;1;04;278;Les Grandes-Loges;275;5;280
44;Grand Est;51;2;22;279;Granges-sur-Aube;184;4;188
44;Grand Est;51;1;01;280;Gratreuil;27;0;27
44;Grand Est;51;2;08;281;Grauves;619;12;631
44;Grand Est;51;3;09;282;Gueux;1741;44;1785
44;Grand Est;51;1;01;283;Hans;146;6;152
44;Grand Est;51;4;20;284;Haussignémont;295;1;296
44;Grand Est;51;1;05;285;Haussimont;140;5;145
44;Grand Est;51;4;20;286;Hauteville;240;8;248
44;Grand Est;51;2;07;287;Hautvillers;687;15;702
44;Grand Est;51;4;20;290;Heiltz-l'Évêque;294;6;300
44;Grand Est;51;4;20;288;Heiltz-le-Hutier;233;8;241
44;Grand Est;51;4;20;289;Heiltz-le-Maurupt;428;9;437
44;Grand Est;51;3;02;291;Hermonville;1402;31;1433
44;Grand Est;51;1;01;292;Herpont;131;4;135
44;Grand Est;51;3;02;293;Heutrégiville;461;7;468
44;Grand Est;51;3;09;294;Hourges;81;1;82
44;Grand Est;51;4;23;295;Huiron;305;2;307
44;Grand Est;51;4;23;296;Humbauville;78;1;79
44;Grand Est;51;2;06;298;Igny-Comblizy;422;3;425
44;Grand Est;51;4;20;300;Isle-sur-Marne;96;2;98
44;Grand Est;51;3;02;299;Isles-sur-Suippe;915;14;929
44;Grand Est;51;1;04;301;Isse;112;8;120
44;Grand Est;51;2;08;302;Les Istres-et-Bury;96;1;97
44;Grand Est;51;1;04;303;Jâlons;556;10;566
44;Grand Est;51;2;21;304;Janvilliers;170;4;174
44;Grand Est;51;3;09;305;Janvry;128;2;130
44;Grand Est;51;2;21;306;Joiselle;101;3;104
44;Grand Est;51;1;01;307;Jonchery-sur-Suippe;220;3;223
44;Grand Est;51;3;09;308;Jonchery-sur-Vesle;1858;53;1911
44;Grand Est;51;3;06;309;Jonquery;110;4;114
44;Grand Est;51;3;09;310;Jouy-lès-Reims;224;2;226
44;Grand Est;51;4;20;311;Jussecourt-Minecourt;206;2;208
44;Grand Est;51;1;04;312;Juvigny;931;29;960
44;Grand Est;51;2;21;313;Lachy;327;5;332
44;Grand Est;51;3;06;314;Lagery;224;3;227
44;Grand Est;51;4;20;315;Landricourt;148;2;150
44;Grand Est;51;4;20;316;Larzicourt;277;5;282
44;Grand Est;51;1;01;317;Laval-sur-Tourbe;56;0;56
44;Grand Est;51;3;02;318;Lavannes;576;16;592
44;Grand Est;51;1;05;319;Lenharrée;97;3;100
44;Grand Est;51;2;06;320;Leuvrigny;324;8;332
44;Grand Est;51;3;06;321;Lhéry;82;3;85
44;Grand Est;51;4;23;322;Lignon;126;1;127
44;Grand Est;51;2;21;323;Linthelles;107;6;113
44;Grand Est;51;2;21;324;Linthes;115;0;115
44;Grand Est;51;4;20;325;Lisse-en-Champagne;117;2;119
44;Grand Est;51;1;10;326;Livry-Louvercy;1092;14;1106
44;Grand Est;51;2;22;327;Loisy-en-Brie;190;2;192
44;Grand Est;51;4;23;328;Loisy-sur-Marne;1099;24;1123
44;Grand Est;51;3;02;329;Loivre;1291;17;1308
44;Grand Est;51;3;10;333;Ludes;656;7;663
44;Grand Est;51;4;20;334;Luxémont-et-Villotte;459;10;469
44;Grand Est;51;1;01;336;Maffrécourt;58;1;59
44;Grand Est;51;2;07;663;Magenta;1698;15;1713
44;Grand Est;51;3;09;337;Magneux;275;3;278
44;Grand Est;51;3;10;338;Mailly-Champagne;650;17;667
44;Grand Est;51;1;05;339;Mairy-sur-Marne;551;15;566
44;Grand Est;51;4;23;340;Maisons-en-Champagne;535;14;549
44;Grand Est;51;1;01;341;Malmy;33;2;35
44;Grand Est;51;2;08;342;Mancy;250;7;257
44;Grand Est;51;2;22;343;Marcilly-sur-Seine;633;21;654
44;Grand Est;51;2;07;344;Mardeuil;1490;20;1510
44;Grand Est;51;2;06;345;Mareuil-en-Brie;280;2;282
44;Grand Est;51;2;06;346;Mareuil-le-Port;1161;18;1179
44;Grand Est;51;3;06;348;Marfaux;115;1;116
44;Grand Est;51;4;23;349;Margerie-Hancourt;177;4;181
44;Grand Est;51;2;06;350;Margny;125;5;130
44;Grand Est;51;2;22;351;Marigny;108;1;109
44;Grand Est;51;4;23;352;Marolles;885;18;903
44;Grand Est;51;2;22;353;Marsangis;47;1;48
44;Grand Est;51;1;05;354;Marson;286;9;295
44;Grand Est;51;1;01;355;Massiges;50;0;50
44;Grand Est;51;4;20;356;Matignicourt-Goncourt;149;5;154
44;Grand Est;51;1;04;357;Matougues;602;13;615
44;Grand Est;51;4;20;358;Maurupt-le-Montois;586;10;596
44;Grand Est;51;2;21;359;Mécringes;205;3;208
44;Grand Est;51;2;21;360;Le Meix-Saint-Epoing;291;2;293
44;Grand Est;51;4;23;361;Le Meix-Tiercelin;171;1;172
44;Grand Est;51;3;02;362;Merfy;604;19;623
44;Grand Est;51;4;20;363;Merlaut;246;7;253
44;Grand Est;51;3;09;364;Méry-Prémecy;62;1;63
44;Grand Est;51;3;09;365;Les Mesneux;870;21;891
44;Grand Est;51;2;22;367;Le Mesnil-sur-Oger;1082;37;1119
44;Grand Est;51;1;01;368;Minaucourt-le-Mesnil-lès-Hurlus;50;3;53
44;Grand Est;51;1;01;370;Moiremont;194;10;204
44;Grand Est;51;1;05;371;Moivre;62;1;63
44;Grand Est;51;4;20;373;Moncetz-l'Abbaye;93;4;97
44;Grand Est;51;1;05;372;Moncetz-Longevas;534;9;543
44;Grand Est;51;2;21;374;Mondement-Montgivroux;29;0;29
44;Grand Est;51;3;09;382;Mont-sur-Courville;123;4;127
44;Grand Est;51;3;10;375;Montbré;299;5;304
44;Grand Est;51;1;05;377;Montépreux;46;0;46
44;Grand Est;51;2;21;376;Montgenost;154;3;157
44;Grand Est;51;2;08;378;Monthelon;351;5;356
44;Grand Est;51;3;09;379;Montigny-sur-Vesle;511;8;519
44;Grand Est;51;2;21;380;Montmirail;3584;49;3633
44;Grand Est;51;2;06;381;Montmort-Lucy;610;11;621
44;Grand Est;51;2;08;384;Morangis;401;7;408
44;Grand Est;51;2;21;386;Morsains;134;3;137
44;Grand Est;51;2;22;387;Moslins;304;3;307
44;Grand Est;51;1;10;388;Mourmelon-le-Grand;5102;48;5150
44;Grand Est;51;1;10;389;Mourmelon-le-Petit;813;8;821
44;Grand Est;51;2;08;390;Moussy;773;10;783
44;Grand Est;51;3;09;391;Muizon;2140;65;2205
44;Grand Est;51;2;07;392;Mutigny;184;5;189
44;Grand Est;51;2;21;369;Mœurs-Verdey;317;14;331
44;Grand Est;51;2;07;393;Nanteuil-la-Forêt;290;7;297
44;Grand Est;51;2;21;395;Nesle-la-Reposte;101;1;102
44;Grand Est;51;2;06;396;Nesle-le-Repons;146;3;149
44;Grand Est;51;1;01;399;La Neuville-au-Pont;545;9;554
44;Grand Est;51;1;01;397;La Neuville-aux-Bois;141;2;143
44;Grand Est;51;2;06;398;La Neuville-aux-Larris;177;2;179
44;Grand Est;51;2;21;402;Neuvy;265;7;272
44;Grand Est;51;3;02;403;Nogent-l'Abbesse;532;5;537
44;Grand Est;51;1;01;404;Noirlieu;106;4;110
44;Grand Est;51;4;20;406;Norrois;152;1;153
44;Grand Est;51;2;21;407;La Noue;415;5;420
44;Grand Est;51;1;05;409;Nuisement-sur-Coole;365;10;375
44;Grand Est;51;2;22;412;Ognes;61;2;63
44;Grand Est;51;2;08;413;Oiry;832;17;849
44;Grand Est;51;3;06;414;Olizy;155;5;160
44;Grand Est;51;1;05;415;Omey;207;0;207
44;Grand Est;51;2;06;416;Orbais-l'Abbaye;550;3;553
44;Grand Est;51;4;20;417;Orconte;385;5;390
44;Grand Est;51;3;09;418;Ormes;435;3;438
44;Grand Est;51;4;20;419;Outines;131;2;133
44;Grand Est;51;4;20;420;Outrepont;83;0;83
44;Grand Est;51;2;21;421;Oyes;94;3;97
44;Grand Est;51;3;09;422;Pargny-lès-Reims;469;10;479
44;Grand Est;51;4;20;423;Pargny-sur-Saulx;1810;15;1825
44;Grand Est;51;1;01;424;Passavant-en-Argonne;208;1;209
44;Grand Est;51;2;06;425;Passy-Grigny;381;14;395
44;Grand Est;51;2;21;426;Péas;67;3;70
44;Grand Est;51;3;10;428;Les Petites-Loges;485;7;492
44;Grand Est;51;3;09;429;Pévy;205;3;208
44;Grand Est;51;2;22;430;Pierre-Morains;87;2;89
44;Grand Est;51;2;08;431;Pierry;1190;19;1209
44;Grand Est;51;2;22;432;Pleurs;844;19;863
44;Grand Est;51;4;20;433;Plichancourt;248;3;251
44;Grand Est;51;2;08;434;Plivot;744;21;765
44;Grand Est;51;2;22;435;Pocancy;175;2;177
44;Grand Est;51;1;05;436;Pogny;914;18;932
44;Grand Est;51;3;06;437;Poilly;95;0;95
44;Grand Est;51;1;01;438;Poix;70;1;71
44;Grand Est;51;3;02;439;Pomacle;454;7;461
44;Grand Est;51;3;10;440;Pontfaverger-Moronvilliers;1751;17;1768
44;Grand Est;51;4;20;441;Ponthion;107;1;108
44;Grand Est;51;4;20;442;Possesse;148;0;148
44;Grand Est;51;2;22;443;Potangis;126;3;129
44;Grand Est;51;3;02;444;Pouillon;499;8;507
44;Grand Est;51;3;06;445;Pourcy;194;1;195
44;Grand Est;51;4;23;446;Pringy;426;8;434
44;Grand Est;51;3;10;447;Prosnes;488;13;501
44;Grand Est;51;3;09;448;Prouilly;558;10;568
44;Grand Est;51;3;18;449;Prunay;1030;16;1046
44;Grand Est;51;3;18;450;Puisieulx;422;8;430
44;Grand Est;51;2;21;451;Queudes;95;5;100
44;Grand Est;51;1;01;452;Rapsécourt;35;0;35
44;Grand Est;51;1;04;453;Recy;1029;30;1059
44;Grand Est;51;3;99;454;Reims;182211;3000;185211
44;Grand Est;51;4;20;455;Reims-la-Brûlée;225;3;228
44;Grand Est;51;1;01;456;Remicourt;59;1;60
44;Grand Est;51;2;06;457;Reuil;278;18;296
44;Grand Est;51;2;21;458;Reuves;67;0;67
44;Grand Est;51;2;21;459;Réveillon;108;1;109
44;Grand Est;51;2;21;460;Rieux;197;5;202
44;Grand Est;51;3;10;461;Rilly-la-Montagne;1008;21;1029
44;Grand Est;51;4;23;463;Les Rivières-Henruel;174;4;178
44;Grand Est;51;3;09;464;Romain;312;17;329
44;Grand Est;51;2;06;465;Romery;160;2;162
44;Grand Est;51;3;06;466;Romigny;215;5;220
44;Grand Est;51;3;09;468;Rosnay;360;10;370
44;Grand Est;51;2;22;469;Rouffy;112;5;117
44;Grand Est;51;1;01;470;Rouvroy-Ripont;6;0;6
44;Grand Est;51;3;09;471;Sacy;369;3;372
44;Grand Est;51;4;20;472;Saint-Amand-sur-Fion;1031;17;1048
44;Grand Est;51;2;21;473;Saint-Bon;109;6;115
44;Grand Est;51;3;15;474;Saint-Brice-Courcelles;3442;41;3483
44;Grand Est;51;4;23;475;Saint-Chéron;60;1;61
44;Grand Est;51;1;05;476;Saint-Étienne-au-Temple;817;13;830
44;Grand Est;51;3;02;477;Saint-Étienne-sur-Suippe;324;4;328
44;Grand Est;51;4;20;478;Saint-Eulien;428;12;440
44;Grand Est;51;3;09;479;Saint-Euphraise-et-Clairizet;235;5;240
44;Grand Est;51;1;05;482;Saint-Germain-la-Ville;674;13;687
44;Grand Est;51;1;04;483;Saint-Gibrien;537;7;544
44;Grand Est;51;3;09;484;Saint-Gilles;286;4;290
44;Grand Est;51;1;10;485;Saint-Hilaire-au-Temple;344;6;350
44;Grand Est;51;1;01;486;Saint-Hilaire-le-Grand;370;4;374
44;Grand Est;51;3;10;487;Saint-Hilaire-le-Petit;343;6;349
44;Grand Est;51;2;07;488;Saint-Imoges;319;34;353
44;Grand Est;51;4;20;489;Saint-Jean-devant-Possesse;32;3;35
44;Grand Est;51;1;05;490;Saint-Jean-sur-Moivre;206;2;208
44;Grand Est;51;1;01;491;Saint-Jean-sur-Tourbe;89;3;92
44;Grand Est;51;2;22;492;Saint-Just-Sauvage;1437;38;1475
44;Grand Est;51;3;18;493;Saint-Léonard;104;3;107
44;Grand Est;51;2;21;495;Saint-Loup;83;0;83
44;Grand Est;51;4;20;496;Saint-Lumier-en-Champagne;268;5;273
44;Grand Est;51;4;20;497;Saint-Lumier-la-Populeuse;47;0;47
44;Grand Est;51;2;22;499;Saint-Mard-lès-Rouffy;162;7;169
44;Grand Est;51;1;01;498;Saint-Mard-sur-Auve;63;1;64
44;Grand Est;51;1;01;500;Saint-Mard-sur-le-Mont;119;0;119
44;Grand Est;51;1;05;502;Saint-Martin-aux-Champs;109;0;109
44;Grand Est;51;2;06;002;Saint-Martin-d'Ablois;1414;23;1437
44;Grand Est;51;3;10;503;Saint-Martin-l'Heureux;86;1;87
44;Grand Est;51;1;04;504;Saint-Martin-sur-le-Pré;801;31;832
44;Grand Est;51;3;10;505;Saint-Masmes;472;4;476
44;Grand Est;51;1;05;506;Saint-Memmie;5473;78;5551
44;Grand Est;51;4;23;508;Saint-Ouen-Domprot;205;6;211
44;Grand Est;51;1;04;509;Saint-Pierre;307;8;315
44;Grand Est;51;2;22;511;Saint-Quentin-le-Verger;120;2;122
44;Grand Est;51;4;20;510;Saint-Quentin-les-Marais;134;0;134
44;Grand Est;51;1;05;512;Saint-Quentin-sur-Coole;103;2;105
44;Grand Est;51;4;20;513;Saint-Remy-en-Bouzemont-Saint-Genest-et-Isson;517;6;523
44;Grand Est;51;2;21;514;Saint-Remy-sous-Broyes;105;2;107
44;Grand Est;51;1;01;515;Saint-Remy-sur-Bussy;343;8;351
44;Grand Est;51;2;22;516;Saint-Saturnin;55;0;55
44;Grand Est;51;3;10;517;Saint-Souplet-sur-Py;123;4;127
44;Grand Est;51;3;02;518;Saint-Thierry;618;24;642
44;Grand Est;51;1;01;519;Saint-Thomas-en-Argonne;39;2;41
44;Grand Est;51;4;23;520;Saint-Utin;79;1;80
44;Grand Est;51;4;20;521;Saint-Vrain;230;3;233
44;Grand Est;51;2;06;480;Sainte-Gemme;138;3;141
44;Grand Est;51;1;01;501;Sainte-Marie-à-Py;197;8;205
44;Grand Est;51;4;20;277;Sainte-Marie-du-Lac-Nuisement;272;2;274
44;Grand Est;51;1;01;507;Sainte-Menehould;4150;116;4266
44;Grand Est;51;4;20;522;Sapignicourt;416;4;420
44;Grand Est;51;3;06;523;Sarcy;256;4;260
44;Grand Est;51;2;22;524;Saron-sur-Aube;304;6;310
44;Grand Est;51;1;05;525;Sarry;2037;86;2123
44;Grand Est;51;2;21;526;Saudoy;377;10;387
44;Grand Est;51;3;09;527;Savigny-sur-Ardres;269;4;273
44;Grand Est;51;4;20;528;Scrupt;130;0;130
44;Grand Est;51;3;10;529;Selles;411;1;412
44;Grand Est;51;3;10;530;Sept-Saulx;626;11;637
44;Grand Est;51;4;20;531;Sermaize-les-Bains;1848;33;1881
44;Grand Est;51;3;09;532;Sermiers;561;14;575
44;Grand Est;51;1;01;533;Servon-Melzicourt;107;0;107
44;Grand Est;51;3;09;534;Serzy-et-Prin;204;4;208
44;Grand Est;51;2;21;535;Sézanne;4756;108;4864
44;Grand Est;51;3;18;536;Sillery;1795;39;1834
44;Grand Est;51;1;01;537;Sivry-Ante;181;4;185
44;Grand Est;51;1;05;538;Sogny-aux-Moulins;111;0;111
44;Grand Est;51;4;20;539;Sogny-en-l'Angle;68;0;68
44;Grand Est;51;2;21;542;Soizy-aux-Bois;187;0;187
44;Grand Est;51;1;01;543;Somme-Bionne;75;7;82
44;Grand Est;51;1;01;546;Somme-Suippe;501;145;646
44;Grand Est;51;1;01;547;Somme-Tourbe;141;2;143
44;Grand Est;51;1;01;548;Somme-Vesle;369;282;651
44;Grand Est;51;1;01;549;Somme-Yèvre;119;3;122
44;Grand Est;51;1;01;544;Sommepy-Tahure;632;19;651
44;Grand Est;51;1;05;545;Sommesous;518;17;535
44;Grand Est;51;4;23;550;Sompuis;281;12;293
44;Grand Est;51;4;23;551;Somsois;197;6;203
44;Grand Est;51;4;23;552;Songy;265;4;269
44;Grand Est;51;1;01;553;Souain-Perthes-lès-Hurlus;240;5;245
44;Grand Est;51;1;05;555;Soudé;175;0;175
44;Grand Est;51;1;05;556;Soudron;296;5;301
44;Grand Est;51;4;23;557;Soulanges;468;9;477
44;Grand Est;51;2;22;558;Soulières;142;3;145
44;Grand Est;51;1;01;559;Suippes;3890;49;3939
44;Grand Est;51;2;06;560;Suizy-le-Franc;106;3;109
44;Grand Est;51;3;18;562;Taissy;2191;36;2227
44;Grand Est;51;2;06;563;Talus-Saint-Prix;107;2;109
44;Grand Est;51;2;22;565;Thaas;100;0;100
44;Grand Est;51;1;04;566;Thibie;292;2;294
44;Grand Est;51;4;20;567;Thiéblemont-Farémont;533;6;539
44;Grand Est;51;3;02;568;Thil;300;6;306
44;Grand Est;51;3;09;569;Thillois;479;69;548
44;Grand Est;51;2;21;570;Le Thoult-Trosnay;104;2;106
44;Grand Est;51;1;01;572;Tilloy-et-Bellay;226;11;237
44;Grand Est;51;3;14;573;Tinqueux;10154;138;10292
44;Grand Est;51;1;05;574;Togny-aux-Bœufs;138;2;140
44;Grand Est;51;2;07;576;Tours-sur-Marne;1384;13;1397
44;Grand Est;51;3;06;577;Tramery;151;3;154
44;Grand Est;51;2;22;578;Trécon;86;1;87
44;Grand Est;51;2;21;579;Tréfols;174;3;177
44;Grand Est;51;3;10;580;Trépail;430;5;435
44;Grand Est;51;3;09;581;Treslon;244;1;245
44;Grand Est;51;3;09;582;Trigny;541;9;550
44;Grand Est;51;4;20;583;Trois-Fontaines-l'Abbaye;195;5;200
44;Grand Est;51;3;18;584;Trois-Puits;151;2;153
44;Grand Est;51;2;06;585;Troissy;798;62;860
44;Grand Est;51;3;09;586;Unchair;172;5;177
44;Grand Est;51;1;10;587;Vadenay;237;5;242
44;Grand Est;51;2;07;564;Val de Livre;620;16;636
44;Grand Est;51;3;10;571;Val-de-Vesle;907;10;917
44;Grand Est;51;4;20;218;Val-de-Vière;130;1;131
44;Grand Est;51;2;22;158;Val-des-Marais;567;11;578
44;Grand Est;51;1;01;588;Valmy;301;5;306
44;Grand Est;51;4;20;589;Vanault-le-Châtel;176;1;177
44;Grand Est;51;4;20;590;Vanault-les-Dames;365;9;374
44;Grand Est;51;3;09;591;Vandeuil;183;3;186
44;Grand Est;51;2;06;592;Vandières;303;6;309
44;Grand Est;51;1;05;594;Vassimont-et-Chapelaine;64;1;65
44;Grand Est;51;1;05;595;Vatry;156;2;158
44;Grand Est;51;2;21;596;Vauchamps;363;10;373
44;Grand Est;51;2;06;597;Vauciennes;330;7;337
44;Grand Est;51;4;20;598;Vauclerc;491;21;512
44;Grand Est;51;3;10;599;Vaudemange;316;5;321
44;Grand Est;51;3;10;600;Vaudesincourt;96;1;97
44;Grand Est;51;4;20;601;Vavray-le-Grand;161;3;164
44;Grand Est;51;4;20;602;Vavray-le-Petit;65;0;65
44;Grand Est;51;2;22;603;Vélye;205;2;207
44;Grand Est;51;3;09;604;Ventelay;258;3;261
44;Grand Est;51;2;06;605;Venteuil;527;10;537
44;Grand Est;51;2;21;607;Verdon;208;2;210
44;Grand Est;51;4;20;608;Vernancourt;87;5;92
44;Grand Est;51;2;06;609;Verneuil;844;20;864
44;Grand Est;51;1;01;610;Verrières;393;6;399
44;Grand Est;51;2;22;611;Vert-Toulon;286;4;290
44;Grand Est;51;3;10;613;Verzenay;1049;8;1057
44;Grand Est;51;3;10;614;Verzy;969;23;992
44;Grand Est;51;1;05;616;Vésigneul-sur-Marne;234;3;237
44;Grand Est;51;1;04;617;La Veuve;611;11;622
44;Grand Est;51;2;21;618;Le Vézier;191;3;194
44;Grand Est;51;1;01;619;Le Vieil-Dampierre;111;3;114
44;Grand Est;51;1;01;620;Vienne-la-Ville;173;7;180
44;Grand Est;51;1;01;621;Vienne-le-Château;519;10;529
44;Grand Est;51;3;09;622;Ville-Dommange;400;9;409
44;Grand Est;51;3;10;623;Ville-en-Selve;280;46;326
44;Grand Est;51;3;06;624;Ville-en-Tardenois;652;6;658
44;Grand Est;51;2;06;639;La Ville-sous-Orbais;46;1;47
44;Grand Est;51;1;01;640;Ville-sur-Tourbe;216;1;217
44;Grand Est;51;2;21;625;Villeneuve-la-Lionne;284;3;287
44;Grand Est;51;2;21;626;La Villeneuve-lès-Charleville;115;4;119
44;Grand Est;51;2;22;627;Villeneuve-Renneville-Chevigny;319;11;330
44;Grand Est;51;2;21;628;Villeneuve-Saint-Vistre-et-Villevotte;123;5;128
44;Grand Est;51;3;10;629;Villers-Allerand;898;22;920
44;Grand Est;51;2;22;630;Villers-aux-Bois;326;5;331
44;Grand Est;51;3;14;631;Villers-aux-Nœuds;224;5;229
44;Grand Est;51;1;01;632;Villers-en-Argonne;235;6;241
44;Grand Est;51;3;02;633;Villers-Franqueux;296;15;311
44;Grand Est;51;1;04;634;Villers-le-Château;259;8;267
44;Grand Est;51;4;20;635;Villers-le-Sec;114;1;115
44;Grand Est;51;3;10;636;Villers-Marmery;513;12;525
44;Grand Est;51;2;06;637;Villers-sous-Châtillon;213;3;216
44;Grand Est;51;2;22;638;Villeseneux;210;6;216
44;Grand Est;51;2;06;641;Villevenard;209;5;214
44;Grand Est;51;2;22;642;Villiers-aux-Corneilles;110;4;114
44;Grand Est;51;2;08;643;Vinay;569;5;574
44;Grand Est;51;2;06;644;Vincelles;299;9;308
44;Grand Est;51;2;21;645;Vindey;111;2;113
44;Grand Est;51;1;01;646;Virginy;83;3;86
44;Grand Est;51;4;20;647;Vitry-en-Perthois;828;24;852
44;Grand Est;51;1;05;648;Vitry-la-Ville;388;9;397
44;Grand Est;51;4;23;649;Vitry-le-François;11743;256;11999
44;Grand Est;51;1;01;650;Voilemont;45;1;46
44;Grand Est;51;2;22;652;Vouarces;59;0;59
44;Grand Est;51;4;20;654;Vouillers;258;2;260
44;Grand Est;51;2;22;655;Vouzy;292;5;297
44;Grand Est;51;1;04;656;Vraux;452;18;470
44;Grand Est;51;3;09;657;Vrigny;237;0;237
44;Grand Est;51;4;20;658;Vroil;104;0;104
44;Grand Est;51;1;01;659;Wargemoulin-Hurlus;47;1;48
44;Grand Est;51;3;02;660;Warmeriville;2529;27;2556
44;Grand Est;51;3;02;662;Witry-lès-Reims;4990;75;5065
44;Grand Est;51;2;06;410;Œuilly;648;10;658
44;Grand Est;52;1;11;001;Ageville;310;8;318
44;Grand Est;52;2;02;002;Aigremont;21;0;21
44;Grand Est;52;1;12;003;Aillianville;157;2;159
44;Grand Est;52;3;12;004;Aingoulaincourt;13;0;13
44;Grand Est;52;1;04;005;Aizanville;34;4;38
44;Grand Est;52;3;13;006;Allichamps;351;4;355
44;Grand Est;52;3;09;007;Ambonville;85;2;87
44;Grand Est;52;1;01;008;Andelot-Blancheville;865;10;875
44;Grand Est;52;2;11;009;Andilly-en-Bassigny;106;1;107
44;Grand Est;52;1;01;011;Annéville-la-Prairie;88;0;88
44;Grand Est;52;3;12;012;Annonville;31;2;33
44;Grand Est;52;2;03;013;Anrosey;122;2;124
44;Grand Est;52;2;16;014;Aprey;185;5;190
44;Grand Est;52;2;03;015;Arbigny-sous-Varennes;87;0;87
44;Grand Est;52;2;16;016;Arbot;69;2;71
44;Grand Est;52;1;04;017;Arc-en-Barrois;736;14;750
44;Grand Est;52;3;09;019;Arnancourt;91;4;95
44;Grand Est;52;3;17;021;Attancourt;266;4;270
44;Grand Est;52;1;04;022;Aubepierre-sur-Aube;186;3;189
44;Grand Est;52;2;16;023;Auberive;157;5;162
44;Grand Est;52;1;12;025;Audeloncourt;87;2;89
44;Grand Est;52;2;16;027;Aujeurres;78;2;80
44;Grand Est;52;2;16;028;Aulnoy-sur-Aube;53;0;53
44;Grand Est;52;3;09;029;Autigny-le-Grand;143;4;147
44;Grand Est;52;3;09;030;Autigny-le-Petit;60;4;64
44;Grand Est;52;1;04;031;Autreville-sur-la-Renne;375;9;384
44;Grand Est;52;2;02;033;Avrecourt;111;4;115
44;Grand Est;52;3;17;034;Bailly-aux-Forges;143;5;148
44;Grand Est;52;2;16;035;Baissey;188;3;191
44;Grand Est;52;2;11;037;Bannes;372;3;375
44;Grand Est;52;1;12;038;Bassoncourt;65;0;65
44;Grand Est;52;3;09;039;Baudrecourt;90;0;90
44;Grand Est;52;2;16;040;Bay-sur-Aube;54;1;55
44;Grand Est;52;3;08;265;Bayard-sur-Marne;1310;28;1338
44;Grand Est;52;2;10;042;Beauchemin;105;1;106
44;Grand Est;52;2;03;043;Belmont;57;2;59
44;Grand Est;52;3;15;045;Bettancourt-la-Ferrée;1787;39;1826
44;Grand Est;52;3;09;047;Beurville;104;0;104
44;Grand Est;52;1;11;050;Biesles;1347;31;1378
44;Grand Est;52;2;03;051;Bize;89;5;94
44;Grand Est;52;1;04;053;Blaisy;74;1;75
44;Grand Est;52;3;09;055;Blécourt;113;2;115
44;Grand Est;52;1;04;056;Blessonville;191;6;197
44;Grand Est;52;3;09;057;Blumeray;107;4;111
44;Grand Est;52;1;01;058;Bologne;1874;28;1902
44;Grand Est;52;2;11;059;Bonnecourt;140;0;140
44;Grand Est;52;2;02;060;Bourbonne-les-Bains;2025;53;2078
44;Grand Est;52;1;01;061;Bourdons-sur-Rognon;288;2;290
44;Grand Est;52;2;16;062;Bourg;158;4;162
44;Grand Est;52;1;12;063;Bourg-Sainte-Marie;100;1;101
44;Grand Est;52;1;12;064;Bourmont-entre-Meuse-et-Mouzon;792;35;827
44;Grand Est;52;3;09;065;Bouzancourt;65;1;66
44;Grand Est;52;3;09;066;Brachay;63;3;66
44;Grand Est;52;1;12;067;Brainville-sur-Meuse;76;0;76
44;Grand Est;52;1;04;069;Braux-le-Châtel;145;1;146
44;Grand Est;52;2;16;070;Brennes;126;3;129
44;Grand Est;52;1;05;072;Brethenay;375;10;385
44;Grand Est;52;1;12;074;Breuvannes-en-Bassigny;673;20;693
44;Grand Est;52;1;01;075;Briaucourt;179;6;185
44;Grand Est;52;1;04;076;Bricon;445;14;459
44;Grand Est;52;3;17;079;Brousseval;677;11;688
44;Grand Est;52;1;04;082;Bugnières;154;5;159
44;Grand Est;52;1;12;084;Busson;41;0;41
44;Grand Est;52;1;02;085;Buxières-lès-Clefmont;26;2;28
44;Grand Est;52;1;06;087;Buxières-lès-Villiers;193;20;213
44;Grand Est;52;3;17;088;Ceffonds;640;21;661
44;Grand Est;52;2;02;089;Celles-en-Bassigny;79;0;79
44;Grand Est;52;2;03;090;Celsoy;104;1;105
44;Grand Est;52;3;01;091;Cerisières;84;7;91
44;Grand Est;52;2;16;092;Chalancey;106;2;108
44;Grand Est;52;2;03;093;Chalindrey;2432;41;2473
44;Grand Est;52;1;12;095;Chalvraines;189;2;191
44;Grand Est;52;1;06;125;Chamarandes-Choignes;1043;172;1215
44;Grand Est;52;1;12;097;Chambroncourt;49;1;50
44;Grand Est;52;3;08;099;Chamouilley;803;10;813
44;Grand Est;52;1;12;101;Champigneulles-en-Bassigny;43;1;44
44;Grand Est;52;2;10;102;Champigny-lès-Langres;424;13;437
44;Grand Est;52;2;03;103;Champigny-sous-Varennes;115;2;117
44;Grand Est;52;2;03;083;Champsevraine;736;14;750
44;Grand Est;52;3;15;104;Chancenay;1066;24;1090
44;Grand Est;52;2;11;105;Changey;301;11;312
44;Grand Est;52;2;10;106;Chanoy;124;2;126
44;Grand Est;52;1;01;107;Chantraines;224;5;229
44;Grand Est;52;2;11;108;Charmes;146;4;150
44;Grand Est;52;3;09;109;Charmes-en-l'Angle;9;0;9
44;Grand Est;52;3;09;110;Charmes-la-Grande;155;6;161
44;Grand Est;52;2;16;113;Chassigny;256;2;258
44;Grand Est;52;1;04;114;Châteauvillain;1580;17;1597
44;Grand Est;52;2;02;400;Le Châtelet-sur-Meuse;153;0;153
44;Grand Est;52;2;10;115;Chatenay-Mâcheron;101;2;103
44;Grand Est;52;2;10;116;Chatenay-Vaudin;50;2;52
44;Grand Est;52;3;09;118;Chatonrupt-Sommermont;288;6;294
44;Grand Est;52;2;03;119;Chaudenay;345;9;354
44;Grand Est;52;2;02;120;Chauffourt;197;8;205
44;Grand Est;52;1;98;121;Chaumont;21990;1198;23188
44;Grand Est;52;1;12;122;Chaumont-la-Ville;116;1;117
44;Grand Est;52;3;08;123;Chevillon;1292;21;1313
44;Grand Est;52;2;03;124;Chézeaux;74;0;74
44;Grand Est;52;2;16;126;Choilley-Dardenay;161;4;165
44;Grand Est;52;1;02;127;Choiseul;78;4;82
44;Grand Est;52;1;01;128;Cirey-lès-Mareilles;144;3;147
44;Grand Est;52;3;09;129;Cirey-sur-Blaise;119;1;120
44;Grand Est;52;1;04;130;Cirfontaines-en-Azois;187;1;188
44;Grand Est;52;3;12;131;Cirfontaines-en-Ornois;75;1;76
44;Grand Est;52;1;02;132;Clefmont;172;3;175
44;Grand Est;52;1;12;133;Clinchamp;73;0;73
44;Grand Est;52;2;16;134;Cohons;228;1;229
44;Grand Est;52;2;03;135;Coiffy-le-Bas;89;0;89
44;Grand Est;52;2;02;136;Coiffy-le-Haut;113;0;113
44;Grand Est;52;2;16;137;Colmier-le-Bas;22;0;22
44;Grand Est;52;2;16;138;Colmier-le-Haut;62;1;63
44;Grand Est;52;1;04;140;Colombey les Deux Églises ;711;22;733
44;Grand Est;52;1;05;141;Condes;301;6;307
44;Grand Est;52;1;01;142;Consigny;70;1;71
44;Grand Est;52;2;16;145;Coublanc;118;5;123
44;Grand Est;52;1;04;146;Coupray;151;3;154
44;Grand Est;52;1;04;151;Cour-l'Évêque;149;2;151
44;Grand Est;52;2;16;147;Courcelles-en-Montagne;89;0;89
44;Grand Est;52;3;09;149;Courcelles-sur-Blaise;96;2;98
44;Grand Est;52;2;03;155;Culmont;526;12;538
44;Grand Est;52;3;08;156;Curel;408;7;415
44;Grand Est;52;1;04;157;Curmont;12;1;13
44;Grand Est;52;2;16;158;Cusey;282;4;286
44;Grand Est;52;1;11;159;Cuves;25;1;26
44;Grand Est;52;1;01;160;Daillancourt;65;2;67
44;Grand Est;52;1;02;161;Daillecourt;73;0;73
44;Grand Est;52;2;02;162;Dammartin-sur-Meuse;196;2;198
44;Grand Est;52;2;11;163;Dampierre;384;4;388
44;Grand Est;52;2;02;164;Damrémont;197;5;202
44;Grand Est;52;1;04;165;Dancevoir;191;5;196
44;Grand Est;52;1;01;167;Darmannes;261;3;264
44;Grand Est;52;1;04;168;Dinteville;58;3;61
44;Grand Est;52;3;08;169;Domblain;79;2;81
44;Grand Est;52;2;16;170;Dommarien;164;7;171
44;Grand Est;52;3;17;171;Dommartin-le-Franc;246;3;249
44;Grand Est;52;3;09;172;Dommartin-le-Saint-Père;277;7;284
44;Grand Est;52;3;01;173;Domremy-Landéville;78;2;80
44;Grand Est;52;1;12;174;Doncourt-sur-Meuse;38;1;39
44;Grand Est;52;3;09;175;Donjeux;388;4;392
44;Grand Est;52;3;01;177;Doulaincourt-Saucourt;796;34;830
44;Grand Est;52;3;09;178;Doulevant-le-Château;364;10;374
44;Grand Est;52;3;17;179;Doulevant-le-Petit;23;2;25
44;Grand Est;52;3;12;181;Échenay;91;2;93
44;Grand Est;52;3;13;182;Éclaron-Braucourt-Sainte-Livière;2027;46;2073
44;Grand Est;52;1;01;183;Ecot-la-Combe;38;1;39
44;Grand Est;52;3;12;184;Effincourt;60;5;65
44;Grand Est;52;2;02;185;Enfonvelle;64;1;65
44;Grand Est;52;3;12;187;Épizon;159;4;163
44;Grand Est;52;1;11;190;Esnouveaux;289;5;294
44;Grand Est;52;1;05;193;Euffigneix;305;13;318
44;Grand Est;52;3;08;194;Eurville-Bienville;2035;32;2067
44;Grand Est;52;2;03;195;Farincourt;38;0;38
44;Grand Est;52;2;10;196;Faverolles;98;4;102
44;Grand Est;52;2;03;197;Fayl-Billot;1311;111;1422
44;Grand Est;52;3;08;198;Fays;72;3;75
44;Grand Est;52;3;09;199;Ferrière-et-Lafolie;49;2;51
44;Grand Est;52;2;16;200;Flagey;80;5;85
44;Grand Est;52;3;09;201;Flammerécourt;69;0;69
44;Grand Est;52;3;08;203;Fontaines-sur-Marne;147;2;149
44;Grand Est;52;1;11;204;Forcey;64;4;68
44;Grand Est;52;1;07;205;Foulain;693;17;710
44;Grand Est;52;3;17;206;Frampas;157;4;161
44;Grand Est;52;2;02;207;Frécourt;97;4;101
44;Grand Est;52;2;02;208;Fresnes-sur-Apance;148;2;150
44;Grand Est;52;1;01;211;Froncles;1485;24;1509
44;Grand Est;52;3;09;212;Fronville;310;3;313
44;Grand Est;52;2;03;213;Genevrières;132;6;138
44;Grand Est;52;1;01;214;La Genevroye;32;1;33
44;Grand Est;52;2;16;216;Germaines;45;1;46
44;Grand Est;52;1;12;217;Germainvilliers;88;4;92
44;Grand Est;52;3;12;218;Germay;47;0;47
44;Grand Est;52;3;12;219;Germisay;18;0;18
44;Grand Est;52;1;04;220;Giey-sur-Aujon;136;1;137
44;Grand Est;52;1;04;221;Gillancourt;120;4;124
44;Grand Est;52;3;12;222;Gillaumé;36;0;36
44;Grand Est;52;2;03;223;Gilley;67;3;70
44;Grand Est;52;1;12;227;Graffigny-Chemin;223;11;234
44;Grand Est;52;2;03;228;Grandchamp;79;1;80
44;Grand Est;52;2;03;229;Grenant;150;2;152
44;Grand Est;52;3;09;230;Gudmont-Villiers;284;5;289
44;Grand Est;52;3;09;231;Guindrecourt-aux-Ormes;92;2;94
44;Grand Est;52;1;01;232;Guindrecourt-sur-Blaise;61;0;61
44;Grand Est;52;2;03;233;Guyonvelle;106;2;108
44;Grand Est;52;1;12;234;Hâcourt;40;0;40
44;Grand Est;52;3;13;235;Hallignicourt;273;4;277
44;Grand Est;52;1;12;237;Harréville-les-Chanteurs;285;10;295
44;Grand Est;52;2;03;242;Haute-Amance;962;16;978
44;Grand Est;52;2;03;240;Heuilley-le-Grand;201;7;208
44;Grand Est;52;1;12;243;Huilliécourt;118;1;119
44;Grand Est;52;3;13;244;Humbécourt;766;10;776
44;Grand Est;52;1;12;245;Humberville;63;5;68
44;Grand Est;52;2;10;246;Humes-Jorquenay;574;11;585
44;Grand Est;52;1;12;247;Illoud;214;8;222
44;Grand Est;52;1;02;248;Is-en-Bassigny;544;17;561
44;Grand Est;52;2;16;249;Isômes;148;6;154
44;Grand Est;52;3;09;250;Joinville;3037;68;3105
44;Grand Est;52;1;05;251;Jonchery;1005;35;1040
44;Grand Est;52;1;04;253;Juzennecourt;215;3;218
44;Grand Est;52;1;04;254;Lachapelle-en-Blaisy;84;3;87
44;Grand Est;52;1;12;256;Lafauche;77;4;81
44;Grand Est;52;2;03;257;Laferté-sur-Amance;107;2;109
44;Grand Est;52;1;04;258;Laferté-sur-Aube;321;2;323
44;Grand Est;52;1;01;260;Lamancine;123;3;126
44;Grand Est;52;2;02;264;Laneuvelle;62;2;64
44;Grand Est;52;3;17;266;Laneuville-à-Rémy;66;0;66
44;Grand Est;52;3;13;267;Laneuville-au-Pont;213;3;216
44;Grand Est;52;2;10;269;Langres;7699;405;8104
44;Grand Est;52;1;11;271;Lanques-sur-Rognon;191;6;197
44;Grand Est;52;1;04;272;Lanty-sur-Aube;118;2;120
44;Grand Est;52;2;02;273;Larivière-Arnoncourt;119;1;120
44;Grand Est;52;1;04;274;Latrecey-Ormoy-sur-Aube;293;9;302
44;Grand Est;52;2;02;275;Lavernoy;72;0;72
44;Grand Est;52;1;06;276;Laville-aux-Bois;214;6;220
44;Grand Est;52;2;02;277;Lavilleneuve;59;1;60
44;Grand Est;52;1;04;278;Lavilleneuve-au-Roi;74;0;74
44;Grand Est;52;2;10;280;Lecey;204;3;207
44;Grand Est;52;1;04;282;Leffonds;344;5;349
44;Grand Est;52;3;09;284;Leschères-sur-le-Blaiseron;97;1;98
44;Grand Est;52;2;16;285;Leuchey;82;2;84
44;Grand Est;52;1;12;286;Leurville;80;0;80
44;Grand Est;52;1;12;287;Levécourt;88;1;89
44;Grand Est;52;3;12;288;Lezéville;122;0;122
44;Grand Est;52;1;12;289;Liffol-le-Petit;318;8;326
44;Grand Est;52;2;03;290;Les Loges;134;2;136
44;Grand Est;52;1;12;291;Longchamp;66;0;66
44;Grand Est;52;2;16;292;Longeau-Percey;730;18;748
44;Grand Est;52;3;13;294;Louvemont;699;13;712
44;Grand Est;52;1;11;295;Louvières;95;0;95
44;Grand Est;52;1;07;297;Luzy-sur-Marne;262;11;273
44;Grand Est;52;2;16;298;Maâtz;75;1;76
44;Grand Est;52;3;08;300;Magneux;165;2;167
44;Grand Est;52;1;12;301;Maisoncelles;60;1;61
44;Grand Est;52;3;08;302;Maizières;193;3;196
44;Grand Est;52;2;03;303;Maizières-sur-Amance;97;1;98
44;Grand Est;52;1;12;304;Malaincourt-sur-Meuse;54;1;55
44;Grand Est;52;1;11;305;Mandres-la-Côte;549;5;554
44;Grand Est;52;1;12;306;Manois;447;9;456
44;Grand Est;52;2;10;307;Marac;215;4;219
44;Grand Est;52;1;04;308;Maranville;404;4;408
44;Grand Est;52;1;01;310;Marbéville;98;2;100
44;Grand Est;52;2;02;311;Marcilly-en-Bassigny;223;4;227
44;Grand Est;52;2;10;312;Mardor;50;3;53
44;Grand Est;52;1;01;313;Mareilles;149;1;150
44;Grand Est;52;1;11;315;Marnay-sur-Marne;333;1;334
44;Grand Est;52;3;09;316;Mathons;66;2;68
44;Grand Est;52;2;02;318;Melay;251;6;257
44;Grand Est;52;1;12;319;Mennouveaux;71;0;71
44;Grand Est;52;1;12;320;Merrey;96;3;99
44;Grand Est;52;3;09;321;Mertrud;177;7;184
44;Grand Est;52;1;01;322;Meures;132;4;136
44;Grand Est;52;1;12;325;Millières;116;5;121
44;Grand Est;52;1;01;326;Mirbel;43;0;43
44;Grand Est;52;3;13;327;Moëslains;434;10;444
44;Grand Est;52;2;02;328;Montcharvot;33;1;34
44;Grand Est;52;1;04;330;Montheries;68;2;70
44;Grand Est;52;1;01;335;Montot-sur-Rognon;125;1;126
44;Grand Est;52;3;17;336;Montreuil-sur-Blaise;156;3;159
44;Grand Est;52;3;12;337;Montreuil-sur-Thonnance;60;0;60
44;Grand Est;52;2;16;405;Le Montsaugeonnais;1227;22;1249
44;Grand Est;52;3;17;341;Morancourt;133;2;135
44;Grand Est;52;1;12;342;Morionvilliers;28;1;29
44;Grand Est;52;2;16;344;Mouilleron;33;1;34
44;Grand Est;52;3;09;346;Mussey-sur-Marne;378;6;384
44;Grand Est;52;3;08;347;Narcy;243;5;248
44;Grand Est;52;2;11;348;Neuilly-l'Évêque;587;19;606
44;Grand Est;52;1;07;349;Neuilly-sur-Suize;308;9;317
44;Grand Est;52;2;02;350;Neuvelle-lès-Voisey;70;0;70
44;Grand Est;52;1;11;352;Ninville;74;4;78
44;Grand Est;52;1;11;353;Nogent;3672;62;3734
44;Grand Est;52;2;03;354;Noidant-Chatenoy;83;0;83
44;Grand Est;52;2;16;355;Noidant-le-Rocheux;152;4;156
44;Grand Est;52;3;09;356;Nomécourt;109;4;113
44;Grand Est;52;3;12;357;Noncourt-sur-le-Rongeant;176;2;178
44;Grand Est;52;1;02;358;Noyers;86;0;86
44;Grand Est;52;3;09;359;Nully;156;3;159
44;Grand Est;52;2;16;360;Occey;161;3;164
44;Grand Est;52;2;11;362;Orbigny-au-Mont;134;2;136
44;Grand Est;52;2;11;363;Orbigny-au-Val;96;7;103
44;Grand Est;52;2;16;364;Orcevaux;101;3;104
44;Grand Est;52;1;04;365;Orges;347;3;350
44;Grand Est;52;2;10;366;Ormancey;79;1;80
44;Grand Est;52;1;01;367;Ormoy-lès-Sexfontaines;42;1;43
44;Grand Est;52;1;12;369;Orquevaux;75;0;75
44;Grand Est;52;3;08;370;Osne-le-Val;258;5;263
44;Grand Est;52;1;01;371;Oudincourt;141;2;143
44;Grand Est;52;1;12;372;Outremécourt;85;6;91
44;Grand Est;52;1;12;373;Ozières;36;1;37
44;Grand Est;52;2;03;374;Le Pailly;280;5;285
44;Grand Est;52;2;03;375;Palaiseul;57;0;57
44;Grand Est;52;3;12;376;Pansey;101;3;104
44;Grand Est;52;2;02;377;Parnoy-en-Bassigny;293;8;301
44;Grand Est;52;3;12;378;Paroy-sur-Saulx;46;2;48
44;Grand Est;52;2;10;380;Peigney;379;4;383
44;Grand Est;52;2;10;383;Perrancey-les-Vieux-Moulins;293;7;300
44;Grand Est;52;2;16;384;Perrogney-les-Fontaines;111;0;111
44;Grand Est;52;1;02;385;Perrusse;31;2;33
44;Grand Est;52;3;13;386;Perthes;522;4;526
44;Grand Est;52;2;03;388;Pierremont-sur-Amance;146;2;148
44;Grand Est;52;2;03;390;Pisseloup;54;1;55
44;Grand Est;52;3;17;391;Planrupt;305;8;313
44;Grand Est;52;2;11;392;Plesnoy;114;2;116
44;Grand Est;52;2;16;393;Poinsenot;55;0;55
44;Grand Est;52;2;03;394;Poinson-lès-Fayl;218;9;227
44;Grand Est;52;2;16;395;Poinson-lès-Grancey;50;0;50
44;Grand Est;52;1;11;396;Poinson-lès-Nogent;142;3;145
44;Grand Est;52;2;11;397;Poiseul;72;1;73
44;Grand Est;52;3;12;398;Poissons;650;14;664
44;Grand Est;52;1;04;399;Pont-la-Ville;108;7;115
44;Grand Est;52;3;17;331;Porte du Der ;2290;65;2355
44;Grand Est;52;1;11;401;Poulangy;373;12;385
44;Grand Est;52;2;16;403;Praslay;76;1;77
44;Grand Est;52;2;03;406;Pressigny;199;5;204
44;Grand Est;52;1;12;407;Prez-sous-Lafauche;286;7;293
44;Grand Est;52;3;08;414;Rachecourt-sur-Marne;774;12;786
44;Grand Est;52;3;17;413;Rachecourt-Suzémont;105;2;107
44;Grand Est;52;1;02;416;Rangecourt;63;1;64
44;Grand Est;52;2;02;415;Rançonnières;110;0;110
44;Grand Est;52;1;04;419;Rennepont;133;5;138
44;Grand Est;52;1;01;420;Reynel;122;1;123
44;Grand Est;52;1;05;421;Riaucourt;475;9;484
44;Grand Est;52;1;04;422;Richebourg;267;5;272
44;Grand Est;52;1;01;423;Rimaucourt;671;8;679
44;Grand Est;52;3;17;411;Rives Dervoises;1350;49;1399
44;Grand Est;52;2;16;425;Rivière-les-Fosses;197;4;201
44;Grand Est;52;2;03;424;Rivières-le-Bois;71;0;71
44;Grand Est;52;1;04;426;Rizaucourt-Buchey;127;1;128
44;Grand Est;52;1;01;428;Rochefort-sur-la-Côte;65;1;66
44;Grand Est;52;3;01;044;Roches-Bettaincourt;561;11;572
44;Grand Est;52;3;08;429;Roches-sur-Marne;557;3;560
44;Grand Est;52;2;16;431;Rochetaillée;166;2;168
44;Grand Est;52;2;11;432;Rolampont;1445;31;1476
44;Grand Est;52;1;12;433;Romain-sur-Meuse;93;1;94
44;Grand Est;52;3;01;436;Rouécourt;48;1;49
44;Grand Est;52;2;16;437;Rouelles;25;0;25
44;Grand Est;52;2;03;438;Rougeux;107;2;109
44;Grand Est;52;2;16;439;Rouvres-sur-Aube;86;1;87
44;Grand Est;52;3;09;440;Rouvroy-sur-Marne;379;7;386
44;Grand Est;52;3;09;442;Rupt;340;10;350
44;Grand Est;52;3;12;443;Sailly;33;0;33
44;Grand Est;52;1;12;444;Saint-Blin;366;10;376
44;Grand Est;52;2;03;445;Saint-Broingt-le-Bois;70;2;72
44;Grand Est;52;2;16;446;Saint-Broingt-les-Fosses;232;4;236
44;Grand Est;52;2;10;447;Saint-Ciergues;186;2;188
44;Grand Est;52;3;99;448;Saint-Dizier;23382;506;23888
44;Grand Est;52;2;16;450;Saint-Loup-sur-Aujon;136;4;140
44;Grand Est;52;2;10;452;Saint-Martin-lès-Langres;110;0;110
44;Grand Est;52;2;10;453;Saint-Maurice;134;1;135
44;Grand Est;52;1;12;455;Saint-Thiébault;237;6;243
44;Grand Est;52;3;09;456;Saint-Urbain-Maconcourt;642;10;652
44;Grand Est;52;2;03;457;Saint-Vallier-sur-Marne;173;3;176
44;Grand Est;52;2;10;449;Saints-Geosmes;1123;32;1155
44;Grand Est;52;1;11;459;Sarcey;113;1;114
44;Grand Est;52;2;02;461;Sarrey;378;10;388
44;Grand Est;52;3;12;463;Saudron;45;2;47
44;Grand Est;52;2;03;464;Saulles;47;2;49
44;Grand Est;52;2;02;465;Saulxures;128;0;128
44;Grand Est;52;2;03;467;Savigny;59;2;61
44;Grand Est;52;1;12;468;Semilly;109;4;113
44;Grand Est;52;1;07;469;Semoutiers-Montsaon;755;16;771
44;Grand Est;52;2;02;470;Serqueux;391;14;405
44;Grand Est;52;1;01;472;Sexfontaines;137;0;137
44;Grand Est;52;1;01;473;Signéville;90;1;91
44;Grand Est;52;1;04;474;Silvarouvres;37;0;37
44;Grand Est;52;3;08;475;Sommancourt;64;7;71
44;Grand Est;52;1;12;476;Sommerécourt;80;3;83
44;Grand Est;52;3;17;479;Sommevoire;678;18;696
44;Grand Est;52;1;01;480;Soncourt-sur-Marne;366;8;374
44;Grand Est;52;1;12;482;Soulaucourt-sur-Mouzon;97;2;99
44;Grand Est;52;2;03;483;Soyers;65;1;66
44;Grand Est;52;3;09;484;Suzannecourt;365;15;380
44;Grand Est;52;2;16;486;Ternat;63;0;63
44;Grand Est;52;3;17;487;Thilleux;72;3;75
44;Grand Est;52;1;11;488;Thivet;272;0;272
44;Grand Est;52;1;12;489;Thol-lès-Millières;34;1;35
44;Grand Est;52;3;09;490;Thonnance-lès-Joinville;697;21;718
44;Grand Est;52;3;12;491;Thonnance-les-Moulins;116;5;121
44;Grand Est;52;2;03;492;Torcenay;551;14;565
44;Grand Est;52;2;03;493;Tornay;31;0;31
44;Grand Est;52;1;05;494;Treix;226;9;235
44;Grand Est;52;3;09;495;Trémilly;85;1;86
44;Grand Est;52;3;08;497;Troisfontaines-la-Ville;434;9;443
44;Grand Est;52;2;16;499;Vaillant;43;0;43
44;Grand Est;52;2;16;189;Le Val-d'Esnoms;397;11;408
44;Grand Est;52;2;02;332;Val-de-Meuse;1846;54;1900
44;Grand Est;52;3;13;500;Valcourt;625;9;634
44;Grand Est;52;3;08;502;Valleret;64;0;64
44;Grand Est;52;2;03;503;Valleroy;24;0;24
44;Grand Est;52;2;16;094;Vals-des-Tilles;172;2;174
44;Grand Est;52;2;03;504;Varennes-sur-Amance;265;4;269
44;Grand Est;52;1;12;505;Vaudrecourt;35;0;35
44;Grand Est;52;1;04;506;Vaudrémont;100;3;103
44;Grand Est;52;3;17;510;Vaux-sur-Blaise;374;7;381
44;Grand Est;52;3;09;511;Vaux-sur-Saint-Urbain;57;2;59
44;Grand Est;52;2;16;507;Vauxbons;58;0;58
44;Grand Est;52;3;09;512;Vecqueville;520;15;535
44;Grand Est;52;2;03;513;Velles;63;1;64
44;Grand Est;52;1;07;514;Verbiesles;337;10;347
44;Grand Est;52;2;16;515;Verseilles-le-Bas;102;4;106
44;Grand Est;52;2;16;516;Verseilles-le-Haut;49;4;53
44;Grand Est;52;1;12;517;Vesaignes-sous-Lafauche;131;1;132
44;Grand Est;52;1;11;518;Vesaignes-sur-Marne;103;2;105
44;Grand Est;52;2;16;519;Vesvres-sous-Chalancey;46;0;46
44;Grand Est;52;2;02;520;Vicq;149;7;156
44;Grand Est;52;1;01;522;Viéville;339;10;349
44;Grand Est;52;1;01;523;Vignes-la-Côte;65;4;69
44;Grand Est;52;1;01;524;Vignory;236;0;236
44;Grand Est;52;1;04;525;Villars-en-Azois;67;1;68
44;Grand Est;52;2;16;526;Villars-Santenoge;80;1;81
44;Grand Est;52;3;17;528;Ville-en-Blaisois;148;1;149
44;Grand Est;52;2;16;529;Villegusien-le-Lac;996;18;1014
44;Grand Est;52;3;13;534;Villiers-en-Lieu;1513;37;1550
44;Grand Est;52;1;06;535;Villiers-le-Sec;713;11;724
44;Grand Est;52;2;16;536;Villiers-lès-Aprey;45;0;45
44;Grand Est;52;1;04;538;Villiers-sur-Suize;263;2;265
44;Grand Est;52;2;03;539;Violot;67;0;67
44;Grand Est;52;2;16;540;Vitry-en-Montagne;22;0;22
44;Grand Est;52;1;11;541;Vitry-lès-Nogent;195;4;199
44;Grand Est;52;2;16;542;Vivey;53;1;54
44;Grand Est;52;3;17;543;Voillecomte;524;10;534
44;Grand Est;52;2;02;544;Voisey;282;2;284
44;Grand Est;52;2;16;545;Voisines;107;2;109
44;Grand Est;52;2;03;546;Voncourt;15;0;15
44;Grand Est;52;1;01;547;Vouécourt;205;1;206
44;Grand Est;52;1;01;548;Vraincourt;92;2;94
44;Grand Est;52;1;12;549;Vroncourt-la-Côte;26;0;26
44;Grand Est;52;3;17;550;Wassy;2858;114;2972
52;Pays de la Loire;53;2;08;001;Ahuillé;1819;58;1877
52;Pays de la Loire;53;3;14;002;Alexain;604;9;613
52;Pays de la Loire;53;3;07;003;Ambrières-les-Vallées;2689;70;2759
52;Pays de la Loire;53;3;05;005;Andouillé;2314;49;2363
52;Pays de la Loire;53;2;02;007;Argentré;2820;75;2895
52;Pays de la Loire;53;3;09;008;Aron;1815;49;1864
52;Pays de la Loire;53;1;15;009;Arquenay;649;14;663
52;Pays de la Loire;53;3;06;010;Assé-le-Bérenger;454;13;467
52;Pays de la Loire;53;1;04;011;Astillé;875;19;894
52;Pays de la Loire;53;1;04;012;Athée;486;26;512
52;Pays de la Loire;53;3;17;013;Averton;575;16;591
52;Pays de la Loire;53;3;05;015;La Baconnière;1923;44;1967
52;Pays de la Loire;53;3;06;016;Bais;1232;14;1246
52;Pays de la Loire;53;1;04;018;Ballots;1287;32;1319
52;Pays de la Loire;53;1;15;019;Bannes;118;3;121
52;Pays de la Loire;53;3;09;021;La Bazoge-Montpinçon;1014;27;1041
52;Pays de la Loire;53;1;15;022;La Bazouge-de-Chemeré;514;10;524
52;Pays de la Loire;53;3;06;023;La Bazouge-des-Alleux;551;6;557
52;Pays de la Loire;53;1;15;025;Bazougers;1100;12;1112
52;Pays de la Loire;53;2;13;026;Beaulieu-sur-Oudon;523;9;532
52;Pays de la Loire;53;1;15;027;Beaumont-Pied-de-Bœuf;197;3;200
52;Pays de la Loire;53;3;09;028;Belgeard;600;13;613
52;Pays de la Loire;53;1;01;029;Bierné-les-Villages;1249;32;1281
52;Pays de la Loire;53;1;15;030;Le Bignon-du-Maine;331;5;336
52;Pays de la Loire;53;3;05;031;La Bigottière;498;2;500
52;Pays de la Loire;53;3;15;228;Blandouet-Saint Jean;590;15;605
52;Pays de la Loire;53;1;04;033;La Boissière;116;5;121
52;Pays de la Loire;53;2;02;034;Bonchamp-lès-Laval;6087;192;6279
52;Pays de la Loire;53;1;03;035;Bouchamps-lès-Craon;576;9;585
52;Pays de la Loire;53;1;15;036;Bouère;1077;20;1097
52;Pays de la Loire;53;1;15;037;Bouessay;732;26;758
52;Pays de la Loire;53;3;17;038;Boulay-les-Ifs;148;4;152
52;Pays de la Loire;53;2;13;039;Le Bourgneuf-la-Forêt;1757;36;1793
52;Pays de la Loire;53;2;13;040;Bourgon;633;12;645
52;Pays de la Loire;53;1;04;041;Brains-sur-les-Marches;273;5;278
52;Pays de la Loire;53;3;07;042;Brecé;834;12;846
52;Pays de la Loire;53;3;06;043;Brée;545;11;556
52;Pays de la Loire;53;2;13;045;La Brûlatte;689;18;707
52;Pays de la Loire;53;1;15;046;Le Buret;308;3;311
52;Pays de la Loire;53;3;07;047;Carelles;269;4;273
52;Pays de la Loire;53;3;05;048;Chailland;1164;34;1198
52;Pays de la Loire;53;2;02;049;Châlons-du-Maine;708;8;716
52;Pays de la Loire;53;3;09;051;Champéon;590;6;596
52;Pays de la Loire;53;3;17;052;Champfrémont;301;7;308
52;Pays de la Loire;53;3;06;053;Champgenéteux;509;21;530
52;Pays de la Loire;53;2;16;054;Changé;6128;194;6322
52;Pays de la Loire;53;3;07;055;Chantrigné;612;15;627
52;Pays de la Loire;53;2;02;056;La Chapelle-Anthenaise;998;27;1025
52;Pays de la Loire;53;3;09;057;La Chapelle-au-Riboul;504;10;514
52;Pays de la Loire;53;1;04;058;La Chapelle-Craonnaise;344;14;358
52;Pays de la Loire;53;3;15;059;La Chapelle-Rainsouin;412;6;418
52;Pays de la Loire;53;3;09;061;Charchigné;466;6;472
52;Pays de la Loire;53;1;  ;062;Château-Gontier-sur-Mayenne ;16913;663;17576
52;Pays de la Loire;53;1;01;063;Châtelain;461;14;475
52;Pays de la Loire;53;3;07;064;Châtillon-sur-Colmont;1001;24;1025
52;Pays de la Loire;53;1;01;066;Chemazé;1373;32;1405
52;Pays de la Loire;53;1;15;067;Chémeré-le-Roi;397;12;409
52;Pays de la Loire;53;1;03;068;Chérancé;159;1;160
52;Pays de la Loire;53;3;17;069;Chevaigné-du-Maine;167;5;172
52;Pays de la Loire;53;3;07;071;Colombiers-du-Plessis;485;20;505
52;Pays de la Loire;53;3;09;072;Commer;1227;28;1255
52;Pays de la Loire;53;1;04;073;Congrier;895;23;918
52;Pays de la Loire;53;3;14;074;Contest;841;35;876
52;Pays de la Loire;53;1;04;075;Cosmes;278;7;285
52;Pays de la Loire;53;1;15;076;Cossé-en-Champagne;328;10;338
52;Pays de la Loire;53;1;04;077;Cossé-le-Vivien;3170;76;3246
52;Pays de la Loire;53;1;01;078;Coudray;856;16;872
52;Pays de la Loire;53;3;07;079;Couesmes-Vaucé;374;11;385
52;Pays de la Loire;53;3;17;080;Couptrain;132;2;134
52;Pays de la Loire;53;1;04;082;Courbeveille;643;13;656
52;Pays de la Loire;53;3;17;083;Courcité;880;29;909
52;Pays de la Loire;53;1;03;084;Craon;4505;178;4683
52;Pays de la Loire;53;3;17;085;Crennes-sur-Fraubée;194;2;196
52;Pays de la Loire;53;3;05;086;La Croixille;670;12;682
52;Pays de la Loire;53;1;15;087;La Cropte;211;4;215
52;Pays de la Loire;53;1;04;088;Cuillé;852;29;881
52;Pays de la Loire;53;1;01;089;Daon;503;5;508
52;Pays de la Loire;53;1;03;090;Denazé;163;5;168
52;Pays de la Loire;53;3;07;091;Désertines;461;15;476
52;Pays de la Loire;53;3;07;093;La Dorée;276;5;281
52;Pays de la Loire;53;2;08;094;Entrammes;2268;41;2309
52;Pays de la Loire;53;3;05;096;Ernée;5712;96;5808
52;Pays de la Loire;53;3;06;097;Évron ;8607;226;8833
52;Pays de la Loire;53;1;04;098;Fontaine-Couverte;436;9;445
52;Pays de la Loire;53;2;08;099;Forcé;1095;33;1128
52;Pays de la Loire;53;3;07;100;Fougerolles-du-Plessis;1183;15;1198
52;Pays de la Loire;53;1;01;101;Fromentières;834;11;845
52;Pays de la Loire;53;1;04;102;Gastines;167;2;169
52;Pays de la Loire;53;2;13;103;Le Genest-Saint-Isle;2135;58;2193
52;Pays de la Loire;53;1;01;104;Gennes-Longuefuye ;1330;23;1353
52;Pays de la Loire;53;3;15;105;Gesnes;227;5;232
52;Pays de la Loire;53;3;17;106;Gesvres;511;11;522
52;Pays de la Loire;53;3;07;107;Gorron;2549;55;2604
52;Pays de la Loire;53;2;13;108;La Gravelle;559;6;565
52;Pays de la Loire;53;3;09;109;Grazay;619;17;636
52;Pays de la Loire;53;1;15;110;Grez-en-Bouère;1004;19;1023
52;Pays de la Loire;53;3;09;111;La Haie-Traversaine;466;14;480
52;Pays de la Loire;53;3;17;112;Le Ham;393;7;400
52;Pays de la Loire;53;3;06;113;Hambers;612;14;626
52;Pays de la Loire;53;3;09;114;Hardanges;203;2;205
52;Pays de la Loire;53;3;07;115;Hercé;313;12;325
52;Pays de la Loire;53;3;09;116;Le Horps;732;18;750
52;Pays de la Loire;53;1;01;117;Houssay;496;5;501
52;Pays de la Loire;53;3;09;118;Le Housseau-Brétignolles;238;2;240
52;Pays de la Loire;53;2;08;119;L' Huisserie;4275;154;4429
52;Pays de la Loire;53;3;06;120;Izé;457;10;467
52;Pays de la Loire;53;3;17;121;Javron-les-Chapelles;1366;29;1395
52;Pays de la Loire;53;3;09;122;Jublains;740;17;757
52;Pays de la Loire;53;3;05;123;Juvigné;1463;14;1477
52;Pays de la Loire;53;3;07;125;Landivy;1151;22;1173
52;Pays de la Loire;53;3;05;126;Larchamp;1112;16;1128
52;Pays de la Loire;53;3;09;127;Lassay-les-Châteaux;2243;58;2301
52;Pays de la Loire;53;1;04;128;Laubrières;360;4;364
52;Pays de la Loire;53;2;13;129;Launay-Villiers;384;5;389
52;Pays de la Loire;53;2;99;130;Laval;49573;2633;52206
52;Pays de la Loire;53;3;07;131;Lesbois;194;2;196
52;Pays de la Loire;53;3;07;132;Levaré;287;11;298
52;Pays de la Loire;53;3;17;133;Lignières-Orgères;724;16;740
52;Pays de la Loire;53;3;06;134;Livet;165;1;166
52;Pays de la Loire;53;1;04;135;Livré-la-Touche;740;23;763
52;Pays de la Loire;53;2;13;137;Loiron-Ruillé ;2715;62;2777
52;Pays de la Loire;53;3;17;139;Loupfougères;410;6;416
52;Pays de la Loire;53;2;02;140;Louverné;4386;96;4482
52;Pays de la Loire;53;2;08;141;Louvigné;1148;31;1179
52;Pays de la Loire;53;3;17;142;Madré;292;6;298
52;Pays de la Loire;53;1;15;143;Maisoncelles-du-Maine;517;11;528
52;Pays de la Loire;53;3;09;144;Marcillé-la-Ville;779;25;804
52;Pays de la Loire;53;1;03;145;Marigné-Peuton;548;14;562
52;Pays de la Loire;53;3;09;146;Martigné-sur-Mayenne;1895;28;1923
52;Pays de la Loire;53;3;14;147;Mayenne;12874;683;13557
52;Pays de la Loire;53;1;03;148;Mée;230;1;231
52;Pays de la Loire;53;1;01;150;Ménil;915;28;943
52;Pays de la Loire;53;1;04;151;Méral;1104;15;1119
52;Pays de la Loire;53;1;15;152;Meslay-du-Maine;2842;72;2914
52;Pays de la Loire;53;3;06;153;Mézangers;641;13;654
52;Pays de la Loire;53;3;07;154;Montaudin;914;15;929
52;Pays de la Loire;53;3;05;155;Montenay;1362;24;1386
52;Pays de la Loire;53;2;02;156;Montflours;251;8;259
52;Pays de la Loire;53;2;08;157;Montigné-le-Brillant;1300;52;1352
52;Pays de la Loire;53;2;13;158;Montjean;1039;20;1059
52;Pays de la Loire;53;3;09;160;Montreuil-Poulay;372;7;379
52;Pays de la Loire;53;3;  ;161;Montsûrs ;3181;61;3242
52;Pays de la Loire;53;3;09;162;Moulay;978;17;995
52;Pays de la Loire;53;3;06;163;Neau;777;4;781
52;Pays de la Loire;53;3;17;164;Neuilly-le-Vendin;346;8;354
52;Pays de la Loire;53;1;03;165;Niafles;353;7;360
52;Pays de la Loire;53;2;08;168;Nuillé-sur-Vicoin;1200;26;1226
52;Pays de la Loire;53;3;07;170;Oisseau;1171;25;1196
52;Pays de la Loire;53;2;13;169;Olivet;415;9;424
52;Pays de la Loire;53;1;01;172;Origné;419;9;428
52;Pays de la Loire;53;3;17;173;La Pallu;187;6;193
52;Pays de la Loire;53;3;14;174;Parigné-sur-Braye;843;23;866
52;Pays de la Loire;53;2;08;175;Parné-sur-Roc;1360;47;1407
52;Pays de la Loire;53;3;07;176;Le Pas;549;11;560
52;Pays de la Loire;53;3;05;177;La Pellerine;322;5;327
52;Pays de la Loire;53;1;03;178;Peuton;227;10;237
52;Pays de la Loire;53;3;14;179;Placé;346;8;354
52;Pays de la Loire;53;1;03;180;Pommerieux;649;28;677
52;Pays de la Loire;53;3;07;181;Pontmain;819;14;833
52;Pays de la Loire;53;2;13;182;Port-Brillet;1798;27;1825
52;Pays de la Loire;53;3;17;185;Pré-en-Pail-Saint-Samson;2311;83;2394
52;Pays de la Loire;53;1;15;184;Préaux;165;7;172
52;Pays de la Loire;53;1;03;124;Prée-d'Anjou;1407;43;1450
52;Pays de la Loire;53;1;04;186;Quelaines-Saint-Gault;2139;64;2203
52;Pays de la Loire;53;3;17;187;Ravigny;232;13;245
52;Pays de la Loire;53;1;04;188;Renazé;2537;57;2594
52;Pays de la Loire;53;3;09;189;Rennes-en-Grenouilles;106;2;108
52;Pays de la Loire;53;3;09;190;Le Ribay;463;10;473
52;Pays de la Loire;53;1;01;136;Roche-Neuville ;1175;37;1212
52;Pays de la Loire;53;1;04;191;La Roë;247;2;249
52;Pays de la Loire;53;1;04;192;La Rouaudière;323;4;327
52;Pays de la Loire;53;1;15;193;Ruillé-Froid-Fonds;568;11;579
52;Pays de la Loire;53;3;02;195;Sacé;497;8;505
52;Pays de la Loire;53;3;17;196;Saint-Aignan-de-Couptrain;366;12;378
52;Pays de la Loire;53;1;04;197;Saint-Aignan-sur-Roë;894;24;918
52;Pays de la Loire;53;3;17;198;Saint-Aubin-du-Désert;234;7;241
52;Pays de la Loire;53;3;07;199;Saint-Aubin-Fosse-Louvain;217;4;221
52;Pays de la Loire;53;3;14;200;Saint-Baudelle;1132;57;1189
52;Pays de la Loire;53;2;16;201;Saint-Berthevin;7348;249;7597
52;Pays de la Loire;53;3;07;202;Saint-Berthevin-la-Tannière;320;3;323
52;Pays de la Loire;53;1;15;203;Saint-Brice;526;13;539
52;Pays de la Loire;53;3;17;204;Saint-Calais-du-Désert;387;12;399
52;Pays de la Loire;53;1;15;206;Saint-Charles-la-Forêt;201;10;211
52;Pays de la Loire;53;3;17;208;Saint-Cyr-en-Pail;490;17;507
52;Pays de la Loire;53;2;13;209;Saint-Cyr-le-Gravelais;551;14;565
52;Pays de la Loire;53;1;01;210;Saint-Denis-d'Anjou;1550;31;1581
52;Pays de la Loire;53;3;05;211;Saint-Denis-de-Gastines;1469;34;1503
52;Pays de la Loire;53;1;15;212;Saint-Denis-du-Maine;429;9;438
52;Pays de la Loire;53;3;07;213;Saint-Ellier-du-Maine;497;8;505
52;Pays de la Loire;53;1;04;214;Saint-Erblon;169;4;173
52;Pays de la Loire;53;3;09;216;Saint-Fraimbault-de-Prières;999;27;1026
52;Pays de la Loire;53;3;14;219;Saint-Georges-Buttavent;1427;41;1468
52;Pays de la Loire;53;3;15;220;Saint-Georges-le-Fléchard;405;8;413
52;Pays de la Loire;53;3;06;221;Saint-Georges-sur-Erve;387;9;396
52;Pays de la Loire;53;3;14;222;Saint-Germain-d'Anxure;377;8;385
52;Pays de la Loire;53;3;17;223;Saint-Germain-de-Coulamer;342;10;352
52;Pays de la Loire;53;2;16;224;Saint-Germain-le-Fouilloux;1173;31;1204
52;Pays de la Loire;53;3;05;225;Saint-Germain-le-Guillaume;503;10;513
52;Pays de la Loire;53;3;05;226;Saint-Hilaire-du-Maine;848;33;881
52;Pays de la Loire;53;2;16;229;Saint-Jean-sur-Mayenne;1652;48;1700
52;Pays de la Loire;53;3;09;230;Saint-Julien-du-Terroux;229;9;238
52;Pays de la Loire;53;3;15;232;Saint-Léger;309;3;312
52;Pays de la Loire;53;1;15;233;Saint-Loup-du-Dorat;352;2;354
52;Pays de la Loire;53;3;07;234;Saint-Loup-du-Gast;367;13;380
52;Pays de la Loire;53;3;17;236;Saint-Mars-du-Désert;170;1;171
52;Pays de la Loire;53;3;07;237;Saint-Mars-sur-Colmont;462;13;475
52;Pays de la Loire;53;3;07;238;Saint-Mars-sur-la-Futaie;523;10;533
52;Pays de la Loire;53;3;06;239;Saint-Martin-de-Connée;421;6;427
52;Pays de la Loire;53;1;04;240;Saint-Martin-du-Limet;440;6;446
52;Pays de la Loire;53;1;04;242;Saint-Michel-de-la-Roë;263;3;266
52;Pays de la Loire;53;2;13;243;Saint-Ouën-des-Toits;1767;36;1803
52;Pays de la Loire;53;3;05;245;Saint-Pierre-des-Landes;915;27;942
52;Pays de la Loire;53;3;17;246;Saint-Pierre-des-Nids;1922;34;1956
52;Pays de la Loire;53;2;13;247;Saint-Pierre-la-Cour;2214;43;2257
52;Pays de la Loire;53;3;15;248;Saint-Pierre-sur-Erve;141;3;144
52;Pays de la Loire;53;3;06;249;Saint-Pierre-sur-Orthe;466;7;473
52;Pays de la Loire;53;1;04;250;Saint-Poix;406;6;412
52;Pays de la Loire;53;1;03;251;Saint-Quentin-les-Anges;449;8;457
52;Pays de la Loire;53;1;04;253;Saint-Saturnin-du-Limet;512;5;517
52;Pays de la Loire;53;3;06;256;Saint-Thomas-de-Courceriers;178;4;182
52;Pays de la Loire;53;3;06;218;Sainte-Gemmes-le-Robert;824;26;850
52;Pays de la Loire;53;3;09;235;Sainte-Marie-du-Bois;222;4;226
52;Pays de la Loire;53;3;15;255;Sainte-Suzanne-et-Chammes ;1282;31;1313
52;Pays de la Loire;53;3;15;257;Saulges;320;8;328
52;Pays de la Loire;53;1;04;258;La Selle-Craonnaise;927;29;956
52;Pays de la Loire;53;1;04;259;Senonnes;351;8;359
52;Pays de la Loire;53;1;04;260;Simplé;434;1;435
52;Pays de la Loire;53;3;07;261;Soucé;166;3;169
52;Pays de la Loire;53;2;08;262;Soulgé-sur-Ouette;1086;33;1119
52;Pays de la Loire;53;3;15;264;Thorigné-en-Charnie;195;3;198
52;Pays de la Loire;53;3;09;263;Thubœuf;286;8;294
52;Pays de la Loire;53;3;15;265;Torcé-Viviers-en-Charnie;756;15;771
52;Pays de la Loire;53;3;06;266;Trans;230;4;234
52;Pays de la Loire;53;3;15;267;Vaiges;1166;32;1198
52;Pays de la Loire;53;1;15;017;Val-du-Maine;942;27;969
52;Pays de la Loire;53;3;05;269;Vautorte;605;5;610
52;Pays de la Loire;53;3;07;270;Vieuvy;109;8;117
52;Pays de la Loire;53;3;17;271;Villaines-la-Juhel;2761;43;2804
52;Pays de la Loire;53;3;17;272;Villepail;181;1;182
52;Pays de la Loire;53;1;15;273;Villiers-Charlemagne;1104;22;1126
52;Pays de la Loire;53;3;06;274;Vimarcé;234;1;235
52;Pays de la Loire;53;3;06;276;Voutré;915;15;930
44;Grand Est;54;3;02;001;Abaucourt;299;3;302
44;Grand Est;54;1;17;002;Abbéville-lès-Conflans;229;4;233
44;Grand Est;54;4;10;003;Aboncourt;99;4;103
44;Grand Est;54;1;17;004;Affléville;179;2;181
44;Grand Est;54;3;10;005;Affracourt;109;1;110
44;Grand Est;54;3;03;006;Agincourt;438;7;445
44;Grand Est;54;4;16;007;Aingeray;531;3;534
44;Grand Est;54;4;10;008;Allain;476;14;490
44;Grand Est;54;1;04;009;Allamont;162;3;165
44;Grand Est;54;4;10;010;Allamps;503;13;516
44;Grand Est;54;1;11;011;Allondrelle-la-Malmaison;649;2;651
44;Grand Est;54;3;03;012;Amance;343;5;348
44;Grand Est;54;2;01;013;Amenoncourt;80;2;82
44;Grand Est;54;2;01;014;Ancerviller;273;14;287
44;Grand Est;54;1;17;015;Anderny;258;6;264
44;Grand Est;54;4;16;016;Andilly;287;7;294
44;Grand Est;54;2;01;017;Angomont;77;1;78
44;Grand Est;54;1;17;018;Anoux;266;7;273
44;Grand Est;54;4;16;019;Ansauville;81;1;82
44;Grand Est;54;2;08;020;Anthelupt;456;6;462
44;Grand Est;54;3;02;021;Armaucourt;232;1;233
44;Grand Est;54;4;18;022;Arnaville;564;10;574
44;Grand Est;54;2;01;023;Arracourt;250;2;252
44;Grand Est;54;3;02;024;Arraye-et-Han;360;6;366
44;Grand Est;54;3;03;025;Art-sur-Meurthe;1537;208;1745
44;Grand Est;54;2;01;026;Athienville;175;3;178
44;Grand Est;54;3;18;027;Atton;852;12;864
44;Grand Est;54;1;04;028;Auboué;2566;19;2585
44;Grand Est;54;1;17;029;Audun-le-Roman;2467;48;2515
44;Grand Est;54;2;01;030;Autrepierre;83;0;83
44;Grand Est;54;3;02;031;Autreville-sur-Moselle;272;5;277
44;Grand Est;54;3;10;032;Autrey;187;4;191
44;Grand Est;54;1;17;033;Avillers;125;0;125
44;Grand Est;54;4;16;034;Avrainville;217;10;227
44;Grand Est;54;2;01;035;Avricourt;386;3;389
44;Grand Est;54;1;17;036;Avril;1150;17;1167
44;Grand Est;54;3;05;037;Azelot;421;2;423
44;Grand Est;54;2;01;038;Azerailles;760;18;778
44;Grand Est;54;2;01;039;Baccarat;4225;61;4286
44;Grand Est;54;2;01;040;Badonviller;1548;32;1580
44;Grand Est;54;4;10;041;Bagneux;153;7;160
44;Grand Est;54;3;10;042;Bainville-aux-Miroirs;290;2;292
44;Grand Est;54;3;15;043;Bainville-sur-Madon;1411;17;1428
44;Grand Est;54;2;01;044;Barbas;193;2;195
44;Grand Est;54;2;09;045;Barbonville;435;7;442
44;Grand Est;54;4;10;046;Barisey-au-Plain;396;8;404
44;Grand Est;54;4;10;047;Barisey-la-Côte;237;6;243
44;Grand Est;54;1;17;048;Les Baroches;352;15;367
44;Grand Est;54;1;11;049;Baslieux;560;15;575
44;Grand Est;54;2;01;050;Bathelémont;65;1;66
44;Grand Est;54;1;04;051;Batilly;1277;21;1298
44;Grand Est;54;4;10;052;Battigny;147;2;149
44;Grand Est;54;2;08;053;Bauzemont;154;6;160
44;Grand Est;54;2;09;054;Bayon;1583;19;1602
44;Grand Est;54;4;18;055;Bayonville-sur-Mad;311;5;316
44;Grand Est;54;1;11;056;Bazailles;141;2;143
44;Grand Est;54;4;16;057;Beaumont;74;0;74
44;Grand Est;54;1;17;058;Béchamps;87;2;89
44;Grand Est;54;3;02;059;Belleau;750;10;760
44;Grand Est;54;3;02;060;Belleville;1465;16;1481
44;Grand Est;54;2;01;061;Bénaménil;586;11;597
44;Grand Est;54;3;10;062;Benney;649;10;659
44;Grand Est;54;4;16;063;Bernécourt;176;4;180
44;Grand Est;54;2;01;064;Bertrambois;311;6;317
44;Grand Est;54;2;01;065;Bertrichamps;1094;23;1117
44;Grand Est;54;1;17;066;Bettainvillers;401;2;403
44;Grand Est;54;1;11;067;Beuveille;759;11;770
44;Grand Est;54;4;10;068;Beuvezin;94;2;96
44;Grand Est;54;1;17;069;Beuvillers;429;8;437
44;Grand Est;54;3;02;070;Bey-sur-Seille;174;0;174
44;Grand Est;54;2;01;071;Bezange-la-Grande;157;1;158
44;Grand Est;54;3;02;072;Bezaumont;263;5;268
44;Grand Est;54;4;20;073;Bicqueley;910;15;925
44;Grand Est;54;2;08;074;Bienville-la-Petite;36;0;36
44;Grand Est;54;2;01;075;Bionville;117;2;119
44;Grand Est;54;2;09;076;Blainville-sur-l'Eau;4006;47;4053
44;Grand Est;54;2;01;077;Blâmont;1070;12;1082
44;Grand Est;54;2;01;078;Blémerey;59;1;60
44;Grand Est;54;3;18;079;Blénod-lès-Pont-à-Mousson;4613;31;4644
44;Grand Est;54;4;10;080;Blénod-lès-Toul;1062;19;1081
44;Grand Est;54;4;16;557;Bois-de-Haye ;2280;99;2379
44;Grand Est;54;1;11;081;Boismont;418;6;424
44;Grand Est;54;1;04;082;Boncourt;172;3;175
44;Grand Est;54;2;08;083;Bonviller;180;3;183
44;Grand Est;54;2;09;085;Borville;93;2;95
44;Grand Est;54;4;16;086;Boucq;355;11;366
44;Grand Est;54;4;16;087;Bouillonville;154;1;155
44;Grand Est;54;4;16;088;Bouvron;238;1;239
44;Grand Est;54;3;03;089;Bouxières-aux-Chênes;1426;20;1446
44;Grand Est;54;3;02;090;Bouxières-aux-Dames;4193;41;4234
44;Grand Est;54;3;18;091;Bouxières-sous-Froidmont;368;4;372
44;Grand Est;54;3;10;092;Bouzanville;63;1;64
44;Grand Est;54;1;04;093;Brainville;164;2;166
44;Grand Est;54;3;10;094;Bralleville;174;3;177
44;Grand Est;54;3;02;095;Bratte;45;0;45
44;Grand Est;54;1;23;096;Bréhain-la-Ville;420;9;429
44;Grand Est;54;2;01;097;Bréménil;105;3;108
44;Grand Est;54;2;09;098;Brémoncourt;167;3;170
44;Grand Est;54;3;02;100;Brin-sur-Seille;775;12;787
44;Grand Est;54;2;01;101;Brouville;131;1;132
44;Grand Est;54;4;16;102;Bruley;610;15;625
44;Grand Est;54;1;04;103;Bruville;226;5;231
44;Grand Est;54;3;03;104;Buissoncourt;261;2;263
44;Grand Est;54;4;10;105;Bulligny;531;15;546
44;Grand Est;54;2;01;106;Bures;61;2;63
44;Grand Est;54;2;01;107;Buriville;74;3;77
44;Grand Est;54;3;05;108;Burthecourt-aux-Chênes;122;4;126
44;Grand Est;54;3;10;109;Ceintrey;930;12;942
44;Grand Est;54;3;03;110;Cerville;564;12;576
44;Grand Est;54;3;15;111;Chaligny;2848;19;2867
44;Grand Est;54;1;04;112;Chambley-Bussières;701;9;710
44;Grand Est;54;3;03;113;Champenoux;1469;15;1484
44;Grand Est;54;3;18;114;Champey-sur-Moselle;337;5;342
44;Grand Est;54;3;21;115;Champigneulles;6708;65;6773
44;Grand Est;54;2;09;116;Chanteheux;2149;43;2192
44;Grand Est;54;3;10;117;Chaouilley;114;3;117
44;Grand Est;54;1;11;118;Charency-Vezin;598;10;608
44;Grand Est;54;4;16;119;Charey;86;3;89
44;Grand Est;54;4;20;120;Charmes-la-Côte;332;8;340
44;Grand Est;54;2;09;121;Charmois;189;3;192
44;Grand Est;54;4;20;122;Chaudeney-sur-Moselle;719;17;736
44;Grand Est;54;3;15;123;Chavigny;1791;10;1801
44;Grand Est;54;2;01;124;Chazelles-sur-Albe;45;3;48
44;Grand Est;54;2;01;125;Chenevières;493;8;501
44;Grand Est;54;3;02;126;Chenicourt;224;1;225
44;Grand Est;54;1;07;127;Chenières;629;19;648
44;Grand Est;54;4;20;128;Choloy-Ménillot;727;7;734
44;Grand Est;54;2;01;129;Cirey-sur-Vezouze;1627;25;1652
44;Grand Est;54;2;09;130;Clayeures;184;1;185
44;Grand Est;54;3;02;131;Clémery;495;10;505
44;Grand Est;54;3;10;132;Clérey-sur-Brenon;63;2;65
44;Grand Est;54;2;01;133;Coincourt;122;4;126
44;Grand Est;54;1;11;134;Colmey;245;7;252
44;Grand Est;54;4;10;135;Colombey-les-Belles;1454;20;1474
44;Grand Est;54;1;04;136;Conflans-en-Jarnisy;2361;33;2394
44;Grand Est;54;1;11;137;Cons-la-Grandville;517;17;534
44;Grand Est;54;1;11;138;Cosnes-et-Romain;2716;56;2772
44;Grand Est;54;2;08;139;Courbesseaux;357;2;359
44;Grand Est;54;4;10;140;Courcelles;100;0;100
44;Grand Est;54;3;05;141;Coyviller;145;2;147
44;Grand Est;54;3;10;142;Crantenoy;156;2;158
44;Grand Est;54;4;10;143;Crépey;397;7;404
44;Grand Est;54;3;10;144;Crévéchamps;396;3;399
44;Grand Est;54;2;08;145;Crévic;925;12;937
44;Grand Est;54;4;10;146;Crézilles;288;3;291
44;Grand Est;54;2;08;147;Crion;100;2;102
44;Grand Est;54;2;08;148;Croismare;647;8;655
44;Grand Est;54;1;23;149;Crusnes;1574;12;1586
44;Grand Est;54;3;02;150;Custines;3074;28;3102
44;Grand Est;54;1;07;151;Cutry;1038;28;1066
44;Grand Est;54;2;09;152;Damelevières;3186;45;3231
44;Grand Est;54;1;04;153;Dampvitoux;57;0;57
44;Grand Est;54;2;01;154;Deneuvre;507;21;528
44;Grand Est;54;2;08;155;Deuxville;416;7;423
44;Grand Est;54;3;10;156;Diarville;521;17;538
44;Grand Est;54;3;02;157;Dieulouard;4760;45;4805
44;Grand Est;54;4;10;158;Dolcourt;131;2;133
44;Grand Est;54;3;08;159;Dombasle-sur-Meurthe;9694;190;9884
44;Grand Est;54;4;16;160;Domèvre-en-Haye;394;9;403
44;Grand Est;54;2;01;161;Domèvre-sur-Vezouze;304;10;314
44;Grand Est;54;4;20;162;Domgermain;1173;14;1187
44;Grand Est;54;2;01;163;Domjevin;258;2;260
44;Grand Est;54;3;10;164;Dommarie-Eulmont;87;2;89
44;Grand Est;54;3;19;165;Dommartemont;580;29;609
44;Grand Est;54;4;16;166;Dommartin-la-Chaussée;33;2;35
44;Grand Est;54;4;20;167;Dommartin-lès-Toul;1962;37;1999
44;Grand Est;54;3;03;168;Dommartin-sous-Amance;285;2;287
44;Grand Est;54;1;17;169;Domprix;90;3;93
44;Grand Est;54;2;09;170;Domptail-en-l'Air;71;1;72
44;Grand Est;54;1;04;171;Doncourt-lès-Conflans;1171;21;1192
44;Grand Est;54;1;11;172;Doncourt-lès-Longuyon;293;7;300
44;Grand Est;54;2;08;173;Drouville;207;4;211
44;Grand Est;54;4;20;174;Écrouves;4402;52;4454
44;Grand Est;54;2;09;175;Einvaux;364;3;367
44;Grand Est;54;2;08;176;Einville-au-Jard;1149;22;1171
44;Grand Est;54;2;01;177;Emberménil;258;3;261
44;Grand Est;54;1;11;178;Épiez-sur-Chiers;187;3;190
44;Grand Est;54;3;02;179;Éply;301;4;305
44;Grand Est;54;3;03;180;Erbéviller-sur-Amezule;74;2;76
44;Grand Est;54;1;23;181;Errouville;706;17;723
44;Grand Est;54;4;16;182;Essey-et-Maizerais;340;10;350
44;Grand Est;54;2;09;183;Essey-la-Côte;80;0;80
44;Grand Est;54;3;19;184;Essey-lès-Nancy;8825;181;9006
44;Grand Est;54;3;10;185;Étreval;60;1;61
44;Grand Est;54;3;03;186;Eulmont;1095;20;1115
44;Grand Est;54;4;16;187;Euvezin;112;1;113
44;Grand Est;54;3;02;188;Faulx;1355;10;1365
44;Grand Est;54;4;10;189;Favières;594;8;602
44;Grand Est;54;4;10;190;Fécocourt;110;3;113
44;Grand Est;54;2;01;191;Fenneviller;98;2;100
44;Grand Est;54;3;09;192;Ferrières;293;4;297
44;Grand Est;54;3;18;193;Fey-en-Haye;77;1;78
44;Grand Est;54;1;23;194;Fillières;511;9;520
44;Grand Est;54;2;08;195;Flainval;203;0;203
44;Grand Est;54;3;15;196;Flavigny-sur-Moselle;1748;134;1882
44;Grand Est;54;3;05;197;Fléville-devant-Nancy;2238;25;2263
44;Grand Est;54;1;17;198;Fléville-Lixières;314;5;319
44;Grand Est;54;2;01;199;Flin;380;11;391
44;Grand Est;54;4;16;200;Flirey;154;1;155
44;Grand Est;54;2;01;201;Fontenoy-la-Joûte;312;3;315
44;Grand Est;54;4;16;202;Fontenoy-sur-Moselle;376;4;380
44;Grand Est;54;3;10;203;Forcelles-Saint-Gorgon;141;3;144
44;Grand Est;54;3;10;204;Forcelles-sous-Gugney;93;2;95
44;Grand Est;54;4;20;205;Foug;2638;30;2668
44;Grand Est;54;2;09;206;Fraimbois;386;5;391
44;Grand Est;54;3;10;207;Fraisnes-en-Saintois;102;2;104
44;Grand Est;54;4;16;208;Francheville;284;2;286
44;Grand Est;54;2;09;209;Franconville;78;0;78
44;Grand Est;54;2;01;210;Fréménil;211;4;215
44;Grand Est;54;2;01;211;Frémonville;189;2;191
44;Grand Est;54;1;11;212;Fresnois-la-Montagne;407;13;420
44;Grand Est;54;1;04;213;Friauville;367;5;372
44;Grand Est;54;3;15;214;Frolois;703;6;709
44;Grand Est;54;3;21;215;Frouard;6566;77;6643
44;Grand Est;54;2;09;216;Froville;126;0;126
44;Grand Est;54;2;01;217;Gélacourt;168;2;170
44;Grand Est;54;4;10;218;Gélaucourt;63;1;64
44;Grand Est;54;3;03;219;Gellenoncourt;78;0;78
44;Grand Est;54;4;10;220;Gémonville;77;0;77
44;Grand Est;54;3;10;221;Gerbécourt-et-Haplemont;234;1;235
44;Grand Est;54;2;09;222;Gerbéviller;1336;23;1359
44;Grand Est;54;4;10;223;Germiny;218;7;225
44;Grand Est;54;3;10;224;Germonville;120;1;121
44;Grand Est;54;4;16;225;Gézoncourt;178;3;181
44;Grand Est;54;4;10;226;Gibeaumeix;167;3;170
44;Grand Est;54;1;04;227;Giraumont;1336;17;1353
44;Grand Est;54;2;09;228;Giriviller;70;3;73
44;Grand Est;54;2;01;229;Glonville;364;5;369
44;Grand Est;54;2;01;230;Gogney;48;0;48
44;Grand Est;54;1;17;231;Gondrecourt-Aix;176;3;179
44;Grand Est;54;4;16;232;Gondreville;2752;50;2802
44;Grand Est;54;2;01;233;Gondrexon;40;2;42
44;Grand Est;54;1;11;234;Gorcy;2817;44;2861
44;Grand Est;54;3;10;235;Goviller;423;9;432
44;Grand Est;54;1;11;236;Grand-Failly;347;8;355
44;Grand Est;54;4;10;237;Grimonviller;88;3;91
44;Grand Est;54;3;10;238;Gripport;278;1;279
44;Grand Est;54;4;16;239;Griscourt;133;2;135
44;Grand Est;54;4;16;240;Grosrouvres;60;0;60
44;Grand Est;54;3;10;241;Gugney;76;3;79
44;Grand Est;54;4;20;242;Gye;264;4;268
44;Grand Est;54;2;01;243;Hablainville;216;7;223
44;Grand Est;54;1;04;244;Hagéville;112;3;115
44;Grand Est;54;2;09;245;Haigneville;60;0;60
44;Grand Est;54;2;01;246;Halloville;68;6;74
44;Grand Est;54;3;10;247;Hammeville;178;4;182
44;Grand Est;54;4;16;248;Hamonville;99;0;99
44;Grand Est;54;1;11;602;Han-devant-Pierrepont;149;0;149
44;Grand Est;54;1;04;249;Hannonville-Suzémont;257;4;261
44;Grand Est;54;3;03;250;Haraucourt;735;6;741
44;Grand Est;54;2;01;251;Harbouey;122;1;123
44;Grand Est;54;3;10;252;Haroué;508;6;514
44;Grand Est;54;1;04;253;Hatrize;767;12;779
44;Grand Est;54;1;07;254;Haucourt-Moulaine;3318;42;3360
44;Grand Est;54;2;09;255;Haudonville;87;6;93
44;Grand Est;54;2;09;256;Haussonville;303;8;311
44;Grand Est;54;3;05;257;Heillecourt;5473;84;5557
44;Grand Est;54;2;08;258;Hénaménil;146;3;149
44;Grand Est;54;2;01;259;Herbéviller;239;2;241
44;Grand Est;54;2;09;260;Hériménil;954;18;972
44;Grand Est;54;1;07;261;Herserange;4394;46;4440
44;Grand Est;54;2;08;262;Hoéville;198;0;198
44;Grand Est;54;1;04;263;Homécourt;6248;55;6303
44;Grand Est;54;3;10;264;Houdelmont;248;0;248
44;Grand Est;54;3;05;265;Houdemont;2102;44;2146
44;Grand Est;54;3;10;266;Houdreville;411;10;421
44;Grand Est;54;3;10;268;Housséville;150;4;154
44;Grand Est;54;2;08;269;Hudiviller;358;5;363
44;Grand Est;54;1;23;270;Hussigny-Godbrange;3632;64;3696
44;Grand Est;54;2;01;271;Igney;123;6;129
44;Grand Est;54;4;16;272;Jaillon;473;3;476
44;Grand Est;54;1;04;273;Jarny;8245;186;8431
44;Grand Est;54;3;05;274;Jarville-la-Malgrange;9312;244;9556
44;Grand Est;54;4;16;275;Jaulny;196;6;202
44;Grand Est;54;3;02;276;Jeandelaincourt;803;7;810
44;Grand Est;54;1;04;277;Jeandelize;373;2;375
44;Grand Est;54;3;10;278;Jevoncourt;99;1;100
44;Grand Est;54;3;18;279;Jezainville;971;21;992
44;Grand Est;54;2;08;281;Jolivet;899;18;917
44;Grand Est;54;1;17;282;Joppécourt;160;4;164
44;Grand Est;54;1;04;283;Jouaville;293;9;302
44;Grand Est;54;1;17;284;Joudreville;1154;21;1175
44;Grand Est;54;2;01;285;Juvrecourt;57;1;58
44;Grand Est;54;1;17;280;Jœuf;6559;53;6612
44;Grand Est;54;1;04;286;Labry;1582;30;1612
44;Grand Est;54;2;01;287;Lachapelle;263;1;264
44;Grand Est;54;4;16;288;Lagney;502;5;507
44;Grand Est;54;3;03;289;Laître-sous-Amance;381;10;391
44;Grand Est;54;1;23;290;Laix;209;3;212
44;Grand Est;54;3;10;291;Lalœuf;290;2;292
44;Grand Est;54;2;09;292;Lamath;195;3;198
44;Grand Est;54;2;09;293;Landécourt;87;4;91
44;Grand Est;54;3;02;294;Landremont;147;1;148
44;Grand Est;54;1;17;295;Landres;972;111;1083
44;Grand Est;54;3;03;296;Laneuvelotte;435;4;439
44;Grand Est;54;2;01;297;Laneuveville-aux-Bois;314;3;317
44;Grand Est;54;4;20;298;Laneuveville-derrière-Foug;151;2;153
44;Grand Est;54;3;10;299;Laneuveville-devant-Bayon;226;6;232
44;Grand Est;54;3;03;300;Laneuveville-devant-Nancy;6538;109;6647
44;Grand Est;54;3;02;301;Lanfroicourt;129;1;130
44;Grand Est;54;1;17;302;Lantéfontaine;756;18;774
44;Grand Est;54;2;01;303;Laronxe;370;3;373
44;Grand Est;54;3;06;304;Laxou;14300;195;14495
44;Grand Est;54;3;02;305;Lay-Saint-Christophe;2421;49;2470
44;Grand Est;54;4;20;306;Lay-Saint-Remy;347;5;352
44;Grand Est;54;3;10;307;Lebeuville;176;4;180
44;Grand Est;54;2;01;308;Leintrey;145;3;148
44;Grand Est;54;3;10;309;Lemainville;377;3;380
44;Grand Est;54;3;10;310;Leménil-Mitry;3;0;3
44;Grand Est;54;3;03;311;Lenoncourt;590;8;598
44;Grand Est;54;3;18;312;Lesménils;489;10;499
44;Grand Est;54;3;02;313;Létricourt;232;1;233
44;Grand Est;54;1;07;314;Lexy;3784;65;3849
44;Grand Est;54;3;02;315;Leyr;913;6;919
44;Grand Est;54;4;16;316;Limey-Remenauville;289;5;294
44;Grand Est;54;4;16;317;Lironville;130;5;135
44;Grand Est;54;4;16;318;Liverdun;5976;74;6050
44;Grand Est;54;3;18;320;Loisy;325;4;329
44;Grand Est;54;1;23;321;Longlaville;2363;28;2391
44;Grand Est;54;1;11;322;Longuyon;5269;63;5332
44;Grand Est;54;1;07;323;Longwy;14730;273;15003
44;Grand Est;54;2;09;324;Lorey;91;1;92
44;Grand Est;54;2;09;325;Loromontzey;84;8;92
44;Grand Est;54;1;17;326;Lubey;225;10;235
44;Grand Est;54;4;16;327;Lucey;631;15;646
44;Grand Est;54;3;05;328;Ludres;6134;89;6223
44;Grand Est;54;2;98;329;Lunéville;18027;344;18371
44;Grand Est;54;3;05;330;Lupcourt;438;9;447
44;Grand Est;54;2;09;331;Magnières;281;6;287
44;Grand Est;54;3;18;332;Maidières;1546;24;1570
44;Grand Est;54;3;02;333;Mailly-sur-Seille;246;14;260
44;Grand Est;54;1;17;334;Mairy-Mainville;565;11;576
44;Grand Est;54;2;08;335;Maixe;412;4;416
44;Grand Est;54;3;15;336;Maizières;939;11;950
44;Grand Est;54;1;17;337;Malavillers;129;3;132
44;Grand Est;54;3;02;338;Malleloy;980;14;994
44;Grand Est;54;3;19;339;Malzéville;8123;269;8392
44;Grand Est;54;4;16;340;Mamey;341;5;346
44;Grand Est;54;4;16;343;Mandres-aux-Quatre-Tours;186;5;191
44;Grand Est;54;3;10;344;Mangonville;222;4;226
44;Grand Est;54;3;05;345;Manoncourt-en-Vermois;343;5;348
44;Grand Est;54;4;16;346;Manoncourt-en-Woëvre;244;4;248
44;Grand Est;54;4;16;348;Manonville;238;8;246
44;Grand Est;54;2;01;349;Manonviller;164;2;166
44;Grand Est;54;2;01;350;Marainviller;697;8;705
44;Grand Est;54;3;21;351;Marbache;1694;15;1709
44;Grand Est;54;3;15;352;Maron;828;9;837
44;Grand Est;54;1;04;353;Mars-la-Tour;944;17;961
44;Grand Est;54;3;10;354;Marthemont;44;0;44
44;Grand Est;54;4;16;355;Martincourt;95;2;97
44;Grand Est;54;2;09;356;Mattexey;67;2;69
44;Grand Est;54;3;21;357;Maxéville;9740;119;9859
44;Grand Est;54;3;03;358;Mazerulles;274;5;279
44;Grand Est;54;2;09;359;Méhoncourt;243;3;246
44;Grand Est;54;4;16;360;Ménil-la-Tour;336;8;344
44;Grand Est;54;1;17;362;Mercy-le-Bas;1281;7;1288
44;Grand Est;54;1;17;363;Mercy-le-Haut;271;6;277
44;Grand Est;54;3;15;364;Méréville;1317;19;1336
44;Grand Est;54;2;01;365;Merviller;330;9;339
44;Grand Est;54;3;15;366;Messein;1929;20;1949
44;Grand Est;54;1;07;367;Mexy;2292;68;2360
44;Grand Est;54;2;01;368;Mignéville;181;3;184
44;Grand Est;54;3;02;369;Millery;615;7;622
44;Grand Est;54;4;16;370;Minorville;230;1;231
44;Grand Est;54;1;04;371;Moineville;1072;20;1092
44;Grand Est;54;3;02;372;Moivrons;506;2;508
44;Grand Est;54;2;09;373;Moncel-lès-Lunéville;622;5;627
44;Grand Est;54;3;03;374;Moncel-sur-Seille;518;9;527
44;Grand Est;54;1;17;084;Mont-Bonvillers;946;14;960
44;Grand Est;54;4;10;379;Mont-l'Étroit;94;0;94
44;Grand Est;54;4;10;380;Mont-le-Vignoble;416;10;426
44;Grand Est;54;1;11;382;Mont-Saint-Martin;8953;113;9066
44;Grand Est;54;2;09;383;Mont-sur-Meurthe;1116;11;1127
44;Grand Est;54;3;18;375;Montauville;1068;17;1085
44;Grand Est;54;3;02;376;Montenoy;411;7;418
44;Grand Est;54;2;01;377;Montigny;157;0;157
44;Grand Est;54;1;11;378;Montigny-sur-Chiers;474;8;482
44;Grand Est;54;2;01;381;Montreux;58;2;60
44;Grand Est;54;1;23;385;Morfontaine;1088;25;1113
44;Grand Est;54;2;09;386;Moriviller;93;1;94
44;Grand Est;54;3;02;387;Morville-sur-Seille;149;0;149
44;Grand Est;54;2;01;388;Mouacourt;73;2;75
44;Grand Est;54;1;17;389;Mouaville;99;2;101
44;Grand Est;54;3;18;390;Mousson;102;3;105
44;Grand Est;54;1;04;391;Moutiers;1565;23;1588
44;Grand Est;54;4;10;392;Moutrot;309;2;311
44;Grand Est;54;2;09;393;Moyen;543;6;549
44;Grand Est;54;1;17;394;Murville;246;6;252
44;Grand Est;54;3;99;395;Nancy;104885;1445;106330
44;Grand Est;54;2;01;396;Neufmaisons;231;8;239
44;Grand Est;54;3;15;397;Neuves-Maisons;6653;55;6708
44;Grand Est;54;2;01;398;Neuviller-lès-Badonviller;96;2;98
44;Grand Est;54;3;10;399;Neuviller-sur-Moselle;246;1;247
44;Grand Est;54;3;02;400;Nomeny;1156;22;1178
44;Grand Est;54;2;01;401;Nonhigny;125;5;130
44;Grand Est;54;1;17;402;Norroy-le-Sec;415;11;426
44;Grand Est;54;3;18;403;Norroy-lès-Pont-à-Mousson;1192;34;1226
44;Grand Est;54;4;16;404;Noviant-aux-Prés;261;5;266
44;Grand Est;54;4;10;405;Ochey;520;0;520
44;Grand Est;54;2;01;406;Ogéviller;281;7;288
44;Grand Est;54;3;10;407;Ognéville;97;3;100
44;Grand Est;54;1;04;408;Olley;235;3;238
44;Grand Est;54;3;10;409;Omelmont;189;0;189
44;Grand Est;54;1;18;410;Onville;519;2;521
44;Grand Est;54;3;10;411;Ormes-et-Ville;222;2;224
44;Grand Est;54;1;11;412;Othe;34;3;37
44;Grand Est;54;1;17;413;Ozerailles;151;1;152
44;Grand Est;54;4;20;414;Pagney-derrière-Barine;628;8;636
44;Grand Est;54;3;18;415;Pagny-sur-Moselle;4126;51;4177
44;Grand Est;54;4;16;416;Pannes;182;3;185
44;Grand Est;54;3;10;417;Parey-Saint-Césaire;242;7;249
44;Grand Est;54;2;01;418;Parroy;166;1;167
44;Grand Est;54;2;01;419;Parux;72;0;72
44;Grand Est;54;1;11;420;Petit-Failly;86;1;87
44;Grand Est;54;2;01;421;Petitmont;319;4;323
44;Grand Est;54;2;01;422;Pettonville;69;0;69
44;Grand Est;54;2;01;423;Pexonne;356;11;367
44;Grand Est;54;3;02;424;Phlin;43;1;44
44;Grand Est;54;1;17;425;Piennes;2518;28;2546
44;Grand Est;54;4;20;426;Pierre-la-Treiche;486;6;492
44;Grand Est;54;2;01;427;Pierre-Percée;93;1;94
44;Grand Est;54;1;11;428;Pierrepont;865;9;874
44;Grand Est;54;3;10;429;Pierreville;303;2;305
44;Grand Est;54;3;21;430;Pompey;4871;56;4927
44;Grand Est;54;3;18;431;Pont-à-Mousson;14434;188;14622
44;Grand Est;54;3;15;432;Pont-Saint-Vincent;1876;37;1913
44;Grand Est;54;3;02;433;Port-sur-Seille;230;7;237
44;Grand Est;54;3;10;434;Praye;260;2;262
44;Grand Est;54;3;18;435;Prény;358;4;362
44;Grand Est;54;1;17;436;Preutin-Higny;140;4;144
44;Grand Est;54;3;15;437;Pulligny;1155;20;1175
44;Grand Est;54;4;10;438;Pulney;57;0;57
44;Grand Est;54;3;03;439;Pulnoy;5020;61;5081
44;Grand Est;54;1;04;440;Puxe;121;0;121
44;Grand Est;54;1;04;441;Puxieux;242;5;247
44;Grand Est;54;3;10;442;Quevilloncourt;97;2;99
44;Grand Est;54;2;01;443;Raon-lès-Leau;37;0;37
44;Grand Est;54;3;02;444;Raucourt;220;2;222
44;Grand Est;54;2;08;445;Raville-sur-Sânon;103;0;103
44;Grand Est;54;2;01;446;Réchicourt-la-Petite;63;2;65
44;Grand Est;54;2;01;447;Réclonville;76;1;77
44;Grand Est;54;2;09;449;Rehainviller;1048;15;1063
44;Grand Est;54;2;01;450;Reherrey;133;1;134
44;Grand Est;54;1;07;451;Réhon;3819;77;3896
44;Grand Est;54;2;01;452;Reillon;82;2;84
44;Grand Est;54;4;16;453;Rembercourt-sur-Mad;160;1;161
44;Grand Est;54;2;09;455;Remenoville;160;4;164
44;Grand Est;54;3;03;456;Réméréville;573;8;581
44;Grand Est;54;2;01;457;Remoncourt;46;0;46
44;Grand Est;54;2;01;458;Repaix;101;1;102
44;Grand Est;54;3;15;459;Richardménil;2354;25;2379
44;Grand Est;54;4;16;460;Rogéville;166;3;169
44;Grand Est;54;2;09;461;Romain;68;2;70
44;Grand Est;54;3;09;462;Rosières-aux-Salines;2856;28;2884
44;Grand Est;54;4;16;463;Rosières-en-Haye;238;2;240
44;Grand Est;54;3;02;464;Rouves;103;0;103
44;Grand Est;54;3;10;465;Roville-devant-Bayon;777;11;788
44;Grand Est;54;4;16;466;Royaumeix;381;5;386
44;Grand Est;54;2;09;467;Rozelieures;191;5;196
44;Grand Est;54;3;09;468;Saffais;114;2;116
44;Grand Est;54;1;04;469;Saint-Ail;410;5;415
44;Grand Est;54;4;16;470;Saint-Baussant;74;2;76
44;Grand Est;54;2;09;471;Saint-Boingt;70;3;73
44;Grand Est;54;2;01;472;Saint-Clément;860;16;876
44;Grand Est;54;3;10;473;Saint-Firmin;276;6;282
44;Grand Est;54;2;09;475;Saint-Germain;157;6;163
44;Grand Est;54;1;11;476;Saint-Jean-lès-Longuyon;418;11;429
44;Grand Est;54;1;04;477;Saint-Julien-lès-Gorze;161;3;164
44;Grand Est;54;1;04;478;Saint-Marcel;148;1;149
44;Grand Est;54;2;09;479;Saint-Mard;91;1;92
44;Grand Est;54;2;01;480;Saint-Martin;58;1;59
44;Grand Est;54;2;01;481;Saint-Maurice-aux-Forges;98;3;101
44;Grand Est;54;3;19;482;Saint-Max;9984;109;10093
44;Grand Est;54;3;05;483;Saint-Nicolas-de-Port;7466;73;7539
44;Grand Est;54;1;11;485;Saint-Pancré;312;6;318
44;Grand Est;54;3;10;486;Saint-Remimont;352;5;357
44;Grand Est;54;2;09;487;Saint-Rémy-aux-Bois;66;0;66
44;Grand Est;54;2;01;488;Saint-Sauveur;37;0;37
44;Grand Est;54;1;11;489;Saint-Supplet;143;4;147
44;Grand Est;54;3;02;474;Sainte-Geneviève;190;0;190
44;Grand Est;54;2;01;484;Sainte-Pôle;187;3;190
44;Grand Est;54;3;16;490;Saizerais;1489;23;1512
44;Grand Est;54;1;17;491;Sancy;318;7;325
44;Grand Est;54;4;16;492;Sanzey;150;2;152
44;Grand Est;54;1;23;493;Saulnes;2410;40;2450
44;Grand Est;54;4;10;494;Saulxerotte;104;0;104
44;Grand Est;54;3;03;495;Saulxures-lès-Nancy;4171;59;4230
44;Grand Est;54;4;10;496;Saulxures-lès-Vannes;371;4;375
44;Grand Est;54;3;10;497;Saxon-Sion;107;3;110
44;Grand Est;54;3;03;498;Seichamps;5030;65;5095
44;Grand Est;54;4;16;499;Seicheprey;112;4;116
44;Grand Est;54;4;10;500;Selaincourt;184;3;187
44;Grand Est;54;2;09;501;Seranville;102;0;102
44;Grand Est;54;2;08;502;Serres;244;1;245
44;Grand Est;54;1;23;504;Serrouville;674;16;690
44;Grand Est;54;4;15;505;Sexey-aux-Forges;713;8;721
44;Grand Est;54;2;08;507;Sionviller;103;2;105
44;Grand Est;54;3;02;508;Sivry;251;4;255
44;Grand Est;54;2;08;509;Sommerviller;994;4;998
44;Grand Est;54;3;03;510;Sornéville;319;6;325
44;Grand Est;54;1;04;511;Sponville;117;4;121
44;Grand Est;54;2;01;512;Tanconville;110;2;112
44;Grand Est;54;3;10;513;Tantonville;644;4;648
44;Grand Est;54;1;11;514;Tellancourt;581;14;595
44;Grand Est;54;3;10;515;Thélod;252;0;252
44;Grand Est;54;3;10;516;They-sous-Vaudemont;16;1;17
44;Grand Est;54;3;02;517;Thézey-Saint-Martin;204;2;206
44;Grand Est;54;4;16;518;Thiaucourt-Regniéville;1121;10;1131
44;Grand Est;54;2;01;519;Thiaville-sur-Meurthe;580;8;588
44;Grand Est;54;2;01;520;Thiébauménil;382;9;391
44;Grand Est;54;1;23;521;Thil;1914;30;1944
44;Grand Est;54;3;10;522;Thorey-Lyautey;143;3;146
44;Grand Est;54;4;10;523;Thuilley-aux-Groseilles;422;2;424
44;Grand Est;54;1;17;524;Thumeréville;78;2;80
44;Grand Est;54;1;23;525;Tiercelet;657;12;669
44;Grand Est;54;3;19;526;Tomblaine;8872;283;9155
44;Grand Est;54;3;09;527;Tonnoy;685;26;711
44;Grand Est;54;4;20;528;Toul;15470;264;15734
44;Grand Est;54;4;10;529;Tramont-Émy;29;0;29
44;Grand Est;54;4;10;530;Tramont-Lassus;87;2;89
44;Grand Est;54;4;10;531;Tramont-Saint-André;56;1;57
44;Grand Est;54;4;16;532;Tremblecourt;169;3;172
44;Grand Est;54;1;17;533;Trieux;2581;33;2614
44;Grand Est;54;4;16;534;Trondes;537;21;558
44;Grand Est;54;1;04;535;Tronville;201;2;203
44;Grand Est;54;1;17;536;Tucquegnieux;2453;25;2478
44;Grand Est;54;1;11;537;Ugny;703;30;733
44;Grand Est;54;4;10;538;Uruffe;391;3;394
44;Grand Est;54;2;01;539;Vacqueville;236;13;249
44;Grand Est;54;1;17;099;Val de Briey;8148;240;8388
44;Grand Est;54;2;01;540;Val-et-Châtillon;588;6;594
44;Grand Est;54;2;08;541;Valhey;167;2;169
44;Grand Est;54;1;04;542;Valleroy;2334;34;2368
44;Grand Est;54;2;09;543;Vallois;157;2;159
44;Grand Est;54;4;18;544;Vandelainville;139;2;141
44;Grand Est;54;4;10;545;Vandeléville;212;5;217
44;Grand Est;54;3;18;546;Vandières;928;9;937
44;Grand Est;54;3;22;547;Vandœuvre-lès-Nancy;30009;271;30280
44;Grand Est;54;4;10;548;Vannes-le-Châtel;553;8;561
44;Grand Est;54;3;08;549;Varangéville;3608;41;3649
44;Grand Est;54;2;09;550;Vathiménil;334;8;342
44;Grand Est;54;2;01;551;Vaucourt;62;2;64
44;Grand Est;54;3;10;552;Vaudémont;62;2;64
44;Grand Est;54;3;10;553;Vaudeville;150;4;154
44;Grand Est;54;3;10;554;Vaudigny;75;1;76
44;Grand Est;54;2;01;555;Vaxainville;93;0;93
44;Grand Est;54;2;01;556;Vého;103;3;106
44;Grand Est;54;3;03;558;Velaine-sous-Amance;282;5;287
44;Grand Est;54;2;09;559;Velle-sur-Moselle;292;2;294
44;Grand Est;54;2;01;560;Veney;51;0;51
44;Grand Est;54;2;09;561;Vennezey;49;1;50
44;Grand Est;54;2;01;562;Verdenal;157;7;164
44;Grand Est;54;3;10;563;Vézelise;1423;18;1441
44;Grand Est;54;4;16;564;Viéville-en-Haye;144;4;148
44;Grand Est;54;2;09;565;Vigneulles;238;2;240
44;Grand Est;54;4;16;566;Vilcey-sur-Trey;158;1;159
44;Grand Est;54;2;09;567;Villacourt;375;13;388
44;Grand Est;54;1;11;568;Ville-au-Montois;270;3;273
44;Grand Est;54;3;02;569;Ville-au-Val;194;4;198
44;Grand Est;54;3;05;571;Ville-en-Vermois;596;8;604
44;Grand Est;54;1;11;572;Ville-Houdlémont;673;5;678
44;Grand Est;54;1;04;581;Ville-sur-Yron;296;9;305
44;Grand Est;54;1;18;570;Villecey-sur-Mad;340;7;347
44;Grand Est;54;4;16;573;Villers-en-Haye;174;0;174
44;Grand Est;54;1;11;574;Villers-la-Chèvre;560;19;579
44;Grand Est;54;1;23;575;Villers-la-Montagne;1515;37;1552
44;Grand Est;54;1;11;576;Villers-le-Rond;111;1;112
44;Grand Est;54;3;02;577;Villers-lès-Moivrons;145;1;146
44;Grand Est;54;3;06;578;Villers-lès-Nancy;14558;318;14876
44;Grand Est;54;3;18;579;Villers-sous-Prény;343;7;350
44;Grand Est;54;1;23;580;Villerupt;9827;106;9933
44;Grand Est;54;1;11;582;Villette;183;1;184
44;Grand Est;54;4;20;583;Villey-le-Sec;410;8;418
44;Grand Est;54;4;16;584;Villey-Saint-Étienne;1040;22;1062
44;Grand Est;54;2;09;585;Virecourt;480;6;486
44;Grand Est;54;3;10;586;Viterne;735;7;742
44;Grand Est;54;3;10;587;Vitrey;198;3;201
44;Grand Est;54;2;08;588;Vitrimont;397;9;406
44;Grand Est;54;3;18;589;Vittonville;129;6;135
44;Grand Est;54;1;11;590;Viviers-sur-Chiers;665;19;684
44;Grand Est;54;3;10;591;Voinémont;330;12;342
44;Grand Est;54;3;10;592;Vroncourt;264;3;267
44;Grand Est;54;1;18;593;Waville;427;5;432
44;Grand Est;54;4;16;594;Xammes;156;1;157
44;Grand Est;54;2;09;595;Xermaménil;561;7;568
44;Grand Est;54;3;10;596;Xeuilley;961;7;968
44;Grand Est;54;3;10;597;Xirocourt;442;3;445
44;Grand Est;54;1;17;598;Xivry-Circourt;271;7;278
44;Grand Est;54;1;04;599;Xonville;119;0;119
44;Grand Est;54;2;01;600;Xousse;128;1;129
44;Grand Est;54;2;01;601;Xures;106;1;107
44;Grand Est;55;2;10;001;Abainville;296;10;306
44;Grand Est;55;3;04;002;Abaucourt-Hautecourt;103;3;106
44;Grand Est;55;3;14;004;Aincreville;73;0;73
44;Grand Est;55;2;10;005;Amanty;38;1;39
44;Grand Est;55;3;08;007;Ambly-sur-Meuse;243;2;245
44;Grand Est;55;3;05;008;Amel-sur-l'Étang;149;5;154
44;Grand Est;55;3;08;009;Ancemont;539;19;558
44;Grand Est;55;1;01;010;Ancerville;2707;74;2781
44;Grand Est;55;1;12;011;Andernay;257;3;260
44;Grand Est;55;2;13;012;Apremont-la-Forêt;405;8;413
44;Grand Est;55;3;05;013;Arrancy-sur-Crusne;483;8;491
44;Grand Est;55;3;06;014;Aubréville;365;7;372
44;Grand Est;55;1;01;015;Aulnois-en-Perthois;503;12;515
44;Grand Est;55;1;08;017;Autrécourt-sur-Aire;116;5;121
44;Grand Est;55;3;14;018;Autréville-Saint-Lambert;40;2;42
44;Grand Est;55;3;09;021;Avillers-Sainte-Croix;62;2;64
44;Grand Est;55;3;11;022;Avioth;149;4;153
44;Grand Est;55;3;06;023;Avocourt;112;1;113
44;Grand Est;55;3;11;024;Azannes-et-Soumazannes;163;3;166
44;Grand Est;55;3;14;025;Baâlon;281;3;284
44;Grand Est;55;2;10;026;Badonvilliers-Gérauvilliers;135;5;140
44;Grand Est;55;2;08;027;Bannoncourt;157;3;160
44;Grand Est;55;3;06;028;Bantheville;116;3;119
44;Grand Est;55;1;98;029;Bar-le-Duc;14733;589;15322
44;Grand Est;55;1;01;031;Baudonvilliers;378;6;384
44;Grand Est;55;2;08;032;Baudrémont;47;1;48
44;Grand Est;55;3;06;033;Baulny;17;1;18
44;Grand Est;55;3;11;034;Bazeilles-sur-Othain;116;3;119
44;Grand Est;55;1;01;035;Bazincourt-sur-Saulx;147;6;153
44;Grand Est;55;3;14;036;Beauclair;89;1;90
44;Grand Est;55;3;14;037;Beaufort-en-Argonne;145;2;147
44;Grand Est;55;1;08;038;Beaulieu-en-Argonne;37;2;39
44;Grand Est;55;3;04;039;Beaumont-en-Verdunois;0;0;0
44;Grand Est;55;1;08;040;Beausite;252;6;258
44;Grand Est;55;1;03;041;Behonne;608;16;624
44;Grand Est;55;3;17;042;Belleray;514;12;526
44;Grand Est;55;3;04;043;Belleville-sur-Meuse;3066;53;3119
44;Grand Est;55;2;08;044;Belrain;34;3;37
44;Grand Est;55;3;17;045;Belrupt-en-Verdunois;567;8;575
44;Grand Est;55;2;13;046;Beney-en-Woëvre;130;4;134
44;Grand Est;55;3;06;047;Béthelainville;166;6;172
44;Grand Est;55;3;06;048;Béthincourt;35;2;37
44;Grand Est;55;1;12;049;Beurey-sur-Saulx;421;0;421
44;Grand Est;55;3;04;050;Bezonvaux;0;0;0
44;Grand Est;55;1;10;051;Biencourt-sur-Orge;124;3;127
44;Grand Est;55;3;05;053;Billy-sous-Mangiennes;372;2;374
44;Grand Est;55;2;13;054;Bislée;61;5;66
44;Grand Est;55;3;04;055;Blanzée;14;1;15
44;Grand Est;55;3;09;057;Boinville-en-Woëvre;77;2;79
44;Grand Est;55;2;07;058;Boncourt-sur-Meuse;327;10;337
44;Grand Est;55;2;10;059;Bonnet;195;8;203
44;Grand Est;55;3;09;060;Bonzée;349;14;363
44;Grand Est;55;1;10;061;Le Bouchon-sur-Saulx;235;6;241
44;Grand Est;55;2;13;062;Bouconville-sur-Madt;113;1;114
44;Grand Est;55;3;05;063;Bouligny;2511;39;2550
44;Grand Est;55;2;08;064;Bouquemont;108;0;108
44;Grand Est;55;3;06;065;Boureuilles;121;0;121
44;Grand Est;55;2;15;066;Bovée-sur-Barboure;133;4;137
44;Grand Est;55;2;15;067;Boviolles;98;2;100
44;Grand Est;55;3;06;068;Brabant-en-Argonne;108;3;111
44;Grand Est;55;1;12;069;Brabant-le-Roi;229;3;232
44;Grand Est;55;3;06;070;Brabant-sur-Meuse;122;6;128
44;Grand Est;55;3;11;071;Brandeville;182;5;187
44;Grand Est;55;3;09;072;Braquis;114;1;115
44;Grand Est;55;3;04;073;Bras-sur-Meuse;695;49;744
44;Grand Est;55;1;10;075;Brauvilliers;172;4;176
44;Grand Est;55;3;11;076;Bréhéville;170;1;171
44;Grand Est;55;3;11;077;Breux;260;9;269
44;Grand Est;55;3;14;078;Brieulles-sur-Meuse;309;8;317
44;Grand Est;55;1;01;079;Brillon-en-Barrois;684;21;705
44;Grand Est;55;2;15;080;Brixey-aux-Chanoines;82;4;86
44;Grand Est;55;1;08;081;Brizeaux;58;1;59
44;Grand Est;55;3;06;082;Brocourt-en-Argonne;46;1;47
44;Grand Est;55;3;14;083;Brouennes;151;4;155
44;Grand Est;55;2;15;084;Broussey-en-Blois;58;2;60
44;Grand Est;55;2;13;085;Broussey-Raulecourt;288;4;292
44;Grand Est;55;1;10;087;Bure;83;8;91
44;Grand Est;55;2;15;088;Burey-en-Vaux;153;4;157
44;Grand Est;55;2;15;089;Burey-la-Côte;88;1;89
44;Grand Est;55;2;13;093;Buxières-sous-les-Côtes;286;3;289
44;Grand Est;55;3;09;094;Buzy-Darmont;554;11;565
44;Grand Est;55;3;14;095;Cesse;109;4;113
44;Grand Est;55;2;13;096;Chaillon;113;1;114
44;Grand Est;55;2;15;097;Chalaines;312;6;318
44;Grand Est;55;3;04;099;Champneuville;119;1;120
44;Grand Est;55;2;15;100;Champougny;81;8;89
44;Grand Est;55;1;10;358;Chanteraine;187;5;192
44;Grand Est;55;1;03;101;Chardogne;300;8;308
44;Grand Est;55;3;04;102;Charny-sur-Meuse;521;19;540
44;Grand Est;55;3;06;103;Charpentry;22;2;24
44;Grand Est;55;2;10;104;Chassey-Beaupré;82;3;85
44;Grand Est;55;3;04;105;Châtillon-sous-les-Côtes;177;4;181
44;Grand Est;55;3;06;106;Chattancourt;180;5;185
44;Grand Est;55;3;11;107;Chaumont-devant-Damvillers;48;1;49
44;Grand Est;55;1;12;108;Chaumont-sur-Aire;125;4;129
44;Grand Est;55;3;11;109;Chauvency-le-Château;242;7;249
44;Grand Est;55;3;11;110;Chauvency-Saint-Hubert;229;7;236
44;Grand Est;55;2;13;111;Chauvoncourt;447;20;467
44;Grand Est;55;3;06;113;Cheppy;152;1;153
44;Grand Est;55;2;07;114;Chonville-Malaumont;209;4;213
44;Grand Est;55;3;06;115;Cierges-sous-Montfaucon;49;0;49
44;Grand Est;55;3;06;116;Le Claon;57;2;59
44;Grand Est;55;3;06;117;Clermont-en-Argonne;1466;34;1500
44;Grand Est;55;3;14;118;Cléry-le-Grand;93;2;95
44;Grand Est;55;3;14;119;Cléry-le-Petit;188;1;189
44;Grand Est;55;1;02;120;Combles-en-Barrois;792;23;815
44;Grand Est;55;3;09;121;Combres-sous-les-Côtes;118;5;123
44;Grand Est;55;2;07;122;Commercy;5399;235;5634
44;Grand Est;55;3;06;124;Consenvoye;310;4;314
44;Grand Est;55;1;12;125;Contrisson;807;19;826
44;Grand Est;55;2;08;127;Courcelles-en-Barrois;40;0;40
44;Grand Est;55;1;12;128;Courcelles-sur-Aire;41;1;42
44;Grand Est;55;2;08;129;Courouvre;36;1;37
44;Grand Est;55;1;01;132;Cousances-les-Forges;1676;29;1705
44;Grand Est;55;2;15;518;Cousances-lès-Triconville;142;2;144
44;Grand Est;55;1;10;133;Couvertpuis;87;5;92
44;Grand Est;55;1;12;134;Couvonges;154;4;158
44;Grand Est;55;3;06;137;Cuisy;47;0;47
44;Grand Est;55;1;15;138;Culey;137;3;140
44;Grand Est;55;3;04;139;Cumières-le-Mort-Homme;0;0;0
44;Grand Est;55;3;06;140;Cunel;16;0;16
44;Grand Est;55;2;15;141;Dagonville;84;0;84
44;Grand Est;55;2;10;142;Dainville-Bertheléville;119;6;125
44;Grand Est;55;3;04;143;Damloup;129;8;137
44;Grand Est;55;1;10;144;Dammarie-sur-Saulx;403;14;417
44;Grand Est;55;3;11;145;Damvillers;635;71;706
44;Grand Est;55;3;06;146;Dannevoux;218;12;230
44;Grand Est;55;2;10;148;Delouze-Rosières;113;4;117
44;Grand Est;55;3;11;149;Delut;122;0;122
44;Grand Est;55;2;10;150;Demange-Baudignécourt ;538;13;551
44;Grand Est;55;3;04;153;Dieppe-sous-Douaumont;192;2;194
44;Grand Est;55;3;08;154;Dieue-sur-Meuse;1441;47;1488
44;Grand Est;55;3;06;155;Dombasle-en-Argonne;402;7;409
44;Grand Est;55;3;11;156;Dombras;137;4;141
44;Grand Est;55;3;09;157;Dommartin-la-Montagne;52;0;52
44;Grand Est;55;3;05;158;Dommary-Baroncourt;733;8;741
44;Grand Est;55;2;08;159;Dompcevrin;324;3;327
44;Grand Est;55;2;13;160;Dompierre-aux-Bois;39;0;39
44;Grand Est;55;3;05;162;Domremy-la-Canne;35;0;35
44;Grand Est;55;3;09;163;Doncourt-aux-Templiers;58;3;61
44;Grand Est;55;3;04;537;Douaumont-Vaux;80;0;80
44;Grand Est;55;3;14;165;Doulcon;436;12;448
44;Grand Est;55;3;17;166;Dugny-sur-Meuse;1308;24;1332
44;Grand Est;55;3;14;167;Dun-sur-Meuse;662;9;671
44;Grand Est;55;3;05;168;Duzey;43;0;43
44;Grand Est;55;3;11;169;Écouviez;507;6;513
44;Grand Est;55;3;11;170;Écurey-en-Verdunois;121;1;122
44;Grand Est;55;3;04;171;Eix;253;4;257
44;Grand Est;55;3;09;172;Les Éparges;65;1;66
44;Grand Est;55;2;15;173;Épiez-sur-Meuse;41;3;44
44;Grand Est;55;3;06;174;Épinonville;75;0;75
44;Grand Est;55;1;02;175;Érize-la-Brûlée;188;5;193
44;Grand Est;55;1;12;177;Érize-la-Petite;50;5;55
44;Grand Est;55;1;02;178;Érize-Saint-Dizier;186;6;192
44;Grand Est;55;2;15;179;Erneville-aux-Bois;155;3;158
44;Grand Est;55;3;06;180;Esnes-en-Argonne;136;11;147
44;Grand Est;55;3;09;181;Étain;3543;74;3617
44;Grand Est;55;3;05;182;Éton;209;3;212
44;Grand Est;55;3;11;183;Étraye;38;1;39
44;Grand Est;55;2;07;184;Euville;1657;32;1689
44;Grand Est;55;1;08;185;Èvres;96;5;101
44;Grand Est;55;1;03;186;Fains-Véel;2124;58;2182
44;Grand Est;55;3;11;188;Flassigny;45;1;46
44;Grand Est;55;3;04;189;Fleury-devant-Douaumont;0;0;0
44;Grand Est;55;3;05;191;Foameix-Ornel;240;5;245
44;Grand Est;55;3;14;192;Fontaines-Saint-Clair;49;1;50
44;Grand Est;55;3;06;193;Forges-sur-Meuse;123;2;125
44;Grand Est;55;1;08;194;Foucaucourt-sur-Thabas;58;0;58
44;Grand Est;55;1;10;195;Fouchères-aux-Bois;131;4;135
44;Grand Est;55;2;07;196;Frémeréville-sous-les-Côtes;130;1;131
44;Grand Est;55;2;08;197;Fresnes-au-Mont;169;4;173
44;Grand Est;55;3;09;198;Fresnes-en-Woëvre;666;9;675
44;Grand Est;55;3;06;199;Froidos;93;2;95
44;Grand Est;55;3;06;200;Fromeréville-les-Vallons;208;4;212
44;Grand Est;55;3;09;201;Fromezey;56;0;56
44;Grand Est;55;3;06;202;Futeau;155;3;158
44;Grand Est;55;3;08;204;Génicourt-sur-Meuse;289;5;294
44;Grand Est;55;3;06;206;Gercourt-et-Drillancourt;102;4;106
44;Grand Est;55;1;02;207;Géry;54;1;55
44;Grand Est;55;3;06;208;Gesnes-en-Argonne;59;2;61
44;Grand Est;55;2;07;258;Geville;618;16;634
44;Grand Est;55;2;08;210;Gimécourt;40;0;40
44;Grand Est;55;3;04;211;Gincrey;64;1;65
44;Grand Est;55;2;07;212;Girauvoisin;81;0;81
44;Grand Est;55;1;10;214;Givrauval;283;21;304
44;Grand Est;55;2;10;215;Gondrecourt-le-Château;1078;17;1095
44;Grand Est;55;3;05;216;Gouraincourt;61;0;61
44;Grand Est;55;2;15;217;Goussaincourt;113;6;119
44;Grand Est;55;3;11;218;Gremilly;40;0;40
44;Grand Est;55;3;04;219;Grimaucourt-en-Woëvre;103;2;105
44;Grand Est;55;2;07;220;Grimaucourt-près-Sampigny;81;0;81
44;Grand Est;55;1;01;221;Guerpont;247;6;253
44;Grand Est;55;3;09;222;Gussainville;34;2;36
44;Grand Est;55;1;01;224;Haironville;587;13;600
44;Grand Est;55;3;14;225;Halles-sous-les-Côtes;147;7;154
44;Grand Est;55;3;11;226;Han-lès-Juvigny;122;1;123
44;Grand Est;55;2;13;229;Han-sur-Meuse;274;3;277
44;Grand Est;55;3;09;228;Hannonville-sous-les-Côtes;560;11;571
44;Grand Est;55;3;09;232;Harville;116;0;116
44;Grand Est;55;3;17;236;Haudainville;946;24;970
44;Grand Est;55;3;09;237;Haudiomont;222;1;223
44;Grand Est;55;3;04;239;Haumont-près-Samogneux;0;0;0
44;Grand Est;55;1;12;123;Les Hauts-de-Chée;716;15;731
44;Grand Est;55;3;08;241;Heippes;77;3;80
44;Grand Est;55;3;09;242;Hennemont;111;4;115
44;Grand Est;55;3;09;243;Herbeuville;180;5;185
44;Grand Est;55;3;09;244;Herméville-en-Woëvre;237;3;240
44;Grand Est;55;2;13;245;Heudicourt-sous-les-Côtes;166;2;168
44;Grand Est;55;1;10;246;Hévilliers;148;1;149
44;Grand Est;55;2;10;247;Horville-en-Ornois;54;6;60
44;Grand Est;55;2;10;248;Houdelaincourt;291;7;298
44;Grand Est;55;3;14;250;Inor;183;8;191
44;Grand Est;55;1;08;251;Ippécourt;102;3;105
44;Grand Est;55;3;11;252;Iré-le-Sec;153;2;155
44;Grand Est;55;1;01;296;L' Isle-en-Rigault;479;9;488
44;Grand Est;55;3;06;253;Les Islettes;731;13;744
44;Grand Est;55;3;11;255;Jametz;259;6;265
44;Grand Est;55;2;13;256;Jonville-en-Woëvre;148;0;148
44;Grand Est;55;3;06;257;Jouy-en-Argonne;45;0;45
44;Grand Est;55;3;08;260;Julvécourt;56;2;58
44;Grand Est;55;1;01;261;Juvigny-en-Perthois;142;2;144
44;Grand Est;55;3;11;262;Juvigny-sur-Loison;263;2;265
44;Grand Est;55;2;08;263;Kœur-la-Grande;162;4;166
44;Grand Est;55;2;08;264;Kœur-la-Petite;276;5;281
44;Grand Est;55;3;09;265;Labeuville;137;5;142
44;Grand Est;55;3;06;266;Lachalade;52;0;52
44;Grand Est;55;2;13;267;Lachaussée;271;8;279
44;Grand Est;55;2;13;268;Lacroix-sur-Meuse;714;17;731
44;Grand Est;55;2;08;269;Lahaymeix;74;0;74
44;Grand Est;55;2;13;270;Lahayville;28;1;29
44;Grand Est;55;1;12;271;Laheycourt;392;6;398
44;Grand Est;55;1;12;272;Laimont;451;18;469
44;Grand Est;55;2;13;274;Lamorville;290;6;296
44;Grand Est;55;3;14;275;Lamouilly;89;4;93
44;Grand Est;55;3;08;276;Landrecourt-Lempire;213;2;215
44;Grand Est;55;2;15;278;Laneuville-au-Rupt;196;3;199
44;Grand Est;55;3;14;279;Laneuville-sur-Meuse;441;8;449
44;Grand Est;55;3;05;280;Lanhères;60;0;60
44;Grand Est;55;3;09;281;Latour-en-Woëvre;95;0;95
44;Grand Est;55;2;08;282;Lavallée;95;3;98
44;Grand Est;55;1;01;284;Lavincourt;72;0;72
44;Grand Est;55;1;08;285;Lavoye;153;5;158
44;Grand Est;55;3;08;286;Lemmes;245;1;246
44;Grand Est;55;2;07;288;Lérouville;1418;16;1434
44;Grand Est;55;2;08;289;Levoncourt;57;1;58
44;Grand Est;55;2;08;290;Lignières-sur-Aire;54;2;56
44;Grand Est;55;1;10;291;Ligny-en-Barrois;4043;135;4178
44;Grand Est;55;3;14;292;Liny-devant-Dun;190;7;197
44;Grand Est;55;3;14;293;Lion-devant-Dun;169;4;173
44;Grand Est;55;1;12;295;Lisle-en-Barrois;32;1;33
44;Grand Est;55;3;11;297;Lissey;111;1;112
44;Grand Est;55;1;15;298;Loisey;299;9;308
44;Grand Est;55;3;05;299;Loison;120;3;123
44;Grand Est;55;2;08;301;Longchamps-sur-Aire;122;8;130
44;Grand Est;55;1;10;300;Longeaux;225;7;232
44;Grand Est;55;1;02;302;Longeville-en-Barrois;1145;35;1180
44;Grand Est;55;2;13;303;Loupmont;73;4;77
44;Grand Est;55;1;12;304;Louppy-le-Château;158;6;164
44;Grand Est;55;3;11;306;Louppy-sur-Loison;115;1;116
44;Grand Est;55;3;04;307;Louvemont-Côte-du-Poivre;0;0;0
44;Grand Est;55;3;14;310;Luzy-Saint-Martin;114;4;118
44;Grand Est;55;3;09;311;Maizeray;31;1;32
44;Grand Est;55;2;13;312;Maizey;165;6;171
44;Grand Est;55;3;06;313;Malancourt;65;2;67
44;Grand Est;55;1;10;315;Mandres-en-Barrois;118;5;123
44;Grand Est;55;3;05;316;Mangiennes;397;7;404
44;Grand Est;55;3;09;317;Manheulles;141;7;148
44;Grand Est;55;3;09;320;Marchéville-en-Woëvre;67;2;69
44;Grand Est;55;3;06;321;Marre;163;7;170
44;Grand Est;55;2;15;322;Marson-sur-Barboure;46;1;47
44;Grand Est;55;3;14;323;Martincourt-sur-Meuse;67;1;68
44;Grand Est;55;3;11;324;Marville;510;13;523
44;Grand Est;55;3;04;325;Maucourt-sur-Orne;54;1;55
44;Grand Est;55;1;01;326;Maulan;114;3;117
44;Grand Est;55;2;10;327;Mauvages;255;2;257
44;Grand Est;55;2;15;328;Maxey-sur-Vaise;291;6;297
44;Grand Est;55;2;07;329;Mécrin;223;2;225
44;Grand Est;55;2;15;330;Méligny-le-Grand;91;2;93
44;Grand Est;55;2;15;331;Méligny-le-Petit;79;0;79
44;Grand Est;55;1;10;332;Menaucourt;239;5;244
44;Grand Est;55;2;08;333;Ménil-aux-Bois;41;0;41
44;Grand Est;55;2;15;334;Ménil-la-Horgne;168;3;171
44;Grand Est;55;1;10;335;Ménil-sur-Saulx;254;10;264
44;Grand Est;55;3;11;336;Merles-sur-Loison;150;2;152
44;Grand Est;55;3;14;338;Milly-sur-Bradon;151;5;156
44;Grand Est;55;3;04;339;Mogeville;82;1;83
44;Grand Est;55;1;12;340;Mognéville;378;11;389
44;Grand Est;55;3;11;341;Moirey-Flabas-Crépion;129;2;131
44;Grand Est;55;3;14;345;Mont-devant-Sassey;99;3;102
44;Grand Est;55;3;06;343;Montblainville;61;2;63
44;Grand Est;55;2;15;344;Montbras;21;0;21
44;Grand Est;55;3;06;346;Montfaucon-d'Argonne;299;7;306
44;Grand Est;55;3;08;347;Les Monthairons;362;3;365
44;Grand Est;55;1;10;348;Montiers-sur-Saulx;376;4;380
44;Grand Est;55;3;14;349;Montigny-devant-Sassey;114;6;120
44;Grand Est;55;2;15;350;Montigny-lès-Vaucouleurs;71;0;71
44;Grand Est;55;3;11;351;Montmédy;2094;85;2179
44;Grand Est;55;1;01;352;Montplonne;143;18;161
44;Grand Est;55;2;13;353;Montsec;83;0;83
44;Grand Est;55;3;06;355;Montzéville;155;1;156
44;Grand Est;55;3;04;356;Moranville;106;1;107
44;Grand Est;55;3;05;357;Morgemoulin;110;3;113
44;Grand Est;55;1;10;359;Morley;206;2;208
44;Grand Est;55;3;09;360;Mouilly;112;1;113
44;Grand Est;55;3;04;361;Moulainville;125;0;125
44;Grand Est;55;3;14;362;Moulins-Saint-Hubert;177;3;180
44;Grand Est;55;3;09;363;Moulotte;97;1;98
44;Grand Est;55;3;14;364;Mouzay;680;29;709
44;Grand Est;55;3;14;365;Murvaux;142;4;146
44;Grand Est;55;3;05;367;Muzeray;135;4;139
44;Grand Est;55;2;15;368;Naives-en-Blois;146;10;156
44;Grand Est;55;1;02;369;Naives-Rosières;794;21;815
44;Grand Est;55;1;10;370;Naix-aux-Forges;223;2;225
44;Grand Est;55;1;01;373;Nant-le-Grand;81;5;86
44;Grand Est;55;1;01;374;Nant-le-Petit;76;1;77
44;Grand Est;55;3;06;375;Nantillois;64;1;65
44;Grand Est;55;1;10;376;Nantois;87;4;91
44;Grand Est;55;2;15;371;Nançois-le-Grand;73;4;77
44;Grand Est;55;1;15;372;Nançois-sur-Ornain;378;12;390
44;Grand Est;55;3;14;377;Nepvant;87;1;88
44;Grand Est;55;1;12;378;Nettancourt;248;3;251
44;Grand Est;55;3;06;379;Le Neufour;72;2;74
44;Grand Est;55;2;08;380;Neuville-en-Verdunois;56;1;57
44;Grand Est;55;2;15;381;Neuville-lès-Vaucouleurs;175;8;183
44;Grand Est;55;1;12;382;Neuville-sur-Ornain;363;9;372
44;Grand Est;55;3;06;383;Neuvilly-en-Argonne;216;2;218
44;Grand Est;55;2;08;384;Nicey-sur-Aire;123;4;127
44;Grand Est;55;3;08;385;Nixéville-Blercourt;496;16;512
44;Grand Est;55;2;13;386;Nonsard-Lamarche;218;5;223
44;Grand Est;55;3;05;387;Nouillonpont;236;4;240
44;Grand Est;55;1;12;388;Noyers-Auzécourt;279;4;283
44;Grand Est;55;1;08;389;Nubécourt;251;6;257
44;Grand Est;55;3;14;391;Olizy-sur-Chiers;195;6;201
44;Grand Est;55;3;04;394;Ornes;6;0;6
44;Grand Est;55;3;08;395;Osches;55;3;58
44;Grand Est;55;2;15;396;Ourches-sur-Meuse;224;5;229
44;Grand Est;55;2;15;397;Pagny-la-Blanche-Côte;238;4;242
44;Grand Est;55;2;15;398;Pagny-sur-Meuse;1015;17;1032
44;Grand Est;55;3;09;399;Pareid;118;0;118
44;Grand Est;55;3;09;400;Parfondrupt;43;0;43
44;Grand Est;55;2;13;401;Les Paroches;415;11;426
44;Grand Est;55;3;11;403;Peuvillers;58;1;59
44;Grand Est;55;2;08;404;Pierrefitte-sur-Aire;321;11;332
44;Grand Est;55;3;05;405;Pillon;256;3;259
44;Grand Est;55;3;09;406;Pintheville;110;4;114
44;Grand Est;55;2;07;407;Pont-sur-Meuse;130;6;136
44;Grand Est;55;3;14;408;Pouilly-sur-Meuse;176;8;184
44;Grand Est;55;1;08;409;Pretz-en-Argonne;69;2;71
44;Grand Est;55;3;11;410;Quincy-Landzécourt;136;6;142
44;Grand Est;55;1;02;442;Raival;252;3;255
44;Grand Est;55;3;08;411;Rambluzin-et-Benoite-Vaux;104;1;105
44;Grand Est;55;2;13;412;Rambucourt;188;5;193
44;Grand Est;55;1;12;414;Rancourt-sur-Ornain;187;1;188
44;Grand Est;55;2;13;415;Ranzières;84;1;85
44;Grand Est;55;3;06;416;Rarécourt;223;7;230
44;Grand Est;55;3;06;419;Récicourt;164;4;168
44;Grand Est;55;3;08;420;Récourt-le-Creux;77;0;77
44;Grand Est;55;2;15;421;Reffroy;75;4;79
44;Grand Est;55;3;06;422;Regnéville-sur-Meuse;51;0;51
44;Grand Est;55;1;12;423;Rembercourt-Sommaisne;341;9;350
44;Grand Est;55;1;12;424;Remennecourt;52;0;52
44;Grand Est;55;3;11;425;Remoiville;134;0;134
44;Grand Est;55;1;02;426;Resson;389;15;404
44;Grand Est;55;1;12;427;Revigny-sur-Ornain;2807;51;2858
44;Grand Est;55;3;11;428;Réville-aux-Bois;119;1;120
44;Grand Est;55;3;09;429;Riaville;45;0;45
44;Grand Est;55;1;10;430;Ribeaucourt;69;1;70
44;Grand Est;55;2;13;431;Richecourt;59;0;59
44;Grand Est;55;2;15;433;Rigny-la-Salle;364;13;377
44;Grand Est;55;2;15;434;Rigny-Saint-Martin;51;2;53
44;Grand Est;55;1;12;435;Robert-Espagne;802;24;826
44;Grand Est;55;2;10;436;Les Roises;30;0;30
44;Grand Est;55;3;11;437;Romagne-sous-les-Côtes;122;3;125
44;Grand Est;55;3;06;438;Romagne-sous-Montfaucon;185;4;189
44;Grand Est;55;3;09;439;Ronvaux;87;5;92
44;Grand Est;55;3;05;443;Rouvres-en-Woëvre;598;6;604
44;Grand Est;55;2;13;444;Rouvrois-sur-Meuse;216;0;216
44;Grand Est;55;3;05;445;Rouvrois-sur-Othain;192;8;200
44;Grand Est;55;1;02;446;Rumont;84;4;88
44;Grand Est;55;1;01;447;Rupt-aux-Nonains;371;7;378
44;Grand Est;55;2;08;448;Rupt-devant-Saint-Mihiel;52;1;53
44;Grand Est;55;3;08;449;Rupt-en-Woëvre;294;4;298
44;Grand Est;55;3;11;450;Rupt-sur-Othain;44;2;46
44;Grand Est;55;1;10;452;Saint-Amand-sur-Ornain;50;2;52
44;Grand Est;55;3;08;453;Saint-André-en-Barrois;66;1;67
44;Grand Est;55;2;15;454;Saint-Aubin-sur-Aire;168;1;169
44;Grand Est;55;2;15;456;Saint-Germain-sur-Meuse;245;8;253
44;Grand Est;55;3;09;457;Saint-Hilaire-en-Woëvre;178;5;183
44;Grand Est;55;3;09;458;Saint-Jean-lès-Buzy;371;0;371
44;Grand Est;55;2;10;459;Saint-Joire;240;3;243
44;Grand Est;55;2;07;460;Saint-Julien-sous-les-Côtes;139;2;141
44;Grand Est;55;3;05;461;Saint-Laurent-sur-Othain;489;16;505
44;Grand Est;55;2;13;462;Saint-Maurice-sous-les-Côtes;348;11;359
44;Grand Est;55;2;13;463;Saint-Mihiel;4074;72;4146
44;Grand Est;55;3;05;464;Saint-Pierrevillers;154;8;162
44;Grand Est;55;3;09;465;Saint-Remy-la-Calonne;103;0;103
44;Grand Est;55;1;15;466;Salmagne;297;8;305
44;Grand Est;55;3;04;468;Samogneux;97;0;97
44;Grand Est;55;2;08;467;Sampigny;690;14;704
44;Grand Est;55;3;14;469;Sassey-sur-Meuse;96;0;96
44;Grand Est;55;1;01;470;Saudrupt;196;2;198
44;Grand Est;55;3;14;471;Saulmory-Villefranche;85;1;86
44;Grand Est;55;2;15;472;Saulvaux;115;6;121
44;Grand Est;55;3;09;473;Saulx-lès-Champlon;116;12;128
44;Grand Est;55;2;15;474;Sauvigny;231;7;238
44;Grand Est;55;2;15;475;Sauvoy;61;1;62
44;Grand Est;55;1;02;476;Savonnières-devant-Bar;470;13;483
44;Grand Est;55;1;01;477;Savonnières-en-Perthois;407;15;422
44;Grand Est;55;1;02;479;Seigneulles;168;3;171
44;Grand Est;55;3;05;481;Senon;335;2;337
44;Grand Est;55;3;08;482;Senoncourt-les-Maujouy;100;2;102
44;Grand Est;55;3;06;484;Septsarges;48;1;49
44;Grand Est;55;2;15;485;Sepvigny;73;3;76
44;Grand Est;55;1;08;517;Seuil-d'Argonne;515;6;521
44;Grand Est;55;2;13;487;Seuzey;106;2;108
44;Grand Est;55;1;01;488;Silmont;154;5;159
44;Grand Est;55;3;16;489;Sivry-la-Perche;274;7;281
44;Grand Est;55;3;06;490;Sivry-sur-Meuse;335;11;346
44;Grand Est;55;3;08;492;Sommedieue;986;13;999
44;Grand Est;55;1;12;493;Sommeilles;197;5;202
44;Grand Est;55;1;01;494;Sommelonne;442;22;464
44;Grand Est;55;3;05;495;Sorbey;262;1;263
44;Grand Est;55;2;15;496;Sorcy-Saint-Martin;1086;31;1117
44;Grand Est;55;3;08;497;Les Souhesmes-Rampont;335;3;338
44;Grand Est;55;3;08;498;Souilly;460;5;465
44;Grand Est;55;3;05;500;Spincourt;837;12;849
44;Grand Est;55;1;01;501;Stainville;401;10;411
44;Grand Est;55;3;14;502;Stenay;2520;129;2649
44;Grand Est;55;2;15;503;Taillancourt;126;2;128
44;Grand Est;55;1;01;504;Tannois;408;10;418
44;Grand Est;55;3;04;505;Thierville-sur-Meuse;3159;97;3256
44;Grand Est;55;2;08;506;Thillombois;31;0;31
44;Grand Est;55;3;09;507;Thillot;227;2;229
44;Grand Est;55;3;11;508;Thonne-la-Long;344;2;346
44;Grand Est;55;3;11;509;Thonne-le-Thil;271;6;277
44;Grand Est;55;3;11;510;Thonne-les-Près;133;3;136
44;Grand Est;55;3;11;511;Thonnelle;122;3;125
44;Grand Est;55;3;08;512;Tilly-sur-Meuse;284;4;288
44;Grand Est;55;1;02;514;Trémont-sur-Saulx;606;10;616
44;Grand Est;55;3;09;515;Trésauvaux;69;1;70
44;Grand Est;55;2;10;516;Tréveray;565;6;571
44;Grand Est;55;1;08;254;Les Trois-Domaines;124;3;127
44;Grand Est;55;1;01;519;Tronville-en-Barrois;1395;30;1425
44;Grand Est;55;2;15;520;Troussey;458;11;469
44;Grand Est;55;2;13;521;Troyon;252;1;253
44;Grand Est;55;2;15;522;Ugny-sur-Meuse;111;3;114
44;Grand Est;55;3;04;523;Vacherauville;182;4;186
44;Grand Est;55;3;08;525;Vadelaincourt;78;0;78
44;Grand Est;55;2;07;526;Vadonville;260;4;264
44;Grand Est;55;1;12;366;Val-d'Ornain;986;34;1020
44;Grand Est;55;2;13;530;Valbois;93;1;94
44;Grand Est;55;3;06;527;Varennes-en-Argonne;647;11;658
44;Grand Est;55;2;13;528;Varnéville;53;0;53
44;Grand Est;55;1;12;531;Vassincourt;274;27;301
44;Grand Est;55;1;12;532;Vaubecourt;312;5;317
44;Grand Est;55;2;15;533;Vaucouleurs;1936;23;1959
44;Grand Est;55;2;10;534;Vaudeville-le-Haut;54;0;54
44;Grand Est;55;3;05;535;Vaudoncourt;92;0;92
44;Grand Est;55;3;06;536;Vauquois;18;3;21
44;Grand Est;55;2;13;540;Vaux-lès-Palameix;58;1;59
44;Grand Est;55;1;03;541;Vavincourt;520;9;529
44;Grand Est;55;1;01;543;Velaines;951;21;972
44;Grand Est;55;3;11;544;Velosnes;158;2;160
44;Grand Est;55;3;99;545;Verdun;17161;960;18121
44;Grand Est;55;3;11;546;Verneuil-Grand;204;8;212
44;Grand Est;55;3;11;547;Verneuil-Petit;120;4;124
44;Grand Est;55;3;06;549;Véry;90;1;91
44;Grand Est;55;3;11;552;Vigneul-sous-Montmédy;83;4;87
44;Grand Est;55;2;13;551;Vigneulles-lès-Hattonchâtel;1562;94;1656
44;Grand Est;55;2;07;553;Vignot;1310;36;1346
44;Grand Est;55;2;08;555;Ville-devant-Belrain;34;1;35
44;Grand Est;55;3;11;556;Ville-devant-Chaumont;49;1;50
44;Grand Est;55;3;09;557;Ville-en-Woëvre;123;2;125
44;Grand Est;55;3;08;567;Ville-sur-Cousances;141;2;143
44;Grand Est;55;1;01;568;Ville-sur-Saulx;284;5;289
44;Grand Est;55;3;11;554;Villécloye;267;15;282
44;Grand Est;55;2;15;559;Villeroy-sur-Méholle;41;2;43
44;Grand Est;55;1;12;560;Villers-aux-Vents;131;4;135
44;Grand Est;55;3;14;561;Villers-devant-Dun;51;5;56
44;Grand Est;55;1;10;562;Villers-le-Sec;125;2;127
44;Grand Est;55;3;05;563;Villers-lès-Mangiennes;80;4;84
44;Grand Est;55;3;09;565;Villers-sous-Pareid;79;3;82
44;Grand Est;55;3;08;566;Villers-sur-Meuse;305;3;308
44;Grand Est;55;1;12;569;Villotte-devant-Louppy;164;5;169
44;Grand Est;55;2;08;570;Villotte-sur-Aire;205;7;212
44;Grand Est;55;3;06;571;Vilosnes-Haraumont;224;8;232
44;Grand Est;55;3;11;572;Vittarville;83;1;84
44;Grand Est;55;2;15;573;Void-Vacon;1635;30;1665
44;Grand Est;55;2;10;574;Vouthon-Bas;46;2;48
44;Grand Est;55;2;10;575;Vouthon-Haut;86;0;86
44;Grand Est;55;1;08;577;Waly;60;2;62
44;Grand Est;55;3;09;578;Warcq;186;7;193
44;Grand Est;55;3;09;579;Watronville;103;0;103
44;Grand Est;55;3;11;580;Wavrille;51;3;54
44;Grand Est;55;1;15;581;Willeroncourt;107;3;110
44;Grand Est;55;3;14;582;Wiseppe;92;1;93
44;Grand Est;55;3;09;583;Woël;200;4;204
44;Grand Est;55;2;08;584;Woimbey;120;2;122
44;Grand Est;55;2;13;586;Xivray-et-Marvoisin;103;3;106
53;Bretagne;56;3;04;001;Allaire;3866;127;3993
53;Bretagne;56;3;11;002;Ambon;1881;50;1931
53;Bretagne;56;3;20;003;Arradon;5377;174;5551
53;Bretagne;56;3;11;004;Arzal;1666;31;1697
53;Bretagne;56;3;18;005;Arzon;2131;34;2165
53;Bretagne;56;3;04;006;Augan;1535;31;1566
53;Bretagne;56;1;01;007;Auray;13945;413;14358
53;Bretagne;56;3;20;008;Baden;4362;120;4482
53;Bretagne;56;1;17;009;Bangor;1004;19;1023
53;Bretagne;56;2;15;010;Baud;6247;193;6440
53;Bretagne;56;3;04;011;Béganne;1401;27;1428
53;Bretagne;56;3;04;012;Beignon;1931;41;1972
53;Bretagne;56;1;17;013;Belz;3735;61;3796
53;Bretagne;56;2;02;014;Berné;1537;140;1677
53;Bretagne;56;3;16;015;Berric;1973;29;2002
53;Bretagne;56;2;10;017;Bignan;2782;63;2845
53;Bretagne;56;3;11;018;Billiers;982;27;1009
53;Bretagne;56;2;10;019;Billio;344;10;354
53;Bretagne;56;3;10;020;Bohal;844;15;859
53;Bretagne;56;3;20;262;Bono;2489;42;2531
53;Bretagne;56;1;14;021;Brandérion;1446;27;1473
53;Bretagne;56;3;03;022;Brandivy;1299;26;1325
53;Bretagne;56;1;14;023;Brech;6631;280;6911
53;Bretagne;56;2;03;024;Bréhan;2297;35;2332
53;Bretagne;56;2;13;025;Brignac;190;4;194
53;Bretagne;56;1;05;026;Bubry;2346;60;2406
53;Bretagne;56;2;10;027;Buléon;537;8;545
53;Bretagne;56;3;16;028;Caden;1609;37;1646
53;Bretagne;56;1;05;029;Calan;1227;23;1250
53;Bretagne;56;3;11;030;Camoël;1024;16;1040
53;Bretagne;56;1;14;031;Camors;3048;61;3109
53;Bretagne;56;2;13;032;Campénéac;1881;53;1934
53;Bretagne;56;3;04;033;Carentoir;3100;58;3158
53;Bretagne;56;1;17;034;Carnac;4250;126;4376
53;Bretagne;56;3;10;035;Caro;1147;31;1178
53;Bretagne;56;1;07;036;Caudan;6891;200;7091
53;Bretagne;56;2;03;039;La Chapelle-Neuve;979;21;1000
53;Bretagne;56;1;05;040;Cléguer;3305;61;3366
53;Bretagne;56;2;02;041;Cléguérec;2867;91;2958
53;Bretagne;56;3;03;042;Colpo;2176;35;2211
53;Bretagne;56;2;13;043;Concoret;734;10;744
53;Bretagne;56;3;04;044;Cournon;773;29;802
53;Bretagne;56;3;16;045;Le Cours;671;10;681
53;Bretagne;56;1;01;046;Crach;3366;80;3446
53;Bretagne;56;2;03;047;Crédin;1540;47;1587
53;Bretagne;56;2;02;048;Le Croisty;707;17;724
53;Bretagne;56;2;13;050;La Croix-Helléan;886;32;918
53;Bretagne;56;2;15;049;Croixanvec;168;4;172
53;Bretagne;56;2;13;051;Cruguel;654;5;659
53;Bretagne;56;3;11;052;Damgan;1771;25;1796
53;Bretagne;56;3;16;053;Elven;6173;117;6290
53;Bretagne;56;1;17;054;Erdeven;3749;95;3844
53;Bretagne;56;1;17;055;Étel;2013;183;2196
53;Bretagne;56;2;03;144;Évellys ;3477;63;3540
53;Bretagne;56;2;13;056;Évriguet;190;4;194
53;Bretagne;56;2;02;057;Le Faouët;2790;58;2848
53;Bretagne;56;3;11;058;Férel;3269;62;3331
53;Bretagne;56;2;13;102;Forges de Lanouée ;2194;50;2244
53;Bretagne;56;3;04;060;Les Fougerêts;952;35;987
53;Bretagne;56;3;04;061;Gacilly ;3979;80;4059
53;Bretagne;56;1;14;062;Gâvres;678;20;698
53;Bretagne;56;1;05;063;Gestel;2666;90;2756
53;Bretagne;56;2;13;065;Gourhel;700;24;724
53;Bretagne;56;2;02;066;Gourin;3794;150;3944
53;Bretagne;56;3;03;067;Grand-Champ;5459;136;5595
53;Bretagne;56;2;13;068;La Grée-Saint-Laurent;329;3;332
53;Bretagne;56;1;09;069;Groix;2249;54;2303
53;Bretagne;56;2;13;070;Guégon;2282;51;2333
53;Bretagne;56;2;10;071;Guéhenno;797;12;809
53;Bretagne;56;2;15;072;Gueltas;513;10;523
53;Bretagne;56;2;02;073;Guémené-sur-Scorff;1057;17;1074
53;Bretagne;56;2;15;074;Guénin;1795;37;1832
53;Bretagne;56;3;04;075;Guer;6141;293;6434
53;Bretagne;56;2;15;076;Guern;1310;38;1348
53;Bretagne;56;3;11;077;Le Guerno;988;16;1004
53;Bretagne;56;1;05;078;Guidel;11659;304;11963
53;Bretagne;56;2;13;079;Guillac;1350;40;1390
53;Bretagne;56;2;13;080;Guilliers;1308;143;1451
53;Bretagne;56;2;02;081;Guiscriff;2086;60;2146
53;Bretagne;56;2;13;082;Helléan;379;7;386
53;Bretagne;56;1;06;083;Hennebont;15858;401;16259
53;Bretagne;56;3;18;084;Le Hézo;829;13;842
53;Bretagne;56;1;17;085;Hœdic;96;6;102
53;Bretagne;56;3;20;087;Île-aux-Moines;613;18;631
53;Bretagne;56;3;20;088;Île-d'Arz;228;8;236
53;Bretagne;56;1;17;086;Île-d'Houat;224;6;230
53;Bretagne;56;1;05;089;Inguiniel;2176;64;2240
53;Bretagne;56;1;05;090;Inzinzac-Lochrist;6526;134;6660
53;Bretagne;56;2;13;091;Josselin;2498;94;2592
53;Bretagne;56;2;15;092;Kerfourn;827;15;842
53;Bretagne;56;2;02;093;Kergrist;722;26;748
53;Bretagne;56;2;02;264;Kernascléden;391;10;401
53;Bretagne;56;1;06;094;Kervignac;6622;211;6833
53;Bretagne;56;1;14;096;Landaul;2345;50;2395
53;Bretagne;56;1;14;097;Landévant;3908;69;3977
53;Bretagne;56;1;07;098;Lanester;23026;472;23498
53;Bretagne;56;2;02;099;Langoëlan;380;6;386
53;Bretagne;56;2;02;100;Langonnet;1739;58;1797
53;Bretagne;56;1;06;101;Languidic;8010;150;8160
53;Bretagne;56;2;13;103;Lantillac;303;4;307
53;Bretagne;56;1;05;104;Lanvaudan;800;11;811
53;Bretagne;56;2;02;105;Lanvénégen;1154;23;1177
53;Bretagne;56;3;20;106;Larmor-Baden;878;18;896
53;Bretagne;56;1;12;107;Larmor-Plage;8327;242;8569
53;Bretagne;56;3;16;108;Larré;1050;20;1070
53;Bretagne;56;3;16;109;Lauzach;1156;27;1183
53;Bretagne;56;2;02;110;Lignol;848;21;869
53;Bretagne;56;3;16;111;Limerzel;1324;22;1346
53;Bretagne;56;3;10;112;Lizio;733;15;748
53;Bretagne;56;2;02;113;Locmalo;906;20;926
53;Bretagne;56;1;17;114;Locmaria;900;29;929
53;Bretagne;56;3;03;115;Locmaria-Grand-Champ;1707;39;1746
53;Bretagne;56;1;01;116;Locmariaquer;1560;45;1605
53;Bretagne;56;2;03;117;Locminé;4437;237;4674
53;Bretagne;56;1;06;118;Locmiquélic;4021;112;4133
53;Bretagne;56;1;17;119;Locoal-Mendon;3437;64;3501
53;Bretagne;56;3;03;120;Locqueltas;1822;39;1861
53;Bretagne;56;1;98;121;Lorient;57084;1459;58543
53;Bretagne;56;2;13;122;Loyat;1622;42;1664
53;Bretagne;56;3;16;123;Malansac;2200;43;2243
53;Bretagne;56;3;10;124;Malestroit;2460;78;2538
53;Bretagne;56;2;02;125;Malguénac;1842;66;1908
53;Bretagne;56;3;11;126;Marzan;2351;27;2378
53;Bretagne;56;2;13;127;Mauron;3113;71;3184
53;Bretagne;56;2;15;128;Melrand;1523;27;1550
53;Bretagne;56;2;13;129;Ménéac;1553;36;1589
53;Bretagne;56;1;14;130;Merlevenez;3218;69;3287
53;Bretagne;56;2;02;131;Meslan;1421;31;1452
53;Bretagne;56;3;21;132;Meucon;2246;52;2298
53;Bretagne;56;3;10;133;Missiriac;1152;27;1179
53;Bretagne;56;2;13;134;Mohon;979;11;990
53;Bretagne;56;3;16;135;Molac;1590;29;1619
53;Bretagne;56;3;04;136;Monteneuf;756;15;771
53;Bretagne;56;3;21;137;Monterblanc;3287;77;3364
53;Bretagne;56;2;13;139;Montertelot;355;10;365
53;Bretagne;56;2;10;140;Moréac;3764;95;3859
53;Bretagne;56;2;03;141;Moustoir-Ac;1768;38;1806
53;Bretagne;56;3;11;143;Muzillac;5041;124;5165
53;Bretagne;56;2;13;145;Néant-sur-Yvel;1098;26;1124
53;Bretagne;56;2;02;146;Neulliac;1395;49;1444
53;Bretagne;56;3;11;147;Nivillac;4645;85;4730
53;Bretagne;56;1;14;148;Nostang;1560;32;1592
53;Bretagne;56;3;11;149;Noyal-Muzillac;2520;52;2572
53;Bretagne;56;2;15;151;Noyal-Pontivy;3619;116;3735
53;Bretagne;56;1;17;152;Le Palais;2552;54;2606
53;Bretagne;56;3;11;153;Péaule;2708;43;2751
53;Bretagne;56;3;04;154;Peillac;1853;50;1903
53;Bretagne;56;3;11;155;Pénestin;2014;26;2040
53;Bretagne;56;2;02;156;Persquen;351;6;357
53;Bretagne;56;3;03;157;Plaudren;1950;55;2005
53;Bretagne;56;3;20;158;Plescop;5999;174;6173
53;Bretagne;56;3;10;159;Pleucadeuc;1803;43;1846
53;Bretagne;56;2;03;160;Pleugriffet;1289;22;1311
53;Bretagne;56;1;17;161;Ploemel;2938;88;3026
53;Bretagne;56;1;12;162;Ploemeur;17790;655;18445
53;Bretagne;56;2;02;163;Ploërdut;1213;26;1239
53;Bretagne;56;3;20;164;Ploeren;6601;221;6822
53;Bretagne;56;2;13;165;Ploërmel ;9787;564;10351
53;Bretagne;56;1;05;166;Plouay;5726;127;5853
53;Bretagne;56;3;20;167;Plougoumelen;2444;80;2524
53;Bretagne;56;1;17;168;Plouharnel;2187;48;2235
53;Bretagne;56;1;14;169;Plouhinec;5367;125;5492
53;Bretagne;56;2;02;170;Plouray;1091;34;1125
53;Bretagne;56;3;16;171;Pluherlin;1530;26;1556
53;Bretagne;56;2;10;172;Plumelec;2673;93;2766
53;Bretagne;56;2;15;173;Pluméliau-Bieuzy ;4363;97;4460
53;Bretagne;56;2;03;174;Plumelin;2733;70;2803
53;Bretagne;56;1;01;175;Plumergat;4145;93;4238
53;Bretagne;56;1;01;176;Pluneret;5796;136;5932
53;Bretagne;56;1;14;177;Pluvigner;7635;140;7775
53;Bretagne;56;1;05;179;Pont-Scorff;3790;84;3874
53;Bretagne;56;2;15;178;Pontivy;14889;930;15819
53;Bretagne;56;3;04;180;Porcaro;725;16;741
53;Bretagne;56;1;06;181;Port-Louis;2636;100;2736
53;Bretagne;56;2;02;182;Priziac;971;181;1152
53;Bretagne;56;3;16;184;Questembert;7723;274;7997
53;Bretagne;56;1;12;185;Quéven;8725;238;8963
53;Bretagne;56;1;17;186;Quiberon;4640;91;4731
53;Bretagne;56;1;05;188;Quistinic;1423;23;1446
53;Bretagne;56;2;03;189;Radenac;1061;16;1077
53;Bretagne;56;2;03;190;Réguiny;1978;52;2030
53;Bretagne;56;3;04;191;Réminiac;398;9;407
53;Bretagne;56;1;06;193;Riantec;5722;142;5864
53;Bretagne;56;3;04;194;Rieux;2855;74;2929
53;Bretagne;56;3;11;195;La Roche-Bernard;699;11;710
53;Bretagne;56;3;16;196;Rochefort-en-Terre;636;13;649
53;Bretagne;56;2;03;198;Rohan;1633;44;1677
53;Bretagne;56;2;02;199;Roudouallec;708;14;722
53;Bretagne;56;3;10;200;Ruffiac;1393;34;1427
53;Bretagne;56;2;02;201;Le Saint;583;11;594
53;Bretagne;56;3;10;202;Saint-Abraham;531;14;545
53;Bretagne;56;2;02;203;Saint-Aignan;618;14;632
53;Bretagne;56;2;10;204;Saint-Allouestre;634;8;642
53;Bretagne;56;3;18;205;Saint-Armel;880;18;898
53;Bretagne;56;3;21;206;Saint-Avé;11787;299;12086
53;Bretagne;56;2;15;207;Saint-Barthélemy;1162;17;1179
53;Bretagne;56;2;13;208;Saint-Brieuc-de-Mauron;318;10;328
53;Bretagne;56;2;02;210;Saint-Caradec-Trégomel;480;6;486
53;Bretagne;56;3;10;211;Saint-Congard;780;17;797
53;Bretagne;56;3;11;212;Saint-Dolay;2515;41;2556
53;Bretagne;56;2;15;213;Saint-Gérand;1126;29;1155
53;Bretagne;56;3;18;214;Saint-Gildas-de-Rhuys;1517;24;1541
53;Bretagne;56;2;15;215;Saint-Gonnery;1104;24;1128
53;Bretagne;56;3;04;216;Saint-Gorgon;393;4;397
53;Bretagne;56;3;16;218;Saint-Gravé;727;5;732
53;Bretagne;56;3;10;219;Saint-Guyomard;1367;22;1389
53;Bretagne;56;3;04;221;Saint-Jacut-les-Pins;1740;95;1835
53;Bretagne;56;2;10;222;Saint-Jean-Brévelay;2808;145;2953
53;Bretagne;56;3;04;223;Saint-Jean-la-Poterie;1485;59;1544
53;Bretagne;56;3;10;224;Saint-Laurent-sur-Oust;374;10;384
53;Bretagne;56;2;13;225;Saint-Léry;195;8;203
53;Bretagne;56;3;04;226;Saint-Malo-de-Beignon;522;23;545
53;Bretagne;56;2;13;227;Saint-Malo-des-Trois-Fontaines;576;14;590
53;Bretagne;56;3;10;228;Saint-Marcel;1090;47;1137
53;Bretagne;56;3;04;229;Saint-Martin-sur-Oust;1292;19;1311
53;Bretagne;56;3;10;230;Saint-Nicolas-du-Tertre;469;11;480
53;Bretagne;56;3;21;231;Saint-Nolff;3838;122;3960
53;Bretagne;56;3;04;232;Saint-Perreux;1110;42;1152
53;Bretagne;56;1;01;233;Saint-Philibert;1492;43;1535
53;Bretagne;56;1;17;234;Saint-Pierre-Quiberon;2056;39;2095
53;Bretagne;56;2;13;236;Saint-Servant;811;18;829
53;Bretagne;56;2;15;237;Saint-Thuriau;1865;76;1941
53;Bretagne;56;2;02;238;Saint-Tugdual;370;9;379
53;Bretagne;56;3;04;239;Saint-Vincent-sur-Oust;1528;41;1569
53;Bretagne;56;1;01;263;Sainte-Anne-d'Auray;2738;113;2851
53;Bretagne;56;2;02;209;Sainte-Brigitte;178;7;185
53;Bretagne;56;1;14;220;Sainte-Hélène;1255;30;1285
53;Bretagne;56;3;18;240;Sarzeau;8487;171;8658
53;Bretagne;56;1;17;241;Sauzon;987;24;1011
53;Bretagne;56;2;02;242;Séglien;658;18;676
53;Bretagne;56;3;18;243;Séné;8946;255;9201
53;Bretagne;56;3;10;244;Sérent;3046;40;3086
53;Bretagne;56;2;02;245;Silfiac;449;13;462
53;Bretagne;56;2;15;246;Le Sourn;2102;44;2146
53;Bretagne;56;3;16;247;Sulniac;3714;88;3802
53;Bretagne;56;3;18;248;Surzur;4502;91;4593
53;Bretagne;56;2;13;249;Taupont;2192;87;2279
53;Bretagne;56;3;04;250;Théhillac;598;5;603
53;Bretagne;56;3;18;251;Theix-Noyalo;8117;232;8349
53;Bretagne;56;3;18;252;Le Tour-du-Parc;1220;8;1228
53;Bretagne;56;3;04;253;Tréal;640;25;665
53;Bretagne;56;3;16;254;Trédion;1293;19;1312
53;Bretagne;56;3;21;255;Treffléan;2321;54;2375
53;Bretagne;56;2;13;256;Tréhorenteuc;119;0;119
53;Bretagne;56;2;13;257;La Trinité-Porhoët;674;17;691
53;Bretagne;56;1;17;258;La Trinité-sur-Mer;1612;47;1659
53;Bretagne;56;3;18;259;La Trinité-Surzur;1655;21;1676
53;Bretagne;56;2;10;197;Val d'Oust;2731;74;2805
53;Bretagne;56;3;99;260;Vannes;53438;1973;55411
53;Bretagne;56;3;16;261;La Vraie-Croix;1488;30;1518
44;Grand Est;57;7;14;001;Aboncourt;340;3;343
44;Grand Est;57;5;23;002;Aboncourt-sur-Seille;71;1;72
44;Grand Est;57;5;17;003;Abreschviller;1413;20;1433
44;Grand Est;57;5;23;004;Achain;80;1;81
44;Grand Est;57;6;02;006;Achen;1001;28;1029
44;Grand Est;57;3;07;007;Adaincourt;127;2;129
44;Grand Est;57;3;07;008;Adelange;206;7;213
44;Grand Est;57;5;23;009;Ajoncourt;103;1;104
44;Grand Est;57;5;23;010;Alaincourt-la-Côte;155;2;157
44;Grand Est;57;5;23;011;Albestroff;641;23;664
44;Grand Est;57;7;01;012;Algrange;6145;56;6201
44;Grand Est;57;3;25;013;Alsting;2562;52;2614
44;Grand Est;57;3;20;014;Altrippe;377;7;384
44;Grand Est;57;3;19;015;Altviller;586;7;593
44;Grand Est;57;3;04;016;Alzing;389;8;397
44;Grand Est;57;9;18;017;Amanvillers;2128;23;2151
44;Grand Est;57;5;23;018;Amelécourt;143;9;152
44;Grand Est;57;9;18;019;Amnéville;10505;72;10577
44;Grand Est;57;9;07;020;Ancerville;304;3;307
44;Grand Est;57;9;05;021;Ancy-Dornot;1539;30;1569
44;Grand Est;57;7;01;022;Angevillers;1252;29;1281
44;Grand Est;57;9;16;024;Antilly;175;0;175
44;Grand Est;57;3;04;025;Anzeling;524;7;531
44;Grand Est;57;7;04;026;Apach;1061;17;1078
44;Grand Est;57;9;16;028;Argancy;1341;39;1380
44;Grand Est;57;3;07;027;Arraincourt;125;3;128
44;Grand Est;57;3;07;029;Arriance;213;3;216
44;Grand Est;57;9;05;030;Arry;561;3;564
44;Grand Est;57;9;16;031;Ars-Laquenexy;915;15;930
44;Grand Est;57;9;05;032;Ars-sur-Moselle;4714;53;4767
44;Grand Est;57;5;17;033;Arzviller;537;15;552
44;Grand Est;57;5;17;034;Aspach;34;1;35
44;Grand Est;57;5;21;035;Assenoncourt;117;3;120
44;Grand Est;57;5;23;036;Attilloncourt;104;0;104
44;Grand Est;57;9;07;037;Aube;269;5;274
44;Grand Est;57;7;01;038;Audun-le-Tiche;6976;62;7038
44;Grand Est;57;9;05;039;Augny;2080;33;2113
44;Grand Est;57;5;23;040;Aulnois-sur-Seille;278;2;280
44;Grand Est;57;7;01;041;Aumetz;2325;32;2357
44;Grand Est;57;5;21;042;Avricourt;602;12;614
44;Grand Est;57;9;16;043;Ay-sur-Moselle;1484;30;1514
44;Grand Est;57;5;21;044;Azoudange;118;5;123
44;Grand Est;57;5;23;045;Bacourt;110;1;111
44;Grand Est;57;6;02;046;Baerenthal;771;14;785
44;Grand Est;57;3;07;047;Bambiderstroff;1062;20;1082
44;Grand Est;57;9;15;049;Le Ban-Saint-Martin;4429;71;4500
44;Grand Est;57;3;03;048;Bannay;74;2;76
44;Grand Est;57;5;17;050;Barchain;110;2;112
44;Grand Est;57;3;20;051;Baronville;366;4;370
44;Grand Est;57;3;09;052;Barst;575;9;584
44;Grand Est;57;7;14;287;Basse-Ham;2232;44;2276
44;Grand Est;57;7;27;574;Basse-Rentgen;501;12;513
44;Grand Est;57;5;23;053;Bassing;115;6;121
44;Grand Est;57;5;23;054;Baudrecourt;188;0;188
44;Grand Est;57;9;16;055;Bazoncourt;538;3;541
44;Grand Est;57;5;21;056;Bébing;197;5;202
44;Grand Est;57;9;07;057;Béchy;619;6;625
44;Grand Est;57;3;25;058;Behren-lès-Forbach;6604;65;6669
44;Grand Est;57;5;23;059;Bellange;53;2;55
44;Grand Est;57;5;21;086;Belles-Forêts;240;5;245
44;Grand Est;57;5;23;060;Bénestroff;541;7;548
44;Grand Est;57;3;09;061;Béning-lès-Saint-Avold;1146;26;1172
44;Grand Est;57;7;27;062;Berg-sur-Moselle;431;14;445
44;Grand Est;57;3;20;063;Bérig-Vintrange;217;8;225
44;Grand Est;57;5;17;064;Berling;265;4;269
44;Grand Est;57;5;23;065;Bermering;223;6;229
44;Grand Est;57;5;21;066;Berthelming;513;8;521
44;Grand Est;57;7;14;067;Bertrange;2721;56;2777
44;Grand Est;57;3;04;069;Berviller-en-Moselle;466;7;473
44;Grand Est;57;3;03;070;Bettange;249;2;251
44;Grand Est;57;5;21;071;Bettborn;391;5;396
44;Grand Est;57;7;14;072;Bettelainville;623;8;631
44;Grand Est;57;3;09;073;Betting;877;16;893
44;Grand Est;57;6;02;074;Bettviller;827;17;844
44;Grand Est;57;9;07;075;Beux;284;3;287
44;Grand Est;57;7;27;076;Beyren-lès-Sierck;508;17;525
44;Grand Est;57;5;23;077;Bezange-la-Petite;94;3;97
44;Grand Est;57;3;04;079;Bibiche;450;9;459
44;Grand Est;57;5;21;080;Bickenholtz;84;0;84
44;Grand Est;57;5;23;081;Bidestroff;130;1;131
44;Grand Est;57;3;20;082;Biding;327;7;334
44;Grand Est;57;6;02;083;Bining;1193;25;1218
44;Grand Est;57;5;23;084;Bioncourt;305;2;307
44;Grand Est;57;3;03;085;Bionville-sur-Nied;383;2;385
44;Grand Est;57;3;03;087;Bisten-en-Lorraine;248;4;252
44;Grand Est;57;3;20;088;Bistroff;313;7;320
44;Grand Est;57;6;02;089;Bitche;5025;110;5135
44;Grand Est;57;5;23;090;Blanche-Église;112;2;114
44;Grand Est;57;6;22;092;Blies-Ébersing;633;8;641
44;Grand Est;57;6;22;093;Blies-Guersviller;648;12;660
44;Grand Est;57;6;22;091;Bliesbruck;1018;21;1039
44;Grand Est;57;3;07;095;Boucheporn;579;9;588
44;Grand Est;57;7;01;096;Boulange;2485;25;2510
44;Grand Est;57;3;03;097;Boulay-Moselle;5591;70;5661
44;Grand Est;57;5;23;099;Bourdonnay;229;5;234
44;Grand Est;57;5;23;098;Bourgaltroff;242;13;255
44;Grand Est;57;5;17;100;Bourscheid;176;5;181
44;Grand Est;57;3;25;101;Bousbach;1235;24;1259
44;Grand Est;57;7;14;102;Bousse;3189;48;3237
44;Grand Est;57;6;02;103;Bousseviller;125;4;129
44;Grand Est;57;7;27;104;Boust;1204;28;1232
44;Grand Est;57;3;20;105;Boustroff;149;1;150
44;Grand Est;57;3;04;106;Bouzonville;3923;78;4001
44;Grand Est;57;5;23;107;Bréhain;107;0;107
44;Grand Est;57;6;02;108;Breidenbach;323;5;328
44;Grand Est;57;7;27;109;Breistroff-la-Grande;729;11;740
44;Grand Est;57;3;04;110;Brettnach;436;2;438
44;Grand Est;57;9;18;111;Bronvaux;536;3;539
44;Grand Est;57;3;03;112;Brouck;84;1;85
44;Grand Est;57;5;17;113;Brouderdorff;971;22;993
44;Grand Est;57;5;17;114;Brouviller;426;15;441
44;Grand Est;57;3;20;115;Brulange;98;4;102
44;Grand Est;57;9;07;116;Buchy;97;1;98
44;Grand Est;57;7;14;117;Buding;591;5;596
44;Grand Est;57;7;14;118;Budling;172;6;178
44;Grand Est;57;5;21;119;Buhl-Lorraine;1202;31;1233
44;Grand Est;57;5;23;120;Burlioncourt;128;3;131
44;Grand Est;57;9;16;121;Burtoncourt;204;5;209
44;Grand Est;57;3;09;122;Cappel;693;11;704
44;Grand Est;57;3;19;123;Carling;3433;43;3476
44;Grand Est;57;7;27;124;Cattenom;2643;34;2677
44;Grand Est;57;9;16;125;Chailly-lès-Ennery;399;6;405
44;Grand Est;57;5;23;126;Chambrey;331;10;341
44;Grand Est;57;9;07;127;Chanville;140;1;141
44;Grand Est;57;9;16;128;Charleville-sous-Bois;320;3;323
44;Grand Est;57;9;16;129;Charly-Oradour;679;21;700
44;Grand Est;57;5;23;130;Château-Bréhain;76;1;77
44;Grand Est;57;3;04;131;Château-Rouge;289;11;300
44;Grand Est;57;5;23;132;Château-Salins;2410;252;2662
44;Grand Est;57;5;23;133;Château-Voué;98;0;98
44;Grand Est;57;9;05;134;Châtel-Saint-Germain;1894;174;2068
44;Grand Est;57;3;04;136;Chémery-les-Deux;568;17;585
44;Grand Est;57;9;07;137;Cheminot;775;13;788
44;Grand Est;57;5;23;138;Chenois;83;3;86
44;Grand Est;57;9;07;139;Chérisey;298;6;304
44;Grand Est;57;9;16;140;Chesny;586;10;596
44;Grand Est;57;5;23;141;Chicourt;93;0;93
44;Grand Est;57;9;16;142;Chieulles;419;7;426
44;Grand Est;57;7;10;143;Clouange;3389;34;3423
44;Grand Est;57;3;08;144;Cocheren;3429;43;3472
44;Grand Est;57;9;05;146;Coin-lès-Cuvry;761;18;779
44;Grand Est;57;9;05;147;Coin-sur-Seille;338;14;352
44;Grand Est;57;9;16;145;Coincy;320;5;325
44;Grand Est;57;9;16;148;Colligny-Maizery;575;11;586
44;Grand Est;57;3;04;149;Colmen;199;4;203
44;Grand Est;57;3;03;150;Condé-Northen;688;8;696
44;Grand Est;57;5;23;151;Conthil;159;2;161
44;Grand Est;57;7;04;152;Contz-les-Bains;508;10;518
44;Grand Est;57;9;05;153;Corny-sur-Moselle;2202;40;2242
44;Grand Est;57;3;03;154;Coume;648;20;668
44;Grand Est;57;9;16;155;Courcelles-Chaussy;3051;324;3375
44;Grand Est;57;9;16;156;Courcelles-sur-Nied;1182;11;1193
44;Grand Est;57;5;23;158;Craincourt;250;1;251
44;Grand Est;57;3;07;159;Créhange;3877;57;3934
44;Grand Est;57;3;03;160;Creutzwald;13070;219;13289
44;Grand Est;57;5;23;161;Cutting;128;1;129
44;Grand Est;57;9;05;162;Cuvry;856;14;870
44;Grand Est;57;5;17;163;Dabo;2476;48;2524
44;Grand Est;57;3;04;165;Dalem;668;9;677
44;Grand Est;57;5;23;166;Dalhain;109;2;111
44;Grand Est;57;3;04;167;Dalstein;368;6;374
44;Grand Est;57;5;17;168;Danne-et-Quatre-Vents;683;16;699
44;Grand Est;57;5;17;169;Dannelbourg;499;16;515
44;Grand Est;57;5;23;171;Delme;1138;9;1147
44;Grand Est;57;3;03;172;Denting;282;1;283
44;Grand Est;57;5;21;173;Desseling;99;3;102
44;Grand Est;57;3;20;174;Destry;95;1;96
44;Grand Est;57;5;21;175;Diane-Capelle;220;6;226
44;Grand Est;57;3;25;176;Diebling;1641;40;1681
44;Grand Est;57;3;19;765;Diesen;1057;15;1072
44;Grand Est;57;5;23;177;Dieuze;2868;234;3102
44;Grand Est;57;3;20;178;Diffembach-lès-Hellimer;349;6;355
44;Grand Est;57;7;14;179;Distroff;1800;33;1833
44;Grand Est;57;5;21;180;Dolving;349;7;356
44;Grand Est;57;5;23;181;Domnom-lès-Dieuze;79;1;80
44;Grand Est;57;5;23;182;Donjeux;95;3;98
44;Grand Est;57;5;23;183;Donnelay;190;2;192
44;Grand Est;57;3;04;186;Ébersviller;951;11;962
44;Grand Est;57;3;03;187;Éblange;370;6;376
44;Grand Est;57;6;02;188;Éguelshardt;426;77;503
44;Grand Est;57;3;20;189;Eincheville;221;2;223
44;Grand Est;57;3;07;190;Elvange;410;4;414
44;Grand Est;57;7;14;191;Elzange;713;8;721
44;Grand Est;57;6;02;192;Enchenberg;1234;33;1267
44;Grand Est;57;9;16;193;Ennery;2083;24;2107
44;Grand Est;57;7;27;194;Entrange;1239;37;1276
44;Grand Est;57;6;02;195;Epping;573;15;588
44;Grand Est;57;6;02;196;Erching;422;11;433
44;Grand Est;57;6;20;197;Ernestviller;508;5;513
44;Grand Est;57;3;20;198;Erstroff;193;3;196
44;Grand Est;57;7;27;199;Escherange;659;14;673
44;Grand Est;57;9;16;200;Les Étangs;402;10;412
44;Grand Est;57;6;02;201;Etting;737;13;750
44;Grand Est;57;3;25;202;Etzling;1172;17;1189
44;Grand Est;57;7;27;203;Évrange;234;4;238
44;Grand Est;57;9;16;204;Failly;520;10;530
44;Grand Est;57;3;04;205;Falck;2495;31;2526
44;Grand Est;57;7;06;206;Fameck;14243;154;14397
44;Grand Est;57;3;09;207;Farébersviller;5509;58;5567
44;Grand Est;57;3;25;208;Farschviller;1357;33;1390
44;Grand Est;57;3;07;209;Faulquemont;5230;87;5317
44;Grand Est;57;5;21;210;Fénétrange;709;17;726
44;Grand Est;57;9;18;211;Fèves;1155;12;1167
44;Grand Est;57;9;05;212;Féy;734;9;743
44;Grand Est;57;3;04;213;Filstroff;773;14;787
44;Grand Est;57;7;27;214;Fixem;413;7;420
44;Grand Est;57;7;04;215;Flastroff;324;4;328
44;Grand Est;57;5;21;216;Fleisheim;144;5;149
44;Grand Est;57;3;07;217;Flétrange;916;18;934
44;Grand Est;57;9;07;218;Fleury;1268;29;1297
44;Grand Est;57;9;16;219;Flévy;549;6;555
44;Grand Est;57;9;07;220;Flocourt;117;2;119
44;Grand Est;57;7;06;221;Florange;11864;92;11956
44;Grand Est;57;3;25;222;Folkling;1312;38;1350
44;Grand Est;57;3;19;224;Folschviller;3945;70;4015
44;Grand Est;57;5;23;225;Fonteny;140;0;140
44;Grand Est;57;7;01;226;Fontoy;3096;40;3136
44;Grand Est;57;3;08;227;Forbach;21652;292;21944
44;Grand Est;57;5;23;228;Fossieux;210;5;215
44;Grand Est;57;5;21;229;Foulcrey;160;3;163
44;Grand Est;57;3;07;230;Fouligny;195;2;197
44;Grand Est;57;9;23;231;Foville;99;0;99
44;Grand Est;57;5;23;232;Francaltroff;778;12;790
44;Grand Est;57;5;17;233;Fraquelfing;85;1;86
44;Grand Est;57;6;22;234;Frauenberg;600;8;608
44;Grand Est;57;3;04;235;Freistroff;1041;20;1061
44;Grand Est;57;5;23;236;Frémery;81;0;81
44;Grand Est;57;3;20;237;Frémestroff;304;7;311
44;Grand Est;57;5;23;238;Fresnes-en-Saulnois;186;6;192
44;Grand Est;57;3;20;239;Freybouse;430;6;436
44;Grand Est;57;3;09;240;Freyming-Merlebach;12844;126;12970
44;Grand Est;57;5;21;241;Fribourg;165;8;173
44;Grand Est;57;7;10;242;Gandrange;2967;35;3002
44;Grand Est;57;5;17;244;Garrebourg;494;11;505
44;Grand Est;57;7;27;245;Gavisse;565;9;574
44;Grand Est;57;5;23;246;Gelucourt;213;4;217
44;Grand Est;57;5;23;247;Gerbécourt;82;3;85
44;Grand Est;57;5;23;248;Givrycourt;87;1;88
44;Grand Est;57;9;16;249;Glatigny;261;7;268
44;Grand Est;57;6;02;250;Goetzenbruck;1510;40;1550
44;Grand Est;57;9;07;251;Goin;337;2;339
44;Grand Est;57;3;03;252;Gomelange;487;10;497
44;Grand Est;57;5;21;253;Gondrexange;500;3;503
44;Grand Est;57;9;05;254;Gorze;1158;10;1168
44;Grand Est;57;5;21;255;Gosselming;580;23;603
44;Grand Est;57;9;05;256;Gravelotte;829;4;833
44;Grand Est;57;5;23;257;Grémecey;105;0;105
44;Grand Est;57;3;20;258;Gréning;124;1;125
44;Grand Est;57;7;04;259;Grindorff-Bizing;318;7;325
44;Grand Est;57;6;02;261;Gros-Réderching;1346;40;1386
44;Grand Est;57;6;22;260;Grosbliederstroff;3281;53;3334
44;Grand Est;57;3;20;262;Grostenquin;641;7;648
44;Grand Est;57;6;20;263;Grundviller;645;19;664
44;Grand Est;57;6;20;264;Guebenhouse;419;6;425
44;Grand Est;57;5;23;265;Guébestroff;53;4;57
44;Grand Est;57;5;23;266;Guéblange-lès-Dieuze;149;4;153
44;Grand Est;57;5;23;268;Guébling;123;4;127
44;Grand Est;57;7;14;269;Guénange;7341;66;7407
44;Grand Est;57;3;09;271;Guenviller;656;16;672
44;Grand Est;57;5;21;272;Guermange;90;5;95
44;Grand Est;57;3;04;273;Guerstling;405;9;414
44;Grand Est;57;3;03;274;Guerting;847;20;867
44;Grand Est;57;3;20;275;Guessling-Hémering;922;12;934
44;Grand Est;57;3;07;276;Guinglange;326;5;331
44;Grand Est;57;3;03;277;Guinkirchen;151;6;157
44;Grand Est;57;5;23;278;Guinzeling;68;0;68
44;Grand Est;57;5;17;280;Guntzviller;377;21;398
44;Grand Est;57;5;23;281;Haboudange;256;5;261
44;Grand Est;57;7;27;282;Hagen;360;4;364
44;Grand Est;57;9;24;283;Hagondange;9243;105;9348
44;Grand Est;57;3;07;284;Hallering;112;5;117
44;Grand Est;57;7;04;286;Halstroff;306;9;315
44;Grand Est;57;3;03;288;Ham-sous-Varsberg;2831;40;2871
44;Grand Est;57;6;22;289;Hambach;2896;67;2963
44;Grand Est;57;5;23;290;Hampont;183;2;185
44;Grand Est;57;3;07;293;Han-sur-Nied;257;6;263
44;Grand Est;57;5;17;291;Hangviller;262;4;266
44;Grand Est;57;5;23;292;Hannocourt;21;0;21
44;Grand Est;57;6;02;294;Hanviller;206;8;214
44;Grand Est;57;5;23;295;Haraucourt-sur-Seille;104;1;105
44;Grand Est;57;3;04;296;Hargarten-aux-Mines;1096;20;1116
44;Grand Est;57;3;20;297;Harprich;178;6;184
44;Grand Est;57;5;17;298;Harreberg;389;7;396
44;Grand Est;57;5;17;299;Hartzviller;915;16;931
44;Grand Est;57;5;17;300;Haselbourg;315;7;322
44;Grand Est;57;6;02;301;Haspelschiedt;301;12;313
44;Grand Est;57;5;17;302;Hattigny;193;1;194
44;Grand Est;57;9;24;303;Hauconcourt;611;8;619
44;Grand Est;57;5;21;304;Haut-Clocher;354;11;365
44;Grand Est;57;7;04;371;Haute-Kontz;584;7;591
44;Grand Est;57;3;07;714;Haute-Vigneulles;423;9;432
44;Grand Est;57;7;01;305;Havange;453;8;461
44;Grand Est;57;7;10;306;Hayange;15888;185;16073
44;Grand Est;57;9;16;307;Hayes;240;5;245
44;Grand Est;57;6;20;308;Hazembourg;144;5;149
44;Grand Est;57;3;04;309;Heining-lès-Bouzonville;480;9;489
44;Grand Est;57;5;21;310;Hellering-lès-Fénétrange;189;4;193
44;Grand Est;57;3;20;311;Hellimer;535;9;544
44;Grand Est;57;3;03;312;Helstroff;520;8;528
44;Grand Est;57;3;07;313;Hémilly;142;3;145
44;Grand Est;57;5;17;314;Héming;498;3;501
44;Grand Est;57;5;17;315;Henridorff;706;15;721
44;Grand Est;57;3;09;316;Henriville;748;16;764
44;Grand Est;57;5;17;317;Hérange;108;4;112
44;Grand Est;57;5;17;318;Hermelange;220;5;225
44;Grand Est;57;3;07;319;Herny;513;5;518
44;Grand Est;57;5;21;320;Hertzing;186;3;189
44;Grand Est;57;5;17;321;Hesse;568;19;587
44;Grand Est;57;3;04;322;Hestroff;457;6;463
44;Grand Est;57;7;27;323;Hettange-Grande;7689;165;7854
44;Grand Est;57;5;21;324;Hilbesheim;602;21;623
44;Grand Est;57;6;20;325;Hilsprich;844;17;861
44;Grand Est;57;3;03;326;Hinckange;335;4;339
44;Grand Est;57;3;07;328;Holacourt;88;2;90
44;Grand Est;57;3;04;329;Holling;437;11;448
44;Grand Est;57;6;20;330;Holving;1287;21;1308
44;Grand Est;57;7;14;331;Hombourg-Budange;550;10;560
44;Grand Est;57;3;09;332;Hombourg-Haut;6272;62;6334
44;Grand Est;57;5;21;333;Hommarting;838;23;861
44;Grand Est;57;5;17;334;Hommert;329;10;339
44;Grand Est;57;5;23;335;Honskirch;223;4;227
44;Grand Est;57;3;19;336;L' Hôpital;5290;57;5347
44;Grand Est;57;3;09;337;Hoste;602;17;619
44;Grand Est;57;6;02;338;Hottviller;522;6;528
44;Grand Est;57;5;17;339;Hultehouse;364;7;371
44;Grand Est;57;6;22;340;Hundling;1351;20;1371
44;Grand Est;57;7;04;341;Hunting;711;16;727
44;Grand Est;57;5;21;342;Ibigny;96;1;97
44;Grand Est;57;7;27;343;Illange;1851;31;1882
44;Grand Est;57;5;21;344;Imling;729;9;738
44;Grand Est;57;7;14;345;Inglange;432;30;462
44;Grand Est;57;5;23;346;Insming;588;23;611
44;Grand Est;57;5;23;347;Insviller;176;3;179
44;Grand Est;57;6;22;348;Ippling;792;17;809
44;Grand Est;57;5;23;349;Jallaucourt;160;3;163
44;Grand Est;57;9;05;350;Jouy-aux-Arches;1456;20;1476
44;Grand Est;57;9;16;351;Jury;1130;18;1148
44;Grand Est;57;9;05;352;Jussy;444;15;459
44;Grand Est;57;5;23;353;Juvelize;72;1;73
44;Grand Est;57;5;23;354;Juville;122;5;127
44;Grand Est;57;6;22;355;Kalhausen;822;17;839
44;Grand Est;57;7;27;356;Kanfen;1207;22;1229
44;Grand Est;57;6;20;357;Kappelkinger;401;2;403
44;Grand Est;57;7;14;358;Kédange-sur-Canner;1083;22;1105
44;Grand Est;57;7;14;359;Kemplich;169;4;173
44;Grand Est;57;3;25;360;Kerbach;1189;33;1222
44;Grand Est;57;7;04;361;Kerling-lès-Sierck;592;17;609
44;Grand Est;57;5;21;362;Kerprich-aux-Bois;168;3;171
44;Grand Est;57;7;04;364;Kirsch-lès-Sierck;310;7;317
44;Grand Est;57;7;04;365;Kirschnaumen;478;11;489
44;Grand Est;57;6;20;366;Kirviller;138;2;140
44;Grand Est;57;7;14;367;Klang;232;4;236
44;Grand Est;57;7;01;368;Knutange;3195;59;3254
44;Grand Est;57;7;14;372;Kuntzig;1355;15;1370
44;Grand Est;57;7;14;370;Kœnigsmacker;2251;39;2290
44;Grand Est;57;3;19;373;Lachambre;917;27;944
44;Grand Est;57;5;17;374;Lafrimbolle;201;6;207
44;Grand Est;57;5;23;375;Lagarde;188;1;189
44;Grand Est;57;6;02;376;Lambach;505;6;511
44;Grand Est;57;5;17;377;Landange;241;4;245
44;Grand Est;57;3;20;379;Landroff;272;2;274
44;Grand Est;57;5;23;381;Laneuveville-en-Saulnois;297;6;303
44;Grand Est;57;5;17;380;Laneuveville-lès-Lorquin;104;3;107
44;Grand Est;57;5;21;382;Langatte;560;6;566
44;Grand Est;57;5;21;383;Languimberg;168;6;174
44;Grand Est;57;3;20;384;Laning;613;18;631
44;Grand Est;57;9;16;385;Laquenexy;1181;22;1203
44;Grand Est;57;3;07;386;Laudrefang;343;7;350
44;Grand Est;57;7;04;387;Laumesfeld;289;1;290
44;Grand Est;57;7;04;388;Launstroff;265;4;269
44;Grand Est;57;3;20;389;Lelling;472;12;484
44;Grand Est;57;6;02;390;Lemberg;1443;39;1482
44;Grand Est;57;5;23;391;Lemoncourt;68;1;69
44;Grand Est;57;9;07;392;Lemud;515;4;519
44;Grand Est;57;6;02;393;Lengelsheim;203;3;206
44;Grand Est;57;5;23;394;Léning;342;12;354
44;Grand Est;57;5;23;395;Lesse;205;4;209
44;Grand Est;57;9;05;396;Lessy;740;28;768
44;Grand Est;57;5;23;397;Ley;99;1;100
44;Grand Est;57;3;20;398;Leyviller;497;8;505
44;Grand Est;57;5;23;399;Lezey;97;8;105
44;Grand Est;57;5;23;410;Lhor;136;3;139
44;Grand Est;57;5;23;401;Lidrezing;85;1;86
44;Grand Est;57;6;02;402;Liederschiedt;121;4;125
44;Grand Est;57;9;07;403;Liéhon;119;0;119
44;Grand Est;57;5;23;404;Lindre-Basse;213;7;220
44;Grand Est;57;5;23;405;Lindre-Haute;51;1;52
44;Grand Est;57;5;23;406;Liocourt;136;7;143
44;Grand Est;57;5;17;407;Lixheim;586;6;592
44;Grand Est;57;6;22;408;Lixing-lès-Rouhling;907;21;928
44;Grand Est;57;3;20;409;Lixing-lès-Saint-Avold;673;16;689
44;Grand Est;57;7;01;411;Lommerange;318;1;319
44;Grand Est;57;9;15;412;Longeville-lès-Metz;3993;64;4057
44;Grand Est;57;3;07;413;Longeville-lès-Saint-Avold;3635;83;3718
44;Grand Est;57;5;17;414;Lorquin;1149;26;1175
44;Grand Est;57;9;05;415;Lorry-lès-Metz;1766;76;1842
44;Grand Est;57;9;05;416;Lorry-Mardigny;651;16;667
44;Grand Est;57;5;23;417;Lostroff;69;0;69
44;Grand Est;57;5;23;418;Loudrefing;322;4;326
44;Grand Est;57;6;20;419;Loupershouse;909;23;932
44;Grand Est;57;6;02;421;Loutzviller;151;3;154
44;Grand Est;57;9;07;422;Louvigny;890;11;901
44;Grand Est;57;5;23;423;Lubécourt;74;0;74
44;Grand Est;57;5;23;424;Lucy;229;2;231
44;Grand Est;57;9;07;425;Luppy;574;4;578
44;Grand Est;57;7;14;426;Luttange;899;8;907
44;Grand Est;57;5;17;427;Lutzelbourg;572;10;582
44;Grand Est;57;3;19;428;Macheren;2761;67;2828
44;Grand Est;57;3;07;430;Mainvillers;332;5;337
44;Grand Est;57;9;16;431;Maizeroy;395;3;398
44;Grand Est;57;9;24;433;Maizières-lès-Metz;11490;126;11616
44;Grand Est;57;5;23;434;Maizières-lès-Vic;494;9;503
44;Grand Est;57;5;23;436;Malaucourt-sur-Seille;125;6;131
44;Grand Est;57;7;04;437;Malling;626;14;640
44;Grand Est;57;9;16;438;Malroy;351;5;356
44;Grand Est;57;7;04;439;Manderen-Ritzing ;596;13;609
44;Grand Est;57;5;23;440;Manhoué;142;3;145
44;Grand Est;57;7;27;441;Manom;2891;58;2949
44;Grand Est;57;3;07;442;Many;251;2;253
44;Grand Est;57;9;18;443;Marange-Silvange;6319;56;6375
44;Grand Est;57;3;07;444;Marange-Zondrange;346;2;348
44;Grand Est;57;9;05;445;Marieulles;704;9;713
44;Grand Est;57;5;23;446;Marimont-lès-Bénestroff;39;1;40
44;Grand Est;57;9;15;447;Marly;10160;231;10391
44;Grand Est;57;5;23;448;Marsal;270;7;277
44;Grand Est;57;9;16;449;Marsilly;586;6;592
44;Grand Est;57;5;23;451;Marthille;170;3;173
44;Grand Est;57;9;24;452;La Maxe;968;15;983
44;Grand Est;57;3;20;453;Maxstadt;307;10;317
44;Grand Est;57;9;16;454;Mécleuves;1148;24;1172
44;Grand Est;57;3;03;455;Mégange;155;3;158
44;Grand Est;57;6;02;456;Meisenthal;685;25;710
44;Grand Est;57;3;04;457;Menskirch;140;2;142
44;Grand Est;57;7;04;459;Merschweiller;268;2;270
44;Grand Est;57;3;04;460;Merten;1493;27;1520
44;Grand Est;57;5;17;461;Métairies-Saint-Quirin;269;8;277
44;Grand Est;57;5;17;462;Metting;414;7;421
44;Grand Est;57;9;98;463;Metz;116581;1841;118422
44;Grand Est;57;7;14;464;Metzeresche;959;28;987
44;Grand Est;57;7;14;465;Metzervisse;2268;53;2321
44;Grand Est;57;3;25;466;Metzing;652;10;662
44;Grand Est;57;9;16;467;Mey;281;2;283
44;Grand Est;57;5;17;468;Mittelbronn;691;10;701
44;Grand Est;57;5;21;469;Mittersheim;600;5;605
44;Grand Est;57;5;23;470;Molring;5;0;5
44;Grand Est;57;3;03;471;Momerstroff;291;3;294
44;Grand Est;57;9;23;472;Moncheux;148;0;148
44;Grand Est;57;5;23;473;Moncourt;68;2;70
44;Grand Est;57;7;06;474;Mondelange;5655;77;5732
44;Grand Est;57;7;27;475;Mondorff;513;14;527
44;Grand Est;57;7;14;476;Monneren;416;6;422
44;Grand Est;57;6;02;477;Montbronn;1629;43;1672
44;Grand Est;57;5;23;478;Montdidier;84;0;84
44;Grand Est;57;7;04;479;Montenach;462;12;474
44;Grand Est;57;9;15;480;Montigny-lès-Metz;21749;363;22112
44;Grand Est;57;9;18;481;Montois-la-Montagne;2722;18;2740
44;Grand Est;57;3;20;483;Morhange;3426;84;3510
44;Grand Est;57;3;08;484;Morsbach;2691;29;2720
44;Grand Est;57;5;23;485;Morville-lès-Vic;123;2;125
44;Grand Est;57;5;23;486;Morville-sur-Nied;117;1;118
44;Grand Est;57;9;05;487;Moulins-lès-Metz;5016;61;5077
44;Grand Est;57;5;21;488;Moussey;562;9;571
44;Grand Est;57;6;02;489;Mouterhouse;309;6;315
44;Grand Est;57;5;23;490;Moyenvic;355;4;359
44;Grand Est;57;7;10;491;Moyeuvre-Grande;7662;66;7728
44;Grand Est;57;7;10;492;Moyeuvre-Petite;457;8;465
44;Grand Est;57;5;23;493;Mulcey;211;5;216
44;Grand Est;57;5;23;494;Munster;244;0;244
44;Grand Est;57;3;03;495;Narbéfontaine;118;1;119
44;Grand Est;57;5;23;496;Nébing;340;5;345
44;Grand Est;57;6;20;497;Nelling;263;9;272
44;Grand Est;57;7;01;498;Neufchef;2591;52;2643
44;Grand Est;57;6;22;499;Neufgrange;1366;30;1396
44;Grand Est;57;5;17;500;Neufmoulins;43;0;43
44;Grand Est;57;5;23;501;Neufvillage;35;0;35
44;Grand Est;57;3;04;502;Neunkirchen-lès-Bouzonville;335;12;347
44;Grand Est;57;5;17;504;Niderhoff;283;4;287
44;Grand Est;57;5;17;505;Niderviller;1220;22;1242
44;Grand Est;57;5;21;506;Niederstinzel;253;1;254
44;Grand Est;57;3;03;507;Niedervisse;261;2;263
44;Grand Est;57;7;01;508;Nilvange;4601;54;4655
44;Grand Est;57;5;17;509;Nitting;472;10;482
44;Grand Est;57;9;16;510;Noisseville;1042;10;1052
44;Grand Est;57;9;18;511;Norroy-le-Veneur;1047;22;1069
44;Grand Est;57;9;16;512;Nouilly;719;11;730
44;Grand Est;57;6;02;513;Nousseviller-lès-Bitche;145;1;146
44;Grand Est;57;3;25;514;Nousseviller-Saint-Nabor;1202;25;1227
44;Grand Est;57;9;05;515;Novéant-sur-Moselle;1810;24;1834
44;Grand Est;57;3;04;516;Oberdorff;340;10;350
44;Grand Est;57;6;02;517;Obergailbach;290;4;294
44;Grand Est;57;5;21;518;Oberstinzel;338;9;347
44;Grand Est;57;3;03;519;Obervisse;158;3;161
44;Grand Est;57;5;23;520;Obreck;35;2;37
44;Grand Est;57;9;16;482;Ogy-Montoy-Flanville;1742;30;1772
44;Grand Est;57;5;23;524;Ommeray;128;1;129
44;Grand Est;57;5;23;525;Oriocourt;56;1;57
44;Grand Est;57;6;02;526;Ormersviller;385;1;386
44;Grand Est;57;9;07;527;Orny;357;4;361
44;Grand Est;57;5;23;528;Oron;97;1;98
44;Grand Est;57;7;01;529;Ottange;3074;65;3139
44;Grand Est;57;3;03;530;Ottonville;441;6;447
44;Grand Est;57;7;14;531;Oudrenne;746;13;759
44;Grand Est;57;9;07;532;Pagny-lès-Goin;233;3;236
44;Grand Est;57;9;16;533;Pange;873;18;891
44;Grand Est;57;9;16;534;Peltre;1849;122;1971
44;Grand Est;57;6;02;535;Petit-Réderching;1465;36;1501
44;Grand Est;57;3;20;536;Petit-Tenquin;226;5;231
44;Grand Est;57;3;08;537;Petite-Rosselle;6322;98;6420
44;Grand Est;57;5;23;538;Pettoncourt;292;2;294
44;Grand Est;57;5;23;539;Pévange;49;3;52
44;Grand Est;57;5;17;540;Phalsbourg;4728;250;4978
44;Grand Est;57;6;02;541;Philippsbourg;602;17;619
44;Grand Est;57;3;03;542;Piblange;993;11;1004
44;Grand Est;57;9;18;543;Pierrevillers;1508;23;1531
44;Grand Est;57;5;17;544;Plaine-de-Walsch;623;16;639
44;Grand Est;57;9;15;545;Plappeville;2009;56;2065
44;Grand Est;57;9;18;546;Plesnois;818;31;849
44;Grand Est;57;9;07;547;Pommérieux;699;9;708
44;Grand Est;57;9;07;548;Pontoy;504;6;510
44;Grand Est;57;3;07;549;Pontpierre;729;15;744
44;Grand Est;57;3;19;550;Porcelette;2480;66;2546
44;Grand Est;57;5;21;551;Postroff;210;1;211
44;Grand Est;57;9;05;552;Pouilly;606;8;614
44;Grand Est;57;9;05;553;Pournoy-la-Chétive;635;4;639
44;Grand Est;57;9;07;554;Pournoy-la-Grasse;660;20;680
44;Grand Est;57;5;23;555;Prévocourt;111;0;111
44;Grand Est;57;6;20;556;Puttelange-aux-Lacs;3057;45;3102
44;Grand Est;57;7;27;557;Puttelange-lès-Thionville;992;24;1016
44;Grand Est;57;5;23;558;Puttigny;83;0;83
44;Grand Est;57;5;23;559;Puzieux;181;0;181
44;Grand Est;57;3;20;560;Racrange;614;12;626
44;Grand Est;57;6;02;561;Rahling;751;20;771
44;Grand Est;57;7;10;562;Ranguevaux;828;18;846
44;Grand Est;57;9;16;563;Raville;259;2;261
44;Grand Est;57;5;21;564;Réchicourt-le-Château;549;15;564
44;Grand Est;57;7;01;565;Rédange;995;20;1015
44;Grand Est;57;5;21;566;Réding;2361;64;2425
44;Grand Est;57;3;04;567;Rémelfang;156;1;157
44;Grand Est;57;6;22;568;Rémelfing;1404;28;1432
44;Grand Est;57;7;04;569;Rémeling;314;6;320
44;Grand Est;57;3;04;570;Rémering;429;5;434
44;Grand Est;57;6;20;571;Rémering-lès-Puttelange;1058;31;1089
44;Grand Est;57;9;07;572;Rémilly;2003;100;2103
44;Grand Est;57;5;23;573;Réning;134;3;137
44;Grand Est;57;9;16;575;Retonfey;1371;30;1401
44;Grand Est;57;7;04;576;Rettel;766;65;831
44;Grand Est;57;6;02;577;Reyersviller;371;7;378
44;Grand Est;57;9;05;578;Rezonville-Vionville ;500;6;506
44;Grand Est;57;5;21;579;Rhodes;125;1;126
44;Grand Est;57;5;23;580;Riche;188;2;190
44;Grand Est;57;6;20;581;Richeling;341;7;348
44;Grand Est;57;7;06;582;Richemont;2092;42;2134
44;Grand Est;57;5;21;583;Richeval;136;2;138
44;Grand Est;57;6;02;584;Rimling;649;17;666
44;Grand Est;57;7;01;586;Rochonvillers;189;2;191
44;Grand Est;57;5;23;587;Rodalbe;251;5;256
44;Grand Est;57;7;27;588;Rodemack;1249;31;1280
44;Grand Est;57;6;02;589;Rohrbach-lès-Bitche;2297;49;2346
44;Grand Est;57;6;02;590;Rolbing;252;6;258
44;Grand Est;57;9;18;591;Rombas;9833;100;9933
44;Grand Est;57;5;21;592;Romelfing;353;2;355
44;Grand Est;57;9;18;593;Roncourt;1014;10;1024
44;Grand Est;57;6;02;594;Roppeviller;102;3;105
44;Grand Est;57;5;23;595;Rorbach-lès-Dieuze;50;1;51
44;Grand Est;57;3;08;596;Rosbruck;750;11;761
44;Grand Est;57;7;10;597;Rosselange;2672;20;2692
44;Grand Est;57;6;22;598;Rouhling;2033;53;2086
44;Grand Est;57;3;03;599;Roupeldange;368;9;377
44;Grand Est;57;7;27;600;Roussy-le-Village;1387;24;1411
44;Grand Est;57;9;05;601;Rozérieulles;1361;42;1403
44;Grand Est;57;7;14;602;Rurange-lès-Thionville;2462;54;2516
44;Grand Est;57;7;01;603;Russange;1279;17;1296
44;Grand Est;57;7;04;604;Rustroff;618;6;624
44;Grand Est;57;9;23;605;Sailly-Achâtel;295;2;297
44;Grand Est;57;3;19;606;Saint-Avold;15433;356;15789
44;Grand Est;57;5;23;609;Saint-Epvre;176;2;178
44;Grand Est;57;3;04;610;Saint-François-Lacroix;303;6;309
44;Grand Est;57;5;21;611;Saint-Georges;194;6;200
44;Grand Est;57;9;16;612;Saint-Hubert;239;5;244
44;Grand Est;57;5;21;613;Saint-Jean-de-Bassel;351;3;354
44;Grand Est;57;5;17;614;Saint-Jean-Kourtzerode;706;4;710
44;Grand Est;57;6;20;615;Saint-Jean-Rohrbach;967;19;986
44;Grand Est;57;9;16;616;Saint-Julien-lès-Metz;3411;85;3496
44;Grand Est;57;9;23;617;Saint-Jure;287;6;293
44;Grand Est;57;5;17;618;Saint-Louis;658;20;678
44;Grand Est;57;6;02;619;Saint-Louis-lès-Bitche;481;10;491
44;Grand Est;57;5;23;621;Saint-Médard;104;1;105
44;Grand Est;57;9;18;622;Saint-Privat-la-Montagne;1918;21;1939
44;Grand Est;57;5;17;623;Saint-Quirin;716;51;767
44;Grand Est;57;9;16;607;Sainte-Barbe;753;10;763
44;Grand Est;57;9;18;620;Sainte-Marie-aux-Chênes;4289;61;4350
44;Grand Est;57;9;05;624;Sainte-Ruffine;549;29;578
44;Grand Est;57;5;23;625;Salonnes;184;2;186
44;Grand Est;57;9;16;626;Sanry-lès-Vigy;528;8;536
44;Grand Est;57;9;16;627;Sanry-sur-Nied;289;3;292
44;Grand Est;57;6;20;628;Sarralbe;4520;94;4614
44;Grand Est;57;5;21;629;Sarraltroff;763;6;769
44;Grand Est;57;5;21;630;Sarrebourg;12331;314;12645
44;Grand Est;57;6;22;631;Sarreguemines;20820;475;21295
44;Grand Est;57;6;22;633;Sarreinsming;1267;30;1297
44;Grand Est;57;9;18;634;Saulny;1468;38;1506
44;Grand Est;57;5;21;635;Schalbach;353;7;360
44;Grand Est;57;6;02;636;Schmittviller;319;12;331
44;Grand Est;57;5;17;637;Schneckenbusch;305;9;314
44;Grand Est;57;6;02;639;Schorbach;539;9;548
44;Grand Est;57;3;04;640;Schwerdorff;475;14;489
44;Grand Est;57;6;02;641;Schweyen;305;4;309
44;Grand Est;57;3;08;638;Schœneck;2518;40;2558
44;Grand Est;57;9;15;642;Scy-Chazelles;2675;53;2728
44;Grand Est;57;9;23;643;Secourt;198;6;204
44;Grand Est;57;3;09;644;Seingbouse;1787;43;1830
44;Grand Est;57;9;24;645;Semécourt;1002;9;1011
44;Grand Est;57;7;10;647;Serémange-Erzange;4218;58;4276
44;Grand Est;57;9;16;648;Servigny-lès-Raville;490;5;495
44;Grand Est;57;9;16;649;Servigny-lès-Sainte-Barbe;464;4;468
44;Grand Est;57;7;04;650;Sierck-les-Bains;1775;13;1788
44;Grand Est;57;6;02;651;Siersthal;656;6;662
44;Grand Est;57;9;07;652;Sillegny;494;5;499
44;Grand Est;57;9;07;653;Silly-en-Saulnois;32;2;34
44;Grand Est;57;9;16;654;Silly-sur-Nied;694;11;705
44;Grand Est;57;9;07;655;Solgne;1114;61;1175
44;Grand Est;57;9;16;656;Sorbey;377;7;384
44;Grand Est;57;5;23;657;Sotzeling;20;0;20
44;Grand Est;57;6;02;658;Soucht;1046;20;1066
44;Grand Est;57;3;25;659;Spicheren;3223;56;3279
44;Grand Est;57;3;25;660;Stiring-Wendel;11385;130;11515
44;Grand Est;57;7;14;767;Stuckange;1138;30;1168
44;Grand Est;57;6;02;661;Sturzelbronn;174;3;177
44;Grand Est;57;3;20;662;Suisse;101;5;106
44;Grand Est;57;9;24;663;Talange;7731;196;7927
44;Grand Est;57;5;23;664;Tarquimpol;62;2;64
44;Grand Est;57;3;25;665;Tenteling;1068;19;1087
44;Grand Est;57;7;26;666;Terville;7120;90;7210
44;Grand Est;57;3;03;667;Téterchen;804;8;812
44;Grand Est;57;3;07;668;Teting-sur-Nied;1289;35;1324
44;Grand Est;57;3;25;669;Théding;2487;45;2532
44;Grand Est;57;3;07;670;Thicourt;138;1;139
44;Grand Est;57;9;07;671;Thimonville;155;0;155
44;Grand Est;57;7;99;672;Thionville;40477;759;41236
44;Grand Est;57;3;07;673;Thonville;47;0;47
44;Grand Est;57;5;23;674;Tincry;174;5;179
44;Grand Est;57;5;23;675;Torcheville;113;1;114
44;Grand Est;57;9;07;676;Tragny;95;1;96
44;Grand Est;57;9;16;677;Trémery;1053;18;1071
44;Grand Est;57;7;01;678;Tressange;2172;34;2206
44;Grand Est;57;3;07;679;Tritteling-Redlach;532;4;536
44;Grand Est;57;5;17;680;Troisfontaines;1266;28;1294
44;Grand Est;57;3;04;681;Tromborn;343;5;348
44;Grand Est;57;5;17;682;Turquestein-Blancrupt;12;0;12
44;Grand Est;57;7;06;683;Uckange;6829;46;6875
44;Grand Est;57;3;20;684;Vahl-Ebersing;513;10;523
44;Grand Est;57;5;23;685;Vahl-lès-Bénestroff;151;2;153
44;Grand Est;57;3;07;686;Vahl-lès-Faulquemont;253;2;255
44;Grand Est;57;5;23;270;Val-de-Bride;584;12;596
44;Grand Est;57;6;20;267;Le Val-de-Guéblange;857;18;875
44;Grand Est;57;3;20;687;Vallerange;211;4;215
44;Grand Est;57;7;14;689;Valmestroff;311;5;316
44;Grand Est;57;3;19;690;Valmont;3075;69;3144
44;Grand Est;57;3;03;691;Valmunster;90;4;94
44;Grand Est;57;5;23;692;Vannecourt;77;0;77
44;Grand Est;57;9;16;693;Vantoux;837;19;856
44;Grand Est;57;9;16;694;Vany;424;10;434
44;Grand Est;57;3;03;695;Varize-Vaudoncourt;537;10;547
44;Grand Est;57;3;03;696;Varsberg;963;26;989
44;Grand Est;57;5;17;697;Vasperviller;315;9;324
44;Grand Est;57;3;07;698;Vatimont;321;6;327
44;Grand Est;57;3;04;700;Vaudreching;518;8;526
44;Grand Est;57;9;05;701;Vaux;805;26;831
44;Grand Est;57;5;23;702;Vaxy;168;0;168
44;Grand Est;57;5;21;703;Veckersviller;232;17;249
44;Grand Est;57;7;14;704;Veckring;658;15;673
44;Grand Est;57;3;03;705;Velving;204;5;209
44;Grand Est;57;5;23;706;Vergaville;563;14;577
44;Grand Est;57;9;05;707;Vernéville;634;6;640
44;Grand Est;57;9;07;708;Verny;1951;67;2018
44;Grand Est;57;5;17;709;Vescheim;316;7;323
44;Grand Est;57;5;23;711;Vibersviller;436;8;444
44;Grand Est;57;5;23;712;Vic-sur-Seille;1292;105;1397
44;Grand Est;57;5;21;713;Vieux-Lixheim;252;8;260
44;Grand Est;57;9;23;715;Vigny;370;11;381
44;Grand Est;57;9;16;716;Vigy;1735;33;1768
44;Grand Est;57;3;20;717;Viller;193;3;196
44;Grand Est;57;9;07;718;Villers-Stoncourt;219;1;220
44;Grand Est;57;5;23;719;Villers-sur-Nied;76;3;79
44;Grand Est;57;3;04;720;Villing;495;12;507
44;Grand Est;57;5;17;721;Vilsberg;351;10;361
44;Grand Est;57;5;23;723;Virming;296;6;302
44;Grand Est;57;7;10;724;Vitry-sur-Orne;3035;36;3071
44;Grand Est;57;5;23;725;Vittersbourg;351;7;358
44;Grand Est;57;3;07;726;Vittoncourt;378;4;382
44;Grand Est;57;5;23;727;Viviers;121;1;122
44;Grand Est;57;3;07;728;Voimhaut;254;3;257
44;Grand Est;57;3;03;730;Volmerange-lès-Boulay;565;12;577
44;Grand Est;57;7;27;731;Volmerange-les-Mines;2229;40;2269
44;Grand Est;57;6;02;732;Volmunster;783;21;804
44;Grand Est;57;7;14;733;Volstroff;1999;29;2028
44;Grand Est;57;5;17;734;Voyer;456;11;467
44;Grand Est;57;9;16;736;Vry;598;8;606
44;Grand Est;57;9;23;737;Vulmont;31;2;33
44;Grand Est;57;3;04;749;Vœlfling-lès-Bouzonville;155;6;161
44;Grand Est;57;6;02;738;Waldhouse;402;6;408
44;Grand Est;57;7;04;739;Waldweistroff;498;2;500
44;Grand Est;57;7;04;740;Waldwisse;816;12;828
44;Grand Est;57;6;02;741;Walschbronn;467;13;480
44;Grand Est;57;5;17;742;Walscheid;1515;41;1556
44;Grand Est;57;5;17;743;Waltembourg;244;7;251
44;Grand Est;57;6;22;745;Wiesviller;950;21;971
44;Grand Est;57;6;22;746;Willerwald;1555;37;1592
44;Grand Est;57;5;17;747;Wintersbourg;266;7;273
44;Grand Est;57;6;22;748;Wittring;777;17;794
44;Grand Est;57;9;24;751;Woippy;13998;136;14134
44;Grand Est;57;6;20;752;Woustviller;3080;53;3133
44;Grand Est;57;5;23;753;Wuisse;62;1;63
44;Grand Est;57;6;22;750;Wœlfling-lès-Sarreguemines;729;26;755
44;Grand Est;57;5;23;754;Xanrey;114;1;115
44;Grand Est;57;5;23;755;Xocourt;96;1;97
44;Grand Est;57;5;17;756;Xouaxange;307;3;310
44;Grand Est;57;7;27;757;Yutz;16633;263;16896
44;Grand Est;57;5;23;759;Zarbeling;61;1;62
44;Grand Est;57;6;22;760;Zetting;835;20;855
44;Grand Est;57;5;17;761;Zilling;270;4;274
44;Grand Est;57;3;07;762;Zimming;709;6;715
44;Grand Est;57;5;23;763;Zommange;45;2;47
44;Grand Est;57;7;27;764;Zoufftgen;1233;14;1247
44;Grand Est;57;3;08;521;Œting;2689;53;2742
27;Bourgogne-Franche-Comté;58;1;02;001;Achun;161;0;161
27;Bourgogne-Franche-Comté;58;4;05;002;Alligny-Cosne;891;13;904
27;Bourgogne-Franche-Comté;58;1;02;003;Alligny-en-Morvan;610;7;617
27;Bourgogne-Franche-Comté;58;1;02;004;Alluy;381;9;390
27;Bourgogne-Franche-Comté;58;2;03;005;Amazy;226;1;227
27;Bourgogne-Franche-Comté;58;3;08;006;Anlezy;246;3;249
27;Bourgogne-Franche-Comté;58;4;15;007;Annay;339;5;344
27;Bourgogne-Franche-Comté;58;2;04;008;Anthien;173;5;178
27;Bourgogne-Franche-Comté;58;4;01;009;Arbourse;127;1;128
27;Bourgogne-Franche-Comté;58;1;02;010;Arleuf;716;12;728
27;Bourgogne-Franche-Comté;58;2;03;011;Armes;283;5;288
27;Bourgogne-Franche-Comté;58;4;15;012;Arquian;578;11;589
27;Bourgogne-Franche-Comté;58;4;01;013;Arthel;96;1;97
27;Bourgogne-Franche-Comté;58;4;01;014;Arzembouy;67;1;68
27;Bourgogne-Franche-Comté;58;2;04;015;Asnan;122;3;125
27;Bourgogne-Franche-Comté;58;2;03;016;Asnois;143;3;146
27;Bourgogne-Franche-Comté;58;1;02;017;Aunay-en-Bazois;226;7;233
27;Bourgogne-Franche-Comté;58;2;04;018;Authiou;46;0;46
27;Bourgogne-Franche-Comté;58;1;10;019;Avrée;81;3;84
27;Bourgogne-Franche-Comté;58;3;16;020;Avril-sur-Loire;260;4;264
27;Bourgogne-Franche-Comté;58;3;16;021;Azy-le-Vif;204;5;209
27;Bourgogne-Franche-Comté;58;1;04;023;Bazoches;178;3;181
27;Bourgogne-Franche-Comté;58;3;08;024;Bazolles;279;11;290
27;Bourgogne-Franche-Comté;58;3;09;025;Béard;167;7;174
27;Bourgogne-Franche-Comté;58;2;04;026;Beaulieu;150;9;159
27;Bourgogne-Franche-Comté;58;4;01;027;Beaumont-la-Ferrière;122;3;125
27;Bourgogne-Franche-Comté;58;3;08;028;Beaumont-Sardolles;116;3;119
27;Bourgogne-Franche-Comté;58;2;04;029;Beuvron;80;0;80
27;Bourgogne-Franche-Comté;58;1;02;030;Biches;285;11;296
27;Bourgogne-Franche-Comté;58;3;08;031;Billy-Chevannes;304;3;307
27;Bourgogne-Franche-Comté;58;2;03;032;Billy-sur-Oisy;365;6;371
27;Bourgogne-Franche-Comté;58;4;15;033;Bitry;301;8;309
27;Bourgogne-Franche-Comté;58;1;02;034;Blismes;182;6;188
27;Bourgogne-Franche-Comté;58;3;08;035;Bona;308;2;310
27;Bourgogne-Franche-Comté;58;4;15;036;Bouhy;463;9;472
27;Bourgogne-Franche-Comté;58;1;04;037;Brassy;602;36;638
27;Bourgogne-Franche-Comté;58;2;03;038;Breugnon;165;5;170
27;Bourgogne-Franche-Comté;58;2;03;039;Brèves;240;2;242
27;Bourgogne-Franche-Comté;58;1;02;040;Brinay;144;3;147
27;Bourgogne-Franche-Comté;58;2;04;041;Brinon-sur-Beuvron;177;5;182
27;Bourgogne-Franche-Comté;58;4;15;042;Bulcy;133;2;135
27;Bourgogne-Franche-Comté;58;2;04;043;Bussy-la-Pesle;55;0;55
27;Bourgogne-Franche-Comté;58;4;05;044;La Celle-sur-Loire;819;10;829
27;Bourgogne-Franche-Comté;58;4;01;045;La Celle-sur-Nièvre;158;1;159
27;Bourgogne-Franche-Comté;58;1;10;046;Cercy-la-Tour;1730;25;1755
27;Bourgogne-Franche-Comté;58;2;04;047;Cervon;657;16;673
27;Bourgogne-Franche-Comté;58;4;15;048;Cessy-les-Bois;101;4;105
27;Bourgogne-Franche-Comté;58;1;04;049;Chalaux;84;2;86
27;Bourgogne-Franche-Comté;58;2;04;050;Challement;46;2;48
27;Bourgogne-Franche-Comté;58;3;13;051;Challuy;1531;133;1664
27;Bourgogne-Franche-Comté;58;2;04;052;Champallement;47;2;49
27;Bourgogne-Franche-Comté;58;4;01;053;Champlemy;328;7;335
27;Bourgogne-Franche-Comté;58;2;01;054;Champlin;39;1;40
27;Bourgogne-Franche-Comté;58;3;06;055;Champvert;779;15;794
27;Bourgogne-Franche-Comté;58;4;01;056;Champvoux;303;7;310
27;Bourgogne-Franche-Comté;58;3;16;057;Chantenay-Saint-Imbert;1149;19;1168
27;Bourgogne-Franche-Comté;58;2;03;058;La Chapelle-Saint-André;302;5;307
27;Bourgogne-Franche-Comté;58;4;01;059;La Charité-sur-Loire;4812;59;4871
27;Bourgogne-Franche-Comté;58;1;10;060;Charrin;610;9;619
27;Bourgogne-Franche-Comté;58;4;01;061;Chasnay;119;1;120
27;Bourgogne-Franche-Comté;58;1;02;063;Château-Chinon (Campagne);546;10;556
27;Bourgogne-Franche-Comté;58;1;02;062;Château-Chinon (Ville);1926;384;2310
27;Bourgogne-Franche-Comté;58;4;15;064;Châteauneuf-Val-de-Bargis;515;15;530
27;Bourgogne-Franche-Comté;58;1;02;065;Châtillon-en-Bazois;900;16;916
27;Bourgogne-Franche-Comté;58;1;02;066;Châtin;86;0;86
27;Bourgogne-Franche-Comté;58;4;01;067;Chaulgnes;1506;23;1529
27;Bourgogne-Franche-Comté;58;1;02;068;Chaumard;209;5;214
27;Bourgogne-Franche-Comté;58;2;04;069;Chaumot;158;4;162
27;Bourgogne-Franche-Comté;58;2;04;070;Chazeuil;58;2;60
27;Bourgogne-Franche-Comté;58;2;04;071;Chevannes-Changy;135;7;142
27;Bourgogne-Franche-Comté;58;3;16;072;Chevenon;604;10;614
27;Bourgogne-Franche-Comté;58;2;03;073;Chevroches;125;5;130
27;Bourgogne-Franche-Comté;58;1;10;074;Chiddes;338;6;344
27;Bourgogne-Franche-Comté;58;2;04;075;Chitry-les-Mines;208;4;212
27;Bourgogne-Franche-Comté;58;1;02;076;Chougny;77;0;77
27;Bourgogne-Franche-Comté;58;4;15;077;Ciez;370;6;376
27;Bourgogne-Franche-Comté;58;3;08;078;Cizely;58;0;58
27;Bourgogne-Franche-Comté;58;2;03;079;Clamecy;3674;171;3845
27;Bourgogne-Franche-Comté;58;2;04;080;La Collancelle;172;1;173
27;Bourgogne-Franche-Comté;58;4;15;081;Colméry;299;4;303
27;Bourgogne-Franche-Comté;58;1;02;082;Corancy;293;4;297
27;Bourgogne-Franche-Comté;58;2;04;083;Corbigny;1463;110;1573
27;Bourgogne-Franche-Comté;58;2;04;084;Corvol-d'Embernard;86;4;90
27;Bourgogne-Franche-Comté;58;2;03;085;Corvol-l'Orgueilleux;777;13;790
27;Bourgogne-Franche-Comté;58;4;05;086;Cosne-Cours-sur-Loire;9741;246;9987
27;Bourgogne-Franche-Comté;58;3;06;087;Cossaye;712;8;720
27;Bourgogne-Franche-Comté;58;3;11;088;Coulanges-lès-Nevers;3638;84;3722
27;Bourgogne-Franche-Comté;58;4;15;089;Couloutre;190;7;197
27;Bourgogne-Franche-Comté;58;2;03;090;Courcelles;218;1;219
27;Bourgogne-Franche-Comté;58;3;08;092;Crux-la-Ville;400;9;409
27;Bourgogne-Franche-Comté;58;2;03;093;Cuncy-lès-Varzy;126;2;128
27;Bourgogne-Franche-Comté;58;4;15;094;Dampierre-sous-Bouhy;453;4;457
27;Bourgogne-Franche-Comté;58;3;06;095;Decize;5267;176;5443
27;Bourgogne-Franche-Comté;58;3;06;096;Devay;495;9;504
27;Bourgogne-Franche-Comté;58;3;08;097;Diennes-Aubigny;93;1;94
27;Bourgogne-Franche-Comté;58;2;03;098;Dirol;114;4;118
27;Bourgogne-Franche-Comté;58;1;02;099;Dommartin;167;3;170
27;Bourgogne-Franche-Comté;58;4;01;101;Dompierre-sur-Nièvre;191;2;193
27;Bourgogne-Franche-Comté;58;4;15;102;Donzy;1578;27;1605
27;Bourgogne-Franche-Comté;58;2;03;103;Dornecy;472;8;480
27;Bourgogne-Franche-Comté;58;3;16;104;Dornes;1448;25;1473
27;Bourgogne-Franche-Comté;58;3;09;105;Druy-Parigny;315;6;321
27;Bourgogne-Franche-Comté;58;1;04;106;Dun-les-Places;351;4;355
27;Bourgogne-Franche-Comté;58;1;02;107;Dun-sur-Grandry;144;2;146
27;Bourgogne-Franche-Comté;58;1;04;108;Empury;84;1;85
27;Bourgogne-Franche-Comté;58;2;03;109;Entrains-sur-Nohain;758;14;772
27;Bourgogne-Franche-Comté;58;2;04;110;Epiry;241;2;243
27;Bourgogne-Franche-Comté;58;1;02;111;Fâchin;108;0;108
27;Bourgogne-Franche-Comté;58;3;08;112;La Fermeté;635;7;642
27;Bourgogne-Franche-Comté;58;3;08;113;Fertrève;100;3;103
27;Bourgogne-Franche-Comté;58;1;10;114;Fléty;98;4;102
27;Bourgogne-Franche-Comté;58;3;16;115;Fleury-sur-Loire;228;6;234
27;Bourgogne-Franche-Comté;58;2;03;116;Flez-Cuzy;133;5;138
27;Bourgogne-Franche-Comté;58;3;07;117;Fourchambault;4182;53;4235
27;Bourgogne-Franche-Comté;58;1;10;118;Fours;643;7;650
27;Bourgogne-Franche-Comté;58;3;08;119;Frasnay-Reugny;85;3;88
27;Bourgogne-Franche-Comté;58;2;04;120;Gâcogne;235;0;235
27;Bourgogne-Franche-Comté;58;3;07;121;Garchizy;3735;46;3781
27;Bourgogne-Franche-Comté;58;4;15;122;Garchy;425;8;433
27;Bourgogne-Franche-Comté;58;2;04;123;Germenay;137;10;147
27;Bourgogne-Franche-Comté;58;3;07;124;Germigny-sur-Loire;769;9;778
27;Bourgogne-Franche-Comté;58;1;02;125;Gien-sur-Cure;97;2;99
27;Bourgogne-Franche-Comté;58;3;13;126;Gimouille;454;7;461
27;Bourgogne-Franche-Comté;58;4;01;127;Giry;191;3;194
27;Bourgogne-Franche-Comté;58;1;02;128;Glux-en-Glenne;92;0;92
27;Bourgogne-Franche-Comté;58;1;02;129;Gouloux;178;5;183
27;Bourgogne-Franche-Comté;58;2;04;130;Grenois;96;2;98
27;Bourgogne-Franche-Comté;58;3;08;131;Guérigny;2511;40;2551
27;Bourgogne-Franche-Comté;58;2;04;132;Guipy;234;16;250
27;Bourgogne-Franche-Comté;58;2;04;133;Héry;73;2;75
27;Bourgogne-Franche-Comté;58;3;09;134;Imphy;3273;38;3311
27;Bourgogne-Franche-Comté;58;1;10;135;Isenay;100;0;100
27;Bourgogne-Franche-Comté;58;3;08;136;Jailly;68;2;70
27;Bourgogne-Franche-Comté;58;3;06;137;Lamenay-sur-Loire;66;0;66
27;Bourgogne-Franche-Comté;58;3;16;138;Langeron;362;10;372
27;Bourgogne-Franche-Comté;58;1;10;139;Lanty;118;0;118
27;Bourgogne-Franche-Comté;58;1;10;140;Larochemillay;231;5;236
27;Bourgogne-Franche-Comté;58;1;02;141;Lavault-de-Frétoy;70;0;70
27;Bourgogne-Franche-Comté;58;1;02;142;Limanton;239;4;243
27;Bourgogne-Franche-Comté;58;3;08;143;Limon;145;5;150
27;Bourgogne-Franche-Comté;58;3;16;144;Livry;700;6;706
27;Bourgogne-Franche-Comté;58;1;04;145;Lormes;1280;29;1309
27;Bourgogne-Franche-Comté;58;3;06;146;Lucenay-lès-Aix;980;19;999
27;Bourgogne-Franche-Comté;58;4;01;147;Lurcy-le-Bourg;281;5;286
27;Bourgogne-Franche-Comté;58;3;16;148;Luthenay-Uxeloup;618;11;629
27;Bourgogne-Franche-Comté;58;1;10;149;Luzy;1982;35;2017
27;Bourgogne-Franche-Comté;58;2;03;150;Lys;109;6;115
27;Bourgogne-Franche-Comté;58;3;09;151;La Machine;3292;53;3345
27;Bourgogne-Franche-Comté;58;3;12;152;Magny-Cours;1382;27;1409
27;Bourgogne-Franche-Comté;58;2;04;153;Magny-Lormes;73;2;75
27;Bourgogne-Franche-Comté;58;2;03;154;La Maison-Dieu;119;1;120
27;Bourgogne-Franche-Comté;58;4;01;155;La Marche;562;17;579
27;Bourgogne-Franche-Comté;58;2;03;156;Marcy;148;2;150
27;Bourgogne-Franche-Comté;58;1;04;157;Marigny-l'Église;288;16;304
27;Bourgogne-Franche-Comté;58;2;04;159;Marigny-sur-Yonne;201;3;204
27;Bourgogne-Franche-Comté;58;3;16;158;Mars-sur-Allier;304;6;310
27;Bourgogne-Franche-Comté;58;3;07;160;Marzy;3704;200;3904
27;Bourgogne-Franche-Comté;58;1;10;161;Maux;143;0;143
27;Bourgogne-Franche-Comté;58;4;15;162;Menestreau;112;1;113
27;Bourgogne-Franche-Comté;58;2;03;163;Menou;183;3;186
27;Bourgogne-Franche-Comté;58;4;15;164;Mesves-sur-Loire;679;31;710
27;Bourgogne-Franche-Comté;58;2;03;165;Metz-le-Comte;161;7;168
27;Bourgogne-Franche-Comté;58;2;04;166;Mhère;231;2;233
27;Bourgogne-Franche-Comté;58;1;10;168;Millay;443;5;448
27;Bourgogne-Franche-Comté;58;2;03;169;Moissy-Moulinot;17;3;20
27;Bourgogne-Franche-Comté;58;2;03;170;Monceaux-le-Comte;121;2;123
27;Bourgogne-Franche-Comté;58;1;02;175;Mont-et-Marré;160;1;161
27;Bourgogne-Franche-Comté;58;1;10;172;Montambert;122;2;124
27;Bourgogne-Franche-Comté;58;1;02;171;Montapas;288;2;290
27;Bourgogne-Franche-Comté;58;1;10;173;Montaron;159;0;159
27;Bourgogne-Franche-Comté;58;4;01;174;Montenoison;120;2;122
27;Bourgogne-Franche-Comté;58;3;08;176;Montigny-aux-Amognes;633;23;656
27;Bourgogne-Franche-Comté;58;1;02;177;Montigny-en-Morvan;285;1;286
27;Bourgogne-Franche-Comté;58;1;10;178;Montigny-sur-Canne;153;2;155
27;Bourgogne-Franche-Comté;58;2;02;179;Montreuillon;260;7;267
27;Bourgogne-Franche-Comté;58;1;02;180;Montsauche-les-Settons;512;3;515
27;Bourgogne-Franche-Comté;58;2;04;181;Moraches;144;5;149
27;Bourgogne-Franche-Comté;58;1;10;182;Moulins-Engilbert;1443;24;1467
27;Bourgogne-Franche-Comté;58;2;04;183;Mouron-sur-Yonne;97;1;98
27;Bourgogne-Franche-Comté;58;4;01;184;Moussy;104;1;105
27;Bourgogne-Franche-Comté;58;1;02;185;Moux-en-Morvan;531;4;535
27;Bourgogne-Franche-Comté;58;4;01;186;Murlin;80;1;81
27;Bourgogne-Franche-Comté;58;4;05;187;Myennes;527;6;533
27;Bourgogne-Franche-Comté;58;4;01;188;Nannay;116;3;119
27;Bourgogne-Franche-Comté;58;4;01;189;Narcy;496;4;500
27;Bourgogne-Franche-Comté;58;2;03;190;Neuffontaines;104;2;106
27;Bourgogne-Franche-Comté;58;2;04;191;Neuilly;114;3;117
27;Bourgogne-Franche-Comté;58;3;16;192;Neuville-lès-Decize;224;9;233
27;Bourgogne-Franche-Comté;58;4;15;193;Neuvy-sur-Loire;1423;31;1454
27;Bourgogne-Franche-Comté;58;3;99;194;Nevers;33279;1074;34353
27;Bourgogne-Franche-Comté;58;1;10;195;La Nocle-Maulaix;280;1;281
27;Bourgogne-Franche-Comté;58;3;08;196;Nolay;352;3;355
27;Bourgogne-Franche-Comté;58;2;03;197;Nuars;158;1;159
27;Bourgogne-Franche-Comté;58;2;03;198;Oisy;303;5;308
27;Bourgogne-Franche-Comté;58;1;02;199;Onlay;148;4;152
27;Bourgogne-Franche-Comté;58;2;03;200;Ouagne;151;1;152
27;Bourgogne-Franche-Comté;58;2;03;201;Oudan;144;3;147
27;Bourgogne-Franche-Comté;58;1;02;202;Ougny;25;0;25
27;Bourgogne-Franche-Comté;58;4;01;203;Oulon;63;1;64
27;Bourgogne-Franche-Comté;58;1;02;205;Ouroux-en-Morvan;601;7;608
27;Bourgogne-Franche-Comté;58;2;03;206;Parigny-la-Rose;37;0;37
27;Bourgogne-Franche-Comté;58;3;17;207;Parigny-les-Vaux;967;32;999
27;Bourgogne-Franche-Comté;58;2;04;208;Pazy;301;10;311
27;Bourgogne-Franche-Comté;58;4;15;209;Perroy;152;5;157
27;Bourgogne-Franche-Comté;58;1;02;210;Planchez;301;4;305
27;Bourgogne-Franche-Comté;58;1;10;211;Poil;142;3;145
27;Bourgogne-Franche-Comté;58;3;08;212;Poiseux;331;4;335
27;Bourgogne-Franche-Comté;58;4;05;213;Pougny;464;9;473
27;Bourgogne-Franche-Comté;58;3;17;214;Pougues-les-Eaux;2375;51;2426
27;Bourgogne-Franche-Comté;58;4;15;215;Pouilly-sur-Loire;1621;24;1645
27;Bourgogne-Franche-Comté;58;2;04;216;Pouques-Lormes;159;3;162
27;Bourgogne-Franche-Comté;58;2;03;217;Pousseaux;200;3;203
27;Bourgogne-Franche-Comté;58;4;01;218;Prémery;1823;27;1850
27;Bourgogne-Franche-Comté;58;1;10;219;Préporché;209;4;213
27;Bourgogne-Franche-Comté;58;4;01;220;Raveau;664;10;674
27;Bourgogne-Franche-Comté;58;1;10;221;Rémilly;151;2;153
27;Bourgogne-Franche-Comté;58;2;03;222;Rix;161;1;162
27;Bourgogne-Franche-Comté;58;3;08;223;Rouy;621;8;629
27;Bourgogne-Franche-Comté;58;2;03;224;Ruages;91;4;95
27;Bourgogne-Franche-Comté;58;3;13;225;Saincaize-Meauce;368;7;375
27;Bourgogne-Franche-Comté;58;1;02;226;Saint-Agnan;133;2;135
27;Bourgogne-Franche-Comté;58;4;15;227;Saint-Amand-en-Puisaye;1233;25;1258
27;Bourgogne-Franche-Comté;58;4;15;228;Saint-Andelain;549;4;553
27;Bourgogne-Franche-Comté;58;1;04;229;Saint-André-en-Morvan;310;5;315
27;Bourgogne-Franche-Comté;58;2;03;230;Saint-Aubin-des-Chaumes;70;0;70
27;Bourgogne-Franche-Comté;58;4;01;231;Saint-Aubin-les-Forges;398;8;406
27;Bourgogne-Franche-Comté;58;3;08;232;Saint-Benin-d'Azy;1269;20;1289
27;Bourgogne-Franche-Comté;58;3;08;233;Saint-Benin-des-Bois;167;7;174
27;Bourgogne-Franche-Comté;58;4;01;234;Saint-Bonnot;145;1;146
27;Bourgogne-Franche-Comté;58;1;02;235;Saint-Brisson;261;3;264
27;Bourgogne-Franche-Comté;58;2;03;237;Saint-Didier;28;2;30
27;Bourgogne-Franche-Comté;58;3;12;238;Saint-Éloi;2184;49;2233
27;Bourgogne-Franche-Comté;58;3;08;239;Saint-Firmin;167;2;169
27;Bourgogne-Franche-Comté;58;3;08;240;Saint-Franchy;75;2;77
27;Bourgogne-Franche-Comté;58;3;06;241;Saint-Germain-Chassenay;319;4;323
27;Bourgogne-Franche-Comté;58;2;03;242;Saint-Germain-des-Bois;126;0;126
27;Bourgogne-Franche-Comté;58;1;10;243;Saint-Gratien-Savigny;114;4;118
27;Bourgogne-Franche-Comté;58;1;02;244;Saint-Hilaire-en-Morvan;219;7;226
27;Bourgogne-Franche-Comté;58;1;10;245;Saint-Hilaire-Fontaine;166;5;171
27;Bourgogne-Franche-Comté;58;1;10;246;Saint-Honoré-les-Bains;730;13;743
27;Bourgogne-Franche-Comté;58;3;08;247;Saint-Jean-aux-Amognes;484;7;491
27;Bourgogne-Franche-Comté;58;4;15;248;Saint-Laurent-l'Abbaye;214;5;219
27;Bourgogne-Franche-Comté;58;1;02;249;Saint-Léger-de-Fougeret;363;2;365
27;Bourgogne-Franche-Comté;58;3;06;250;Saint-Léger-des-Vignes;1871;46;1917
27;Bourgogne-Franche-Comté;58;4;05;251;Saint-Loup;471;7;478
27;Bourgogne-Franche-Comté;58;4;15;252;Saint-Malo-en-Donziois;127;3;130
27;Bourgogne-Franche-Comté;58;3;08;254;Saint-Martin-d'Heuille;583;13;596
27;Bourgogne-Franche-Comté;58;1;04;255;Saint-Martin-du-Puy;277;5;282
27;Bourgogne-Franche-Comté;58;4;15;256;Saint-Martin-sur-Nohain;373;13;386
27;Bourgogne-Franche-Comté;58;3;08;257;Saint-Maurice;63;0;63
27;Bourgogne-Franche-Comté;58;3;09;258;Saint-Ouen-sur-Loire;561;6;567
27;Bourgogne-Franche-Comté;58;3;16;259;Saint-Parize-en-Viry;148;3;151
27;Bourgogne-Franche-Comté;58;3;16;260;Saint-Parize-le-Châtel;1274;28;1302
27;Bourgogne-Franche-Comté;58;4;05;261;Saint-Père;1078;20;1098
27;Bourgogne-Franche-Comté;58;1;02;262;Saint-Péreuse;216;7;223
27;Bourgogne-Franche-Comté;58;2;03;263;Saint-Pierre-du-Mont;180;2;182
27;Bourgogne-Franche-Comté;58;3;16;264;Saint-Pierre-le-Moûtier;1918;27;1945
27;Bourgogne-Franche-Comté;58;4;15;265;Saint-Quentin-sur-Nohain;97;3;100
27;Bourgogne-Franche-Comté;58;2;04;266;Saint-Révérien;157;0;157
27;Bourgogne-Franche-Comté;58;3;08;267;Saint-Saulge;732;80;812
27;Bourgogne-Franche-Comté;58;1;10;268;Saint-Seine;201;5;206
27;Bourgogne-Franche-Comté;58;3;08;269;Saint-Sulpice;406;10;416
27;Bourgogne-Franche-Comté;58;4;15;270;Saint-Vérain;346;6;352
27;Bourgogne-Franche-Comté;58;4;15;236;Sainte-Colombe-des-Bois;133;2;135
27;Bourgogne-Franche-Comté;58;3;08;253;Sainte-Marie;80;5;85
27;Bourgogne-Franche-Comté;58;2;03;271;Saizy;187;3;190
27;Bourgogne-Franche-Comté;58;2;04;272;Sardy-lès-Épiry;111;4;115
27;Bourgogne-Franche-Comté;58;3;09;273;Sauvigny-les-Bois;1438;40;1478
27;Bourgogne-Franche-Comté;58;1;10;274;Savigny-Poil-Fol;120;3;123
27;Bourgogne-Franche-Comté;58;3;08;275;Saxi-Bourdon;298;4;302
27;Bourgogne-Franche-Comté;58;1;10;276;Sémelay;227;3;230
27;Bourgogne-Franche-Comté;58;1;10;277;Sermages;190;8;198
27;Bourgogne-Franche-Comté;58;3;12;278;Sermoise-sur-Loire;1498;69;1567
27;Bourgogne-Franche-Comté;58;4;01;279;Sichamps;187;6;193
27;Bourgogne-Franche-Comté;58;3;09;280;Sougy-sur-Loire;606;16;622
27;Bourgogne-Franche-Comté;58;4;15;281;Suilly-la-Tour;597;14;611
27;Bourgogne-Franche-Comté;58;2;03;282;Surgy;330;11;341
27;Bourgogne-Franche-Comté;58;2;04;283;Taconnay;75;2;77
27;Bourgogne-Franche-Comté;58;2;03;284;Talon;39;2;41
27;Bourgogne-Franche-Comté;58;1;02;285;Tamnay-en-Bazois;162;5;167
27;Bourgogne-Franche-Comté;58;2;03;286;Tannay;581;10;591
27;Bourgogne-Franche-Comté;58;1;10;287;Tazilly;194;4;198
27;Bourgogne-Franche-Comté;58;2;03;288;Teigny;103;2;105
27;Bourgogne-Franche-Comté;58;1;10;289;Ternant;191;0;191
27;Bourgogne-Franche-Comté;58;1;10;290;Thaix;48;1;49
27;Bourgogne-Franche-Comté;58;3;09;291;Thianges;172;0;172
27;Bourgogne-Franche-Comté;58;1;02;292;Tintury;175;0;175
27;Bourgogne-Franche-Comté;58;3;16;293;Toury-Lurcy;423;4;427
27;Bourgogne-Franche-Comté;58;3;16;294;Toury-sur-Jour;120;2;122
27;Bourgogne-Franche-Comté;58;4;15;295;Tracy-sur-Loire;983;15;998
27;Bourgogne-Franche-Comté;58;3;16;296;Tresnay;142;0;142
27;Bourgogne-Franche-Comté;58;3;09;297;Trois-Vèvres;241;1;242
27;Bourgogne-Franche-Comté;58;4;01;298;Tronsanges;396;9;405
27;Bourgogne-Franche-Comté;58;2;03;299;Trucy-l'Orgueilleux;220;3;223
27;Bourgogne-Franche-Comté;58;3;08;300;Urzy;1749;35;1784
27;Bourgogne-Franche-Comté;58;1;10;301;Vandenesse;297;5;302
27;Bourgogne-Franche-Comté;58;4;01;302;Varennes-lès-Narcy;933;5;938
27;Bourgogne-Franche-Comté;58;3;17;303;Varennes-Vauzelles;9207;177;9384
27;Bourgogne-Franche-Comté;58;2;03;304;Varzy;1152;204;1356
27;Bourgogne-Franche-Comté;58;2;04;305;Vauclaix;135;2;137
27;Bourgogne-Franche-Comté;58;3;08;204;Vaux d'Amognes;542;8;550
27;Bourgogne-Franche-Comté;58;3;06;306;Verneuil;296;9;305
27;Bourgogne-Franche-Comté;58;4;15;307;Vielmanay;181;4;185
27;Bourgogne-Franche-Comté;58;2;03;308;Vignol;62;0;62
27;Bourgogne-Franche-Comté;58;1;10;309;Villapourçon;411;8;419
27;Bourgogne-Franche-Comté;58;3;08;311;Ville-Langy;248;6;254
27;Bourgogne-Franche-Comté;58;2;03;310;Villiers-le-Sec;48;1;49
27;Bourgogne-Franche-Comté;58;2;03;312;Villiers-sur-Yonne;271;9;280
27;Bourgogne-Franche-Comté;58;2;04;313;Vitry-Laché;80;4;84
32;Hauts-de-France;59;2;09;001;Abancourt;469;13;482
32;Hauts-de-France;59;6;14;002;Abscon;4376;34;4410
32;Hauts-de-France;59;1;19;003;Aibes;369;6;375
32;Hauts-de-France;59;3;31;004;Aix-en-Pévèle;1275;14;1289
32;Hauts-de-France;59;5;02;005;Allennes-les-Marais;3458;58;3516
32;Hauts-de-France;59;1;05;006;Amfroipret;217;8;225
32;Hauts-de-France;59;3;31;007;Anhiers;894;9;903
32;Hauts-de-France;59;3;01;008;Aniche;10146;84;10230
32;Hauts-de-France;59;2;09;010;Anneux;266;2;268
32;Hauts-de-France;59;5;02;011;Annœullin;10486;110;10596
32;Hauts-de-France;59;1;19;012;Anor;3213;45;3258
32;Hauts-de-France;59;5;36;013;Anstaing;1511;16;1527
32;Hauts-de-France;59;6;03;014;Anzin;13303;81;13384
32;Hauts-de-France;59;3;01;015;Arleux;3199;27;3226
32;Hauts-de-France;59;4;12;016;Armbouts-Cappel;2240;48;2288
32;Hauts-de-France;59;5;04;017;Armentières;24778;362;25140
32;Hauts-de-France;59;4;41;018;Arnèke;1594;17;1611
32;Hauts-de-France;59;6;06;019;Artres;1051;12;1063
32;Hauts-de-France;59;1;30;021;Assevent;1821;18;1839
32;Hauts-de-France;59;5;36;022;Attiches;2263;32;2295
32;Hauts-de-France;59;2;09;023;Aubencheul-au-Bac;541;7;548
32;Hauts-de-France;59;3;01;024;Auberchicourt;4533;29;4562
32;Hauts-de-France;59;5;02;025;Aubers;1655;21;1676
32;Hauts-de-France;59;3;01;026;Aubigny-au-Bac;1172;17;1189
32;Hauts-de-France;59;6;06;027;Aubry-du-Hainaut;1706;15;1721
32;Hauts-de-France;59;3;31;028;Auby;7256;34;7290
32;Hauts-de-France;59;3;31;029;Auchy-lez-Orchies;1509;21;1530
32;Hauts-de-France;59;1;05;031;Audignies;369;4;373
32;Hauts-de-France;59;6;06;032;Aulnoy-lez-Valenciennes;7280;73;7353
32;Hauts-de-France;59;1;05;033;Aulnoye-Aymeries;8767;239;9006
32;Hauts-de-France;59;5;36;034;Avelin;2666;46;2712
32;Hauts-de-France;59;1;19;035;Avesnelles;2433;47;2480
32;Hauts-de-France;59;6;14;038;Avesnes-le-Sec;1445;17;1462
32;Hauts-de-France;59;2;11;037;Avesnes-les-Aubert;3638;34;3672
32;Hauts-de-France;59;1;07;036;Avesnes-sur-Helpe;4345;142;4487
32;Hauts-de-France;59;2;10;039;Awoingt;815;18;833
32;Hauts-de-France;59;1;05;041;Bachant;2306;17;2323
32;Hauts-de-France;59;5;36;042;Bachy;1747;29;1776
32;Hauts-de-France;59;4;08;043;Bailleul;15019;250;15269
32;Hauts-de-France;59;5;36;044;Baisieux;4784;49;4833
32;Hauts-de-France;59;1;19;045;Baives;168;4;172
32;Hauts-de-France;59;4;41;046;Bambecque;806;11;817
32;Hauts-de-France;59;2;10;047;Banteux;346;3;349
32;Hauts-de-France;59;2;09;048;Bantigny;520;11;531
32;Hauts-de-France;59;2;10;049;Bantouzelle;431;7;438
32;Hauts-de-France;59;1;19;050;Bas-Lieu;345;8;353
32;Hauts-de-France;59;5;02;051;La Bassée;6545;51;6596
32;Hauts-de-France;59;5;02;052;Bauvin;5131;43;5174
32;Hauts-de-France;59;1;05;053;Bavay;3295;68;3363
32;Hauts-de-France;59;4;41;054;Bavinchove;983;8;991
32;Hauts-de-France;59;2;10;055;Bazuel;517;11;528
32;Hauts-de-France;59;5;28;056;Beaucamps-Ligny;851;23;874
32;Hauts-de-France;59;1;07;057;Beaudignies;560;14;574
32;Hauts-de-France;59;1;07;058;Beaufort;1013;14;1027
32;Hauts-de-France;59;2;10;059;Beaumont-en-Cambrésis;445;4;449
32;Hauts-de-France;59;2;11;060;Beaurain;231;3;234
32;Hauts-de-France;59;1;07;061;Beaurepaire-sur-Sambre;263;2;265
32;Hauts-de-France;59;1;19;062;Beaurieux;165;6;171
32;Hauts-de-France;59;2;11;063;Beauvois-en-Cambrésis;2038;21;2059
32;Hauts-de-France;59;6;06;064;Bellaing;1252;12;1264
32;Hauts-de-France;59;1;05;065;Bellignies;819;10;829
32;Hauts-de-France;59;1;19;066;Bérelles;151;5;156
32;Hauts-de-France;59;4;12;067;Bergues;3637;45;3682
32;Hauts-de-France;59;1;05;068;Berlaimont;3155;36;3191
32;Hauts-de-France;59;2;11;069;Bermerain;730;12;742
32;Hauts-de-France;59;1;05;070;Bermeries;372;4;376
32;Hauts-de-France;59;5;36;071;Bersée;2246;47;2293
32;Hauts-de-France;59;1;30;072;Bersillies;254;6;260
32;Hauts-de-France;59;4;08;073;Berthen;552;13;565
32;Hauts-de-France;59;2;10;074;Bertry;2174;36;2210
32;Hauts-de-France;59;2;11;075;Béthencourt;751;11;762
32;Hauts-de-France;59;1;30;076;Bettignies;310;5;315
32;Hauts-de-France;59;1;05;077;Bettrechies;255;6;261
32;Hauts-de-France;59;1;19;078;Beugnies;630;6;636
32;Hauts-de-France;59;6;03;079;Beuvrages;6821;34;6855
32;Hauts-de-France;59;3;31;080;Beuvry-la-Forêt;2761;31;2792
32;Hauts-de-France;59;2;11;081;Bévillers;566;6;572
32;Hauts-de-France;59;4;12;082;Bierne;1819;30;1849
32;Hauts-de-France;59;4;41;083;Bissezeele;249;2;251
32;Hauts-de-France;59;4;21;084;Blaringhem;2064;30;2094
32;Hauts-de-France;59;2;09;085;Blécourt;305;6;311
32;Hauts-de-France;59;4;08;086;Boeschepe;2179;30;2209
32;Hauts-de-France;59;4;21;087;Boëseghem;749;13;762
32;Hauts-de-France;59;5;04;088;Bois-Grenier;1675;21;1696
32;Hauts-de-France;59;4;41;089;Bollezeele;1430;30;1460
32;Hauts-de-France;59;5;24;090;Bondues;9961;182;10143
32;Hauts-de-France;59;4;08;091;Borre;580;14;594
32;Hauts-de-France;59;6;14;092;Bouchain;3940;39;3979
32;Hauts-de-France;59;1;07;093;Boulogne-sur-Helpe;340;5;345
32;Hauts-de-France;59;4;20;094;Bourbourg;7171;50;7221
32;Hauts-de-France;59;5;36;096;Bourghelles;1653;38;1691
32;Hauts-de-France;59;2;09;097;Boursies;397;5;402
32;Hauts-de-France;59;5;22;098;Bousbecque;4818;54;4872
32;Hauts-de-France;59;1;07;099;Bousies;1740;13;1753
32;Hauts-de-France;59;6;34;100;Bousignies;343;4;347
32;Hauts-de-France;59;1;19;101;Bousignies-sur-Roc;394;11;405
32;Hauts-de-France;59;2;11;102;Boussières-en-Cambrésis;430;4;434
32;Hauts-de-France;59;1;05;103;Boussières-sur-Sambre;524;9;533
32;Hauts-de-France;59;1;30;104;Boussois;3212;22;3234
32;Hauts-de-France;59;3;31;105;Bouvignies;1537;25;1562
32;Hauts-de-France;59;5;36;106;Bouvines;765;14;779
32;Hauts-de-France;59;4;17;107;Bray-Dunes;4507;46;4553
32;Hauts-de-France;59;2;10;108;Briastre;745;4;749
32;Hauts-de-France;59;6;34;109;Brillon;754;9;763
32;Hauts-de-France;59;4;20;110;Brouckerque;1408;29;1437
32;Hauts-de-France;59;4;41;111;Broxeele;401;4;405
32;Hauts-de-France;59;6;03;112;Bruay-sur-l'Escaut;11311;41;11352
32;Hauts-de-France;59;3;35;113;Bruille-lez-Marchiennes;1365;6;1371
32;Hauts-de-France;59;6;34;114;Bruille-Saint-Amand;1672;15;1687
32;Hauts-de-France;59;3;01;115;Brunémont;712;4;716
32;Hauts-de-France;59;1;05;116;Bry;418;12;430
32;Hauts-de-France;59;3;01;117;Bugnicourt;1042;11;1053
32;Hauts-de-France;59;2;10;118;Busigny;2473;25;2498
32;Hauts-de-France;59;4;41;119;Buysscheure;591;9;600
32;Hauts-de-France;59;4;08;120;Caëstre;2017;32;2049
32;Hauts-de-France;59;2;11;121;Cagnoncles;614;7;621
32;Hauts-de-France;59;2;09;122;Cambrai;32501;627;33128
32;Hauts-de-France;59;5;02;123;Camphin-en-Carembault;1682;22;1704
32;Hauts-de-France;59;5;36;124;Camphin-en-Pévèle;2493;41;2534
32;Hauts-de-France;59;2;10;125;Cantaing-sur-Escaut;402;9;411
32;Hauts-de-France;59;3;01;126;Cantin;1605;13;1618
32;Hauts-de-France;59;2;11;127;Capelle;149;5;154
32;Hauts-de-France;59;5;04;128;Capinghem;2565;30;2595
32;Hauts-de-France;59;4;20;130;Cappelle-Brouck;1159;19;1178
32;Hauts-de-France;59;5;36;129;Cappelle-en-Pévèle;2234;26;2260
32;Hauts-de-France;59;4;12;131;Cappelle-la-Grande;7909;74;7983
32;Hauts-de-France;59;2;11;132;Carnières;1047;13;1060
32;Hauts-de-France;59;5;02;133;Carnin;1024;19;1043
32;Hauts-de-France;59;1;07;134;Cartignies;1245;10;1255
32;Hauts-de-France;59;4;08;135;Cassel;2278;100;2378
32;Hauts-de-France;59;2;10;136;Le Cateau-Cambrésis;6951;140;7091
32;Hauts-de-France;59;2;10;137;Catillon-sur-Sambre;823;8;831
32;Hauts-de-France;59;2;10;138;Cattenières;678;14;692
32;Hauts-de-France;59;2;11;139;Caudry;14487;143;14630
32;Hauts-de-France;59;2;10;140;Caullery;452;10;462
32;Hauts-de-France;59;2;11;141;Cauroir;573;15;588
32;Hauts-de-France;59;1;19;142;Cerfontaine;702;5;707
32;Hauts-de-France;59;5;04;143;La Chapelle-d'Armentières;8627;95;8722
32;Hauts-de-France;59;6;34;144;Château-l'Abbaye;864;10;874
32;Hauts-de-France;59;5;18;145;Chemy;767;12;779
32;Hauts-de-France;59;5;36;146;Chéreng;2991;40;3031
32;Hauts-de-France;59;1;19;147;Choisies;51;2;53
32;Hauts-de-France;59;1;19;148;Clairfayts;366;1;367
32;Hauts-de-France;59;2;10;149;Clary;1088;16;1104
32;Hauts-de-France;59;5;36;150;Cobrieux;529;11;540
32;Hauts-de-France;59;1;19;151;Colleret;1618;17;1635
32;Hauts-de-France;59;5;22;152;Comines;12498;97;12595
32;Hauts-de-France;59;6;29;153;Condé-sur-l'Escaut;9586;55;9641
32;Hauts-de-France;59;4;12;155;Coudekerque-Branche;20925;294;21219
32;Hauts-de-France;59;3;15;156;Courchelettes;2813;32;2845
32;Hauts-de-France;59;1;19;157;Cousolre;2237;21;2258
32;Hauts-de-France;59;3;31;158;Coutiches;3041;45;3086
32;Hauts-de-France;59;4;20;159;Craywick;676;6;682
32;Hauts-de-France;59;6;29;160;Crespin;4514;29;4543
32;Hauts-de-France;59;2;10;161;Crèvecœur-sur-l'Escaut;750;45;795
32;Hauts-de-France;59;4;41;162;Crochte;665;21;686
32;Hauts-de-France;59;5;13;163;Croix;21087;282;21369
32;Hauts-de-France;59;1;07;164;Croix-Caluyau;252;8;260
32;Hauts-de-France;59;3;15;165;Cuincy;6421;98;6519
32;Hauts-de-France;59;6;29;166;Curgies;1278;35;1313
32;Hauts-de-France;59;2;09;167;Cuvillers;199;1;200
32;Hauts-de-France;59;5;36;168;Cysoing;4908;70;4978
32;Hauts-de-France;59;1;19;169;Damousies;197;4;201
32;Hauts-de-France;59;3;01;170;Dechy;5362;34;5396
32;Hauts-de-France;59;2;10;171;Dehéries;38;2;40
32;Hauts-de-France;59;6;14;172;Denain;19933;122;20055
32;Hauts-de-France;59;5;04;173;Deûlémont;1798;24;1822
32;Hauts-de-France;59;1;19;174;Dimechaux;337;2;339
32;Hauts-de-France;59;1;19;175;Dimont;312;9;321
32;Hauts-de-France;59;2;09;176;Doignies;329;3;332
32;Hauts-de-France;59;1;07;177;Dompierre-sur-Helpe;854;14;868
32;Hauts-de-France;59;5;02;670;Don;1312;13;1325
32;Hauts-de-France;59;3;15;178;Douai;39634;855;40489
32;Hauts-de-France;59;6;14;179;Douchy-les-Mines;10311;32;10343
32;Hauts-de-France;59;4;08;180;Le Doulieu;1472;19;1491
32;Hauts-de-France;59;1;07;181;Dourlers;554;6;560
32;Hauts-de-France;59;4;20;182;Drincham;262;6;268
32;Hauts-de-France;59;4;96;183;Dunkerque;86865;1276;88141
32;Hauts-de-France;59;4;21;184;Ebblinghem;666;10;676
32;Hauts-de-France;59;3;01;185;Écaillon;1936;13;1949
32;Hauts-de-France;59;1;19;186;Eccles;82;1;83
32;Hauts-de-France;59;1;07;187;Éclaibes;280;5;285
32;Hauts-de-France;59;1;05;188;Écuélin;137;4;141
32;Hauts-de-France;59;4;08;189;Eecke;1220;26;1246
32;Hauts-de-France;59;1;30;190;Élesmes;976;14;990
32;Hauts-de-France;59;2;10;191;Élincourt;624;5;629
32;Hauts-de-France;59;6;14;192;Émerchicourt;869;47;916
32;Hauts-de-France;59;5;18;193;Emmerin;3140;25;3165
32;Hauts-de-France;59;1;07;194;Englefontaine;1293;23;1316
32;Hauts-de-France;59;5;28;195;Englos;613;9;622
32;Hauts-de-France;59;5;28;196;Ennetières-en-Weppes;1300;19;1319
32;Hauts-de-France;59;5;36;197;Ennevelin;2204;22;2226
32;Hauts-de-France;59;1;19;198;Eppe-Sauvage;257;0;257
32;Hauts-de-France;59;3;01;199;Erchin;689;11;700
32;Hauts-de-France;59;4;41;200;Eringhem;488;6;494
32;Hauts-de-France;59;5;28;201;Erquinghem-le-Sec;598;11;609
32;Hauts-de-France;59;5;04;202;Erquinghem-Lys;5293;40;5333
32;Hauts-de-France;59;3;35;203;Erre;1589;9;1598
32;Hauts-de-France;59;2;11;204;Escarmain;476;4;480
32;Hauts-de-France;59;6;14;205;Escaudain;9645;43;9688
32;Hauts-de-France;59;2;09;206;Escaudœuvres;3238;28;3266
32;Hauts-de-France;59;6;03;207;Escautpont;4173;28;4201
32;Hauts-de-France;59;5;28;208;Escobecques;297;10;307
32;Hauts-de-France;59;2;10;209;Esnes;676;8;684
32;Hauts-de-France;59;4;41;210;Esquelbecq;2110;39;2149
32;Hauts-de-France;59;3;15;211;Esquerchin;899;19;918
32;Hauts-de-France;59;4;21;212;Estaires;6420;147;6567
32;Hauts-de-France;59;2;11;213;Estourmel;460;15;475
32;Hauts-de-France;59;3;01;214;Estrées;1106;21;1127
32;Hauts-de-France;59;6;29;215;Estreux;957;33;990
32;Hauts-de-France;59;2;09;219;Estrun;711;8;719
32;Hauts-de-France;59;2;09;216;Eswars;351;8;359
32;Hauts-de-France;59;1;05;217;Eth;343;7;350
32;Hauts-de-France;59;1;07;218;Étrœungt;1315;15;1330
32;Hauts-de-France;59;5;18;220;Faches-Thumesnil;18165;122;18287
32;Hauts-de-France;59;6;06;221;Famars;2531;68;2599
32;Hauts-de-France;59;3;31;222;Faumont;2191;45;2236
32;Hauts-de-France;59;1;07;223;Le Favril;507;4;511
32;Hauts-de-France;59;3;01;224;Féchain;1722;14;1736
32;Hauts-de-France;59;1;05;225;Feignies;6854;70;6924
32;Hauts-de-France;59;1;19;226;Felleries;1437;16;1453
32;Hauts-de-France;59;3;35;227;Fenain;5448;49;5497
32;Hauts-de-France;59;3;01;228;Férin;1469;17;1486
32;Hauts-de-France;59;1;19;229;Féron;567;9;576
32;Hauts-de-France;59;1;30;230;Ferrière-la-Grande;5292;52;5344
32;Hauts-de-France;59;1;19;231;Ferrière-la-Petite;1064;13;1077
32;Hauts-de-France;59;1;05;232;La Flamengrie;424;4;428
32;Hauts-de-France;59;1;19;233;Flaumont-Waudrechies;373;3;376
32;Hauts-de-France;59;3;15;234;Flers-en-Escrebieux;5816;42;5858
32;Hauts-de-France;59;2;10;236;Flesquières;261;4;265
32;Hauts-de-France;59;4;08;237;Flêtre;983;23;1006
32;Hauts-de-France;59;6;34;238;Flines-lès-Mortagne;1646;25;1671
32;Hauts-de-France;59;3;31;239;Flines-lez-Raches;5597;92;5689
32;Hauts-de-France;59;1;07;240;Floursies;127;3;130
32;Hauts-de-France;59;1;07;241;Floyon;526;15;541
32;Hauts-de-France;59;1;07;242;Fontaine-au-Bois;673;7;680
32;Hauts-de-France;59;2;10;243;Fontaine-au-Pire;1218;18;1236
32;Hauts-de-France;59;2;09;244;Fontaine-Notre-Dame;1776;31;1807
32;Hauts-de-France;59;1;07;246;Forest-en-Cambrésis;565;4;569
32;Hauts-de-France;59;5;40;247;Forest-sur-Marque;1467;18;1485
32;Hauts-de-France;59;1;19;249;Fourmies;11714;191;11905
32;Hauts-de-France;59;5;02;250;Fournes-en-Weppes;2225;110;2335
32;Hauts-de-France;59;1;05;251;Frasnoy;376;4;380
32;Hauts-de-France;59;5;04;252;Frelinghien;2431;20;2451
32;Hauts-de-France;59;6;03;253;Fresnes-sur-Escaut;7532;41;7573
32;Hauts-de-France;59;3;01;254;Fressain;873;12;885
32;Hauts-de-France;59;2;09;255;Fressies;572;8;580
32;Hauts-de-France;59;5;36;256;Fretin;3334;33;3367
32;Hauts-de-France;59;5;02;257;Fromelles;1000;14;1014
32;Hauts-de-France;59;5;36;258;Genech;2768;641;3409
32;Hauts-de-France;59;1;07;259;Ghissignies;515;20;535
32;Hauts-de-France;59;4;17;260;Ghyvelde;4164;60;4224
32;Hauts-de-France;59;1;19;261;Glageon;1782;30;1812
32;Hauts-de-France;59;4;08;262;Godewaersvelde;2051;37;2088
32;Hauts-de-France;59;1;30;264;Gognies-Chaussée;738;11;749
32;Hauts-de-France;59;1;05;265;Gommegnies;2312;36;2348
32;Hauts-de-France;59;5;18;266;Gondecourt;4045;41;4086
32;Hauts-de-France;59;2;10;267;Gonnelieu;304;4;308
32;Hauts-de-France;59;4;21;268;La Gorgue;5637;49;5686
32;Hauts-de-France;59;2;10;269;Gouzeaucourt;1477;25;1502
32;Hauts-de-France;59;1;07;270;Grand-Fayt;493;7;500
32;Hauts-de-France;59;4;20;272;Grand-Fort-Philippe;5121;47;5168
32;Hauts-de-France;59;4;20;271;Grande-Synthe;22777;209;22986
32;Hauts-de-France;59;4;20;273;Gravelines;11132;198;11330
32;Hauts-de-France;59;2;10;274;La Groise;484;4;488
32;Hauts-de-France;59;5;36;275;Gruson;1288;36;1324
32;Hauts-de-France;59;3;01;276;Guesnain;4691;34;4725
32;Hauts-de-France;59;1;05;277;Gussignies;335;4;339
32;Hauts-de-France;59;3;01;263;Gœulzin;1034;26;1060
32;Hauts-de-France;59;5;28;278;Hallennes-lez-Haubourdin;4727;38;4765
32;Hauts-de-France;59;5;37;279;Halluin;20808;114;20922
32;Hauts-de-France;59;3;01;280;Hamel;793;10;803
32;Hauts-de-France;59;5;02;281;Hantay;1292;12;1304
32;Hauts-de-France;59;4;41;282;Hardifort;383;10;393
32;Hauts-de-France;59;1;05;283;Hargnies;609;10;619
32;Hauts-de-France;59;6;34;284;Hasnon;3899;31;3930
32;Hauts-de-France;59;6;06;285;Haspres;2709;20;2729
32;Hauts-de-France;59;5;18;286;Haubourdin;14775;119;14894
32;Hauts-de-France;59;2;10;287;Haucourt-en-Cambrésis;195;4;199
32;Hauts-de-France;59;6;06;288;Haulchin;2323;26;2349
32;Hauts-de-France;59;2;11;289;Haussy;1529;33;1562
32;Hauts-de-France;59;1;07;290;Haut-Lieu;389;1;390
32;Hauts-de-France;59;1;07;291;Hautmont;14601;98;14699
32;Hauts-de-France;59;6;06;292;Haveluy;3212;6;3218
32;Hauts-de-France;59;4;21;293;Haverskerque;1419;18;1437
32;Hauts-de-France;59;2;09;294;Haynecourt;318;7;325
32;Hauts-de-France;59;4;21;295;Hazebrouck;21353;495;21848
32;Hauts-de-France;59;1;07;296;Hecq;356;10;366
32;Hauts-de-France;59;6;34;297;Hélesmes;1988;9;1997
32;Hauts-de-France;59;5;13;299;Hem;18621;173;18794
32;Hauts-de-France;59;2;09;300;Hem-Lenglet;557;9;566
32;Hauts-de-France;59;6;29;301;Hergnies;4439;27;4466
32;Hauts-de-France;59;6;06;302;Hérin;4128;29;4157
32;Hauts-de-France;59;5;02;303;Herlies;2396;27;2423
32;Hauts-de-France;59;5;18;304;Herrin;422;8;430
32;Hauts-de-France;59;4;41;305;Herzeele;1641;34;1675
32;Hauts-de-France;59;1;19;306;Hestrud;293;3;296
32;Hauts-de-France;59;4;41;307;Holque;898;5;903
32;Hauts-de-France;59;1;05;310;Hon-Hergies;862;10;872
32;Hauts-de-France;59;4;08;308;Hondeghem;932;24;956
32;Hauts-de-France;59;4;41;309;Hondschoote;4072;84;4156
32;Hauts-de-France;59;2;10;311;Honnechy;552;7;559
32;Hauts-de-France;59;2;10;312;Honnecourt-sur-Escaut;777;18;795
32;Hauts-de-France;59;6;14;313;Hordain;1426;9;1435
32;Hauts-de-France;59;3;35;314;Hornaing;3562;21;3583
32;Hauts-de-France;59;1;05;315;Houdain-lez-Bavay;881;12;893
32;Hauts-de-France;59;5;18;316;Houplin-Ancoisne;3378;47;3425
32;Hauts-de-France;59;5;04;317;Houplines;7770;94;7864
32;Hauts-de-France;59;4;41;318;Houtkerque;982;8;990
32;Hauts-de-France;59;4;41;319;Hoymille;3204;202;3406
32;Hauts-de-France;59;5;02;320;Illies;1635;12;1647
32;Hauts-de-France;59;2;10;321;Inchy;708;5;713
32;Hauts-de-France;59;2;11;322;Iwuy;3359;31;3390
32;Hauts-de-France;59;1;05;323;Jenlain;1141;26;1167
32;Hauts-de-France;59;1;30;324;Jeumont;10229;111;10340
32;Hauts-de-France;59;1;07;325;Jolimetz;864;16;880
32;Hauts-de-France;59;4;41;326;Killem;1148;21;1169
32;Hauts-de-France;59;3;35;327;Lallaing;6297;38;6335
32;Hauts-de-France;59;5;22;328;Lambersart;27415;431;27846
32;Hauts-de-France;59;3;15;329;Lambres-lez-Douai;5071;84;5155
32;Hauts-de-France;59;3;31;330;Landas;2395;41;2436
32;Hauts-de-France;59;1;07;331;Landrecies;3479;107;3586
32;Hauts-de-France;59;5;13;332;Lannoy;1796;7;1803
32;Hauts-de-France;59;1;07;333;Larouillies;248;9;257
32;Hauts-de-France;59;3;15;334;Lauwin-Planque;1644;23;1667
32;Hauts-de-France;59;6;34;335;Lecelles;2828;55;2883
32;Hauts-de-France;59;3;01;336;Lécluse;1375;13;1388
32;Hauts-de-France;59;4;41;337;Lederzeele;680;21;701
32;Hauts-de-France;59;4;41;338;Ledringhem;659;27;686
32;Hauts-de-France;59;5;33;339;Leers;9400;80;9480
32;Hauts-de-France;59;4;17;340;Leffrinckoucke;4255;97;4352
32;Hauts-de-France;59;2;10;341;Lesdain;426;7;433
32;Hauts-de-France;59;5;36;343;Lesquin;8635;82;8717
32;Hauts-de-France;59;1;05;344;Leval;2445;10;2455
32;Hauts-de-France;59;3;01;345;Lewarde;2427;23;2450
32;Hauts-de-France;59;1;19;342;Lez-Fontaine;226;4;230
32;Hauts-de-France;59;5;26;346;Lezennes;3065;23;3088
32;Hauts-de-France;59;1;19;347;Liessies;536;16;552
32;Hauts-de-France;59;6;14;348;Lieu-Saint-Amand;1388;14;1402
32;Hauts-de-France;59;2;10;349;Ligny-en-Cambrésis;1895;30;1925
32;Hauts-de-France;59;5;97;350;Lille;233098;2091;235189
32;Hauts-de-France;59;1;07;351;Limont-Fontaine;557;7;564
32;Hauts-de-France;59;5;22;352;Linselles;8329;98;8427
32;Hauts-de-France;59;1;07;353;Locquignol;350;8;358
32;Hauts-de-France;59;3;01;354;Loffre;722;13;735
32;Hauts-de-France;59;5;22;356;Lompret;2264;48;2312
32;Hauts-de-France;59;1;05;357;La Longueville;2094;33;2127
32;Hauts-de-France;59;4;20;358;Looberghe;1181;23;1204
32;Hauts-de-France;59;4;20;359;Loon-Plage;6139;75;6214
32;Hauts-de-France;59;5;28;360;Loos;22426;237;22663
32;Hauts-de-France;59;6;14;361;Lourches;3959;18;3977
32;Hauts-de-France;59;1;07;363;Louvignies-Quesnoy;932;19;951
32;Hauts-de-France;59;5;36;364;Louvil;847;11;858
32;Hauts-de-France;59;1;30;365;Louvroil;6405;39;6444
32;Hauts-de-France;59;4;21;366;Lynde;767;15;782
32;Hauts-de-France;59;5;13;367;Lys-lez-Lannoy;13471;150;13621
32;Hauts-de-France;59;5;23;368;La Madeleine;21968;187;22155
32;Hauts-de-France;59;6;06;369;Maing;4061;40;4101
32;Hauts-de-France;59;1;30;370;Mairieux;722;11;733
32;Hauts-de-France;59;5;02;371;Le Maisnil;642;15;657
32;Hauts-de-France;59;2;10;372;Malincourt;495;6;501
32;Hauts-de-France;59;1;07;374;Marbaix;478;4;482
32;Hauts-de-France;59;3;35;375;Marchiennes;4587;63;4650
32;Hauts-de-France;59;2;10;377;Marcoing;1894;25;1919
32;Hauts-de-France;59;5;24;378;Marcq-en-Barœul;38570;721;39291
32;Hauts-de-France;59;3;01;379;Marcq-en-Ostrevent;744;3;747
32;Hauts-de-France;59;1;07;381;Maresches;816;20;836
32;Hauts-de-France;59;2;10;382;Maretz;1451;15;1466
32;Hauts-de-France;59;6;29;383;Marly;12074;114;12188
32;Hauts-de-France;59;1;07;384;Maroilles;1416;23;1439
32;Hauts-de-France;59;1;30;385;Marpent;2729;22;2751
32;Hauts-de-France;59;6;14;387;Marquette-en-Ostrevant;1885;12;1897
32;Hauts-de-France;59;5;23;386;Marquette-lez-Lille;10354;66;10420
32;Hauts-de-France;59;5;02;388;Marquillies;2008;24;2032
32;Hauts-de-France;59;2;10;389;Masnières;2731;29;2760
32;Hauts-de-France;59;3;01;390;Masny;4125;45;4170
32;Hauts-de-France;59;6;14;391;Mastaing;877;5;882
32;Hauts-de-France;59;1;30;392;Maubeuge;29632;287;29919
32;Hauts-de-France;59;6;34;393;Maulde;1025;11;1036
32;Hauts-de-France;59;2;10;394;Maurois;399;3;402
32;Hauts-de-France;59;2;10;395;Mazinghien;305;4;309
32;Hauts-de-France;59;1;05;396;Mecquignies;711;7;718
32;Hauts-de-France;59;4;41;397;Merckeghem;599;12;611
32;Hauts-de-France;59;5;36;398;Mérignies;3132;139;3271
32;Hauts-de-France;59;4;08;399;Merris;1011;28;1039
32;Hauts-de-France;59;4;21;400;Merville;9598;88;9686
32;Hauts-de-France;59;4;08;401;Méteren;2314;37;2351
32;Hauts-de-France;59;4;41;402;Millam;820;21;841
32;Hauts-de-France;59;6;34;403;Millonfosse;716;12;728
32;Hauts-de-France;59;1;05;406;Monceau-Saint-Waast;475;6;481
32;Hauts-de-France;59;6;06;407;Monchaux-sur-Écaillon;539;9;548
32;Hauts-de-France;59;5;36;408;Moncheaux;1583;18;1601
32;Hauts-de-France;59;3;01;409;Monchecourt;2512;20;2532
32;Hauts-de-France;59;5;25;410;Mons-en-Barœul;21017;136;21153
32;Hauts-de-France;59;5;36;411;Mons-en-Pévèle;2126;37;2163
32;Hauts-de-France;59;2;10;412;Montay;285;4;289
32;Hauts-de-France;59;2;10;413;Montigny-en-Cambrésis;561;9;570
32;Hauts-de-France;59;3;01;414;Montigny-en-Ostrevent;4791;39;4830
32;Hauts-de-France;59;2;11;415;Montrécourt;224;1;225
32;Hauts-de-France;59;4;21;416;Morbecque;2519;41;2560
32;Hauts-de-France;59;6;34;418;Mortagne-du-Nord;1609;7;1616
32;Hauts-de-France;59;5;36;419;Mouchin;1400;16;1416
32;Hauts-de-France;59;1;19;420;Moustier-en-Fagne;59;2;61
32;Hauts-de-France;59;5;24;421;Mouvaux;13173;178;13351
32;Hauts-de-France;59;2;09;405;Mœuvres;474;3;477
32;Hauts-de-France;59;2;11;422;Naves;633;12;645
32;Hauts-de-France;59;4;21;423;Neuf-Berquin;1248;19;1267
32;Hauts-de-France;59;1;05;424;Neuf-Mesnil;1324;5;1329
32;Hauts-de-France;59;5;36;427;La Neuville;644;10;654
32;Hauts-de-France;59;1;07;425;Neuville-en-Avesnois;303;8;311
32;Hauts-de-France;59;5;37;426;Neuville-en-Ferrain;10231;68;10299
32;Hauts-de-France;59;2;09;428;Neuville-Saint-Rémy;3792;40;3832
32;Hauts-de-France;59;6;14;429;Neuville-sur-Escaut;2695;16;2711
32;Hauts-de-France;59;2;10;430;Neuvilly;1100;12;1112
32;Hauts-de-France;59;4;08;431;Nieppe;7479;79;7558
32;Hauts-de-France;59;2;10;432;Niergnies;517;7;524
32;Hauts-de-France;59;4;41;433;Nieurlet;927;13;940
32;Hauts-de-France;59;6;34;434;Nivelle;1334;17;1351
32;Hauts-de-France;59;3;31;435;Nomain;2544;37;2581
32;Hauts-de-France;59;4;41;436;Noordpeene;787;10;797
32;Hauts-de-France;59;5;18;437;Noyelles-lès-Seclin;864;12;876
32;Hauts-de-France;59;2;10;438;Noyelles-sur-Escaut;805;12;817
32;Hauts-de-France;59;1;05;439;Noyelles-sur-Sambre;274;5;279
32;Hauts-de-France;59;6;14;440;Noyelles-sur-Selle;701;6;707
32;Hauts-de-France;59;1;05;441;Obies;662;6;668
32;Hauts-de-France;59;1;19;442;Obrechies;269;6;275
32;Hauts-de-France;59;4;41;443;Ochtezeele;383;5;388
32;Hauts-de-France;59;6;29;444;Odomez;930;11;941
32;Hauts-de-France;59;1;19;445;Ohain;1194;17;1211
32;Hauts-de-France;59;6;06;446;Oisy;631;8;639
32;Hauts-de-France;59;6;03;447;Onnaing;8813;65;8878
32;Hauts-de-France;59;4;41;448;Oost-Cappel;468;5;473
32;Hauts-de-France;59;3;31;449;Orchies;8736;146;8882
32;Hauts-de-France;59;2;10;450;Ors;636;9;645
32;Hauts-de-France;59;1;07;451;Orsinval;552;3;555
32;Hauts-de-France;59;5;02;452;Ostricourt;5367;26;5393
32;Hauts-de-France;59;4;41;453;Oudezeele;681;14;695
32;Hauts-de-France;59;4;08;454;Oxelaëre;518;4;522
32;Hauts-de-France;59;2;09;455;Paillencourt;1002;8;1010
32;Hauts-de-France;59;3;35;456;Pecquencourt;6050;261;6311
32;Hauts-de-France;59;5;04;457;Pérenchies;8413;41;8454
32;Hauts-de-France;59;5;36;458;Péronne-en-Mélantois;913;19;932
32;Hauts-de-France;59;1;07;461;Petit-Fayt;311;2;313
32;Hauts-de-France;59;6;06;459;Petite-Forêt;4882;37;4919
32;Hauts-de-France;59;5;02;462;Phalempin;4780;37;4817
32;Hauts-de-France;59;4;20;463;Pitgam;973;12;985
32;Hauts-de-France;59;1;07;464;Poix-du-Nord;2208;18;2226
32;Hauts-de-France;59;2;10;465;Pommereuil;765;3;768
32;Hauts-de-France;59;5;36;466;Pont-à-Marcq;2899;93;2992
32;Hauts-de-France;59;1;05;467;Pont-sur-Sambre;2505;28;2533
32;Hauts-de-France;59;1;07;468;Potelle;412;4;416
32;Hauts-de-France;59;4;08;469;Pradelles;406;4;410
32;Hauts-de-France;59;5;04;470;Prémesques;2119;24;2143
32;Hauts-de-France;59;6;29;471;Préseau;1957;23;1980
32;Hauts-de-France;59;1;07;472;Preux-au-Bois;840;10;850
32;Hauts-de-France;59;1;05;473;Preux-au-Sart;311;7;318
32;Hauts-de-France;59;1;07;474;Prisches;1058;21;1079
32;Hauts-de-France;59;6;06;475;Prouvy;2249;33;2282
32;Hauts-de-France;59;2;09;476;Proville;3150;75;3225
32;Hauts-de-France;59;5;02;477;Provin;4318;39;4357
32;Hauts-de-France;59;4;41;478;Quaëdypre;1112;26;1138
32;Hauts-de-France;59;6;29;479;Quarouble;3045;25;3070
32;Hauts-de-France;59;6;06;480;Quérénaing;881;20;901
32;Hauts-de-France;59;1;07;481;Le Quesnoy;4902;129;5031
32;Hauts-de-France;59;5;22;482;Quesnoy-sur-Deûle;6814;61;6875
32;Hauts-de-France;59;1;19;483;Quiévelon;134;2;136
32;Hauts-de-France;59;6;29;484;Quiévrechain;6355;32;6387
32;Hauts-de-France;59;2;11;485;Quiévy;1790;21;1811
32;Hauts-de-France;59;3;31;486;Râches;2719;44;2763
32;Hauts-de-France;59;5;02;487;Radinghem-en-Weppes;1403;19;1422
32;Hauts-de-France;59;2;09;488;Raillencourt-Sainte-Olle;2209;41;2250
32;Hauts-de-France;59;3;31;489;Raimbeaucourt;4005;55;4060
32;Hauts-de-France;59;1;19;490;Rainsars;179;2;181
32;Hauts-de-France;59;6;34;491;Raismes;12468;65;12533
32;Hauts-de-France;59;2;09;492;Ramillies;603;7;610
32;Hauts-de-France;59;1;19;493;Ramousies;228;1;229
32;Hauts-de-France;59;1;07;494;Raucourt-au-Bois;167;1;168
32;Hauts-de-France;59;1;19;495;Recquignies;2408;24;2432
32;Hauts-de-France;59;2;10;496;Rejet-de-Beaulieu;251;1;252
32;Hauts-de-France;59;4;21;497;Renescure;2100;29;2129
32;Hauts-de-France;59;2;10;498;Reumont;358;8;366
32;Hauts-de-France;59;4;41;499;Rexpoëde;1988;33;2021
32;Hauts-de-France;59;2;10;500;Ribécourt-la-Tour;373;5;378
32;Hauts-de-France;59;3;35;501;Rieulay;1294;26;1320
32;Hauts-de-France;59;2;11;502;Rieux-en-Cambrésis;1429;9;1438
32;Hauts-de-France;59;1;07;503;Robersart;191;3;194
32;Hauts-de-France;59;6;29;505;Rombies-et-Marchipont;760;3;763
32;Hauts-de-France;59;2;11;506;Romeries;459;7;466
32;Hauts-de-France;59;5;26;507;Ronchin;19477;122;19599
32;Hauts-de-France;59;5;37;508;Roncq;13361;128;13489
32;Hauts-de-France;59;3;31;509;Roost-Warendin;6089;48;6137
32;Hauts-de-France;59;6;34;511;Rosult;1915;26;1941
32;Hauts-de-France;59;5;98;512;Roubaix;98089;482;98571
32;Hauts-de-France;59;3;01;513;Roucourt;457;7;464
32;Hauts-de-France;59;1;19;514;Rousies;4055;53;4108
32;Hauts-de-France;59;6;06;515;Rouvignies;650;6;656
32;Hauts-de-France;59;4;41;516;Rubrouck;936;19;955
32;Hauts-de-France;59;2;10;517;Les Rues-des-Vignes;786;15;801
32;Hauts-de-France;59;1;07;518;Ruesnes;459;7;466
32;Hauts-de-France;59;6;34;519;Rumegies;1778;34;1812
32;Hauts-de-France;59;2;10;520;Rumilly-en-Cambrésis;1444;25;1469
32;Hauts-de-France;59;6;14;504;Rœulx;3817;21;3838
32;Hauts-de-France;59;2;09;521;Sailly-lez-Cambrai;457;9;466
32;Hauts-de-France;59;5;40;522;Sailly-lez-Lannoy;1926;38;1964
32;Hauts-de-France;59;5;36;523;Sainghin-en-Mélantois;2792;26;2818
32;Hauts-de-France;59;5;02;524;Sainghin-en-Weppes;5533;51;5584
32;Hauts-de-France;59;1;19;525;Sains-du-Nord;2845;26;2871
32;Hauts-de-France;59;6;34;526;Saint-Amand-les-Eaux;16053;152;16205
32;Hauts-de-France;59;5;23;527;Saint-André-lez-Lille;12966;116;13082
32;Hauts-de-France;59;2;11;528;Saint-Aubert;1568;17;1585
32;Hauts-de-France;59;1;07;529;Saint-Aubin;359;8;367
32;Hauts-de-France;59;6;29;530;Saint-Aybert;364;1;365
32;Hauts-de-France;59;2;10;531;Saint-Benin;341;3;344
32;Hauts-de-France;59;4;20;532;Saint-Georges-sur-l'Aa;305;8;313
32;Hauts-de-France;59;2;11;533;Saint-Hilaire-lez-Cambrai;1575;14;1589
32;Hauts-de-France;59;1;07;534;Saint-Hilaire-sur-Helpe;825;31;856
32;Hauts-de-France;59;4;08;535;Saint-Jans-Cappel;1714;49;1763
32;Hauts-de-France;59;2;11;537;Saint-Martin-sur-Écaillon;510;9;519
32;Hauts-de-France;59;4;41;538;Saint-Momelin;443;11;454
32;Hauts-de-France;59;4;20;539;Saint-Pierre-Brouck;991;18;1009
32;Hauts-de-France;59;2;11;541;Saint-Python;1026;7;1033
32;Hauts-de-France;59;1;05;542;Saint-Remy-Chaussée;509;12;521
32;Hauts-de-France;59;1;07;543;Saint-Remy-du-Nord;1108;10;1118
32;Hauts-de-France;59;6;39;544;Saint-Saulve;11353;160;11513
32;Hauts-de-France;59;2;10;545;Saint-Souplet;1228;24;1252
32;Hauts-de-France;59;4;08;546;Saint-Sylvestre-Cappel;1170;30;1200
32;Hauts-de-France;59;2;11;547;Saint-Vaast-en-Cambrésis;871;9;880
32;Hauts-de-France;59;1;05;548;Saint-Waast;636;8;644
32;Hauts-de-France;59;4;08;536;Sainte-Marie-Cappel;879;21;900
32;Hauts-de-France;59;1;07;549;Salesches;315;3;318
32;Hauts-de-France;59;5;02;550;Salomé;2956;22;2978
32;Hauts-de-France;59;3;31;551;Saméon;1702;24;1726
32;Hauts-de-France;59;2;09;552;Sancourt;197;6;203
32;Hauts-de-France;59;5;28;553;Santes;5668;53;5721
32;Hauts-de-France;59;6;34;554;Sars-et-Rosières;598;15;613
32;Hauts-de-France;59;1;19;555;Sars-Poteries;1444;18;1462
32;Hauts-de-France;59;1;05;556;Sassegnies;264;3;267
32;Hauts-de-France;59;6;29;557;Saultain;2435;15;2450
32;Hauts-de-France;59;2;11;558;Saulzoir;1720;19;1739
32;Hauts-de-France;59;6;29;559;Sebourg;1975;32;2007
32;Hauts-de-France;59;5;18;560;Seclin;12410;93;12503
32;Hauts-de-France;59;1;19;562;Sémeries;544;7;551
32;Hauts-de-France;59;1;07;563;Semousies;240;3;243
32;Hauts-de-France;59;6;06;564;La Sentinelle;3126;16;3142
32;Hauts-de-France;59;1;07;565;Sepmeries;653;11;664
32;Hauts-de-France;59;5;28;566;Sequedin;4739;36;4775
32;Hauts-de-France;59;2;10;567;Séranvillers-Forenville;413;6;419
32;Hauts-de-France;59;4;21;568;Sercus;469;8;477
32;Hauts-de-France;59;3;35;569;Sin-le-Noble;15522;109;15631
32;Hauts-de-France;59;4;41;570;Socx;928;35;963
32;Hauts-de-France;59;2;11;571;Solesmes;4290;108;4398
32;Hauts-de-France;59;1;19;572;Solre-le-Château;1797;21;1818
32;Hauts-de-France;59;1;19;573;Solrinnes;137;3;140
32;Hauts-de-France;59;3;35;574;Somain;12213;77;12290
32;Hauts-de-France;59;2;11;575;Sommaing;406;4;410
32;Hauts-de-France;59;4;12;576;Spycker;1804;27;1831
32;Hauts-de-France;59;4;08;577;Staple;655;5;660
32;Hauts-de-France;59;4;21;578;Steenbecque;1674;30;1704
32;Hauts-de-France;59;4;12;579;Steene;1374;25;1399
32;Hauts-de-France;59;4;41;580;Steenvoorde;4388;85;4473
32;Hauts-de-France;59;4;08;581;Steenwerck;3669;54;3723
32;Hauts-de-France;59;4;08;582;Strazeele;938;23;961
32;Hauts-de-France;59;1;07;583;Taisnières-en-Thiérache;468;4;472
32;Hauts-de-France;59;1;05;584;Taisnières-sur-Hon;964;12;976
32;Hauts-de-France;59;5;18;585;Templemars;3401;34;3435
32;Hauts-de-France;59;5;36;586;Templeuve-en-Pévèle;6196;86;6282
32;Hauts-de-France;59;4;41;587;Terdeghem;527;14;541
32;Hauts-de-France;59;4;12;588;Téteghem-Coudekerque-Village;8311;221;8532
32;Hauts-de-France;59;6;06;589;Thiant;2998;25;3023
32;Hauts-de-France;59;4;21;590;Thiennes;905;14;919
32;Hauts-de-France;59;6;29;591;Thivencelle;842;3;845
32;Hauts-de-France;59;5;36;592;Thumeries;3893;32;3925
32;Hauts-de-France;59;2;09;593;Thun-l'Évêque;754;11;765
32;Hauts-de-France;59;6;34;594;Thun-Saint-Amand;1122;13;1135
32;Hauts-de-France;59;2;09;595;Thun-Saint-Martin;524;7;531
32;Hauts-de-France;59;2;09;597;Tilloy-lez-Cambrai;610;22;632
32;Hauts-de-France;59;3;35;596;Tilloy-lez-Marchiennes;516;17;533
32;Hauts-de-France;59;5;40;598;Toufflers;3909;28;3937
32;Hauts-de-France;59;5;99;599;Tourcoing;97442;684;98126
32;Hauts-de-France;59;5;36;600;Tourmignies;895;14;909
32;Hauts-de-France;59;1;19;601;Trélon;2798;66;2864
32;Hauts-de-France;59;5;36;602;Tressin;1409;31;1440
32;Hauts-de-France;59;6;06;603;Trith-Saint-Léger;6189;89;6278
32;Hauts-de-France;59;2;10;604;Troisvilles;832;7;839
32;Hauts-de-France;59;4;12;605;Uxem;1422;23;1445
32;Hauts-de-France;59;6;39;606;Valenciennes;43405;454;43859
32;Hauts-de-France;59;1;07;607;Vendegies-au-Bois;488;5;493
32;Hauts-de-France;59;2;11;608;Vendegies-sur-Écaillon;1087;20;1107
32;Hauts-de-France;59;5;18;609;Vendeville;1584;21;1605
32;Hauts-de-France;59;6;06;610;Verchain-Maugré;1056;9;1065
32;Hauts-de-France;59;5;22;611;Verlinghem;2475;55;2530
32;Hauts-de-France;59;2;11;612;Vertain;510;10;520
32;Hauts-de-France;59;6;29;613;Vicq;1478;14;1492
32;Hauts-de-France;59;2;11;614;Viesly;1460;20;1480
32;Hauts-de-France;59;4;08;615;Vieux-Berquin;2503;42;2545
32;Hauts-de-France;59;6;29;616;Vieux-Condé;10374;52;10426
32;Hauts-de-France;59;1;05;617;Vieux-Mesnil;636;7;643
32;Hauts-de-France;59;1;30;618;Vieux-Reng;863;6;869
32;Hauts-de-France;59;5;40;009;Villeneuve-d'Ascq;62727;661;63388
32;Hauts-de-France;59;1;05;619;Villereau;1021;14;1035
32;Hauts-de-France;59;3;01;620;Villers-au-Tertre;643;6;649
32;Hauts-de-France;59;2;11;622;Villers-en-Cauchies;1217;17;1234
32;Hauts-de-France;59;2;10;623;Villers-Guislain;697;4;701
32;Hauts-de-France;59;2;10;624;Villers-Outréaux;2129;26;2155
32;Hauts-de-France;59;2;10;625;Villers-Plouich;398;4;402
32;Hauts-de-France;59;1;07;626;Villers-Pol;1284;21;1305
32;Hauts-de-France;59;1;30;627;Villers-Sire-Nicole;993;11;1004
32;Hauts-de-France;59;4;41;628;Volckerinckhove;558;6;564
32;Hauts-de-France;59;3;35;629;Vred;1357;24;1381
32;Hauts-de-France;59;5;02;630;Wahagnies;2621;40;2661
32;Hauts-de-France;59;2;10;631;Walincourt-Selvigny;2148;30;2178
32;Hauts-de-France;59;6;34;632;Wallers;5568;39;5607
32;Hauts-de-France;59;1;19;633;Wallers-en-Fagne;284;7;291
32;Hauts-de-France;59;4;21;634;Wallon-Cappel;806;21;827
32;Hauts-de-France;59;2;10;635;Wambaix;369;6;375
32;Hauts-de-France;59;5;23;636;Wambrechies;10857;105;10962
32;Hauts-de-France;59;3;35;637;Wandignies-Hamage;1313;14;1327
32;Hauts-de-France;59;5;36;638;Wannehain;1306;14;1320
32;Hauts-de-France;59;1;05;639;Wargnies-le-Grand;1110;23;1133
32;Hauts-de-France;59;1;05;640;Wargnies-le-Petit;763;11;774
32;Hauts-de-France;59;4;41;641;Warhem;2020;43;2063
32;Hauts-de-France;59;3;35;642;Warlaing;580;17;597
32;Hauts-de-France;59;5;04;643;Warneton;239;2;241
32;Hauts-de-France;59;6;14;645;Wasnes-au-Bac;599;4;603
32;Hauts-de-France;59;5;13;646;Wasquehal;20485;229;20714
32;Hauts-de-France;59;4;41;647;Watten;2602;29;2631
32;Hauts-de-France;59;5;18;648;Wattignies;14736;189;14925
32;Hauts-de-France;59;1;19;649;Wattignies-la-Victoire;242;5;247
32;Hauts-de-France;59;5;33;650;Wattrelos;40885;175;41060
32;Hauts-de-France;59;6;14;651;Wavrechain-sous-Denain;1651;11;1662
32;Hauts-de-France;59;6;14;652;Wavrechain-sous-Faulx;399;1;400
32;Hauts-de-France;59;5;02;653;Wavrin;7723;63;7786
32;Hauts-de-France;59;3;35;654;Waziers;7427;69;7496
32;Hauts-de-France;59;4;41;655;Wemaers-Cappel;249;4;253
32;Hauts-de-France;59;5;22;656;Wervicq-Sud;5384;50;5434
32;Hauts-de-France;59;4;41;657;West-Cappel;639;7;646
32;Hauts-de-France;59;5;02;658;Wicres;522;7;529
32;Hauts-de-France;59;1;19;659;Wignehies;2877;33;2910
32;Hauts-de-France;59;5;40;660;Willems;2999;39;3038
32;Hauts-de-France;59;1;19;661;Willies;142;2;144
32;Hauts-de-France;59;4;41;662;Winnezeele;1307;23;1330
32;Hauts-de-France;59;4;41;663;Wormhout;5665;83;5748
32;Hauts-de-France;59;4;41;664;Wulverdinghe;311;4;315
32;Hauts-de-France;59;4;41;665;Wylder;294;6;300
32;Hauts-de-France;59;4;41;666;Zegerscappel;1533;25;1558
32;Hauts-de-France;59;4;41;667;Zermezeele;225;6;231
32;Hauts-de-France;59;4;17;668;Zuydcoote;1616;60;1676
32;Hauts-de-France;59;4;41;669;Zuytpeene;516;17;533
32;Hauts-de-France;60;1;11;001;Abancourt;635;8;643
32;Hauts-de-France;60;1;04;002;Abbecourt;797;24;821
32;Hauts-de-France;60;2;19;003;Abbeville-Saint-Lucien;496;13;509
32;Hauts-de-France;60;1;11;004;Achy;403;7;410
32;Hauts-de-France;60;4;15;005;Acy-en-Multien;859;13;872
32;Hauts-de-France;60;2;18;006;Les Ageux;1167;20;1187
32;Hauts-de-France;60;2;05;007;Agnetz;3047;109;3156
32;Hauts-de-France;60;2;19;008;Airion;383;163;546
32;Hauts-de-France;60;1;02;009;Allonne;1596;30;1626
32;Hauts-de-France;60;1;12;010;Amblainville;1748;17;1765
32;Hauts-de-France;60;3;21;011;Amy;399;5;404
32;Hauts-de-France;60;1;12;012;Andeville;3292;49;3341
32;Hauts-de-France;60;2;18;013;Angicourt;1401;29;1430
32;Hauts-de-France;60;2;19;014;Angivillers;178;5;183
32;Hauts-de-France;60;2;14;015;Angy;1161;14;1175
32;Hauts-de-France;60;2;14;016;Ansacq;275;8;283
32;Hauts-de-France;60;2;19;017;Ansauvillers;1191;25;1216
32;Hauts-de-France;60;3;10;019;Antheuil-Portes;412;12;424
32;Hauts-de-France;60;4;15;020;Antilly;258;9;267
32;Hauts-de-France;60;3;17;021;Appilly;544;8;552
32;Hauts-de-France;60;4;03;022;Apremont;654;16;670
32;Hauts-de-France;60;3;07;023;Armancourt;555;17;572
32;Hauts-de-France;60;3;10;024;Arsy;763;8;771
32;Hauts-de-France;60;3;06;025;Attichy;1894;40;1934
32;Hauts-de-France;60;1;19;026;Auchy-la-Montagne;590;13;603
32;Hauts-de-France;60;4;09;027;Auger-Saint-Vincent;529;13;542
32;Hauts-de-France;60;4;20;028;Aumont-en-Halatte;464;25;489
32;Hauts-de-France;60;1;02;029;Auneuil ;2864;60;2924
32;Hauts-de-France;60;1;02;030;Auteuil;544;9;553
32;Hauts-de-France;60;4;15;031;Autheuil-en-Valois;271;7;278
32;Hauts-de-France;60;3;06;032;Autrêches;721;14;735
32;Hauts-de-France;60;4;20;033;Avilly-Saint-Léonard;889;39;928
32;Hauts-de-France;60;2;19;034;Avrechy;1153;17;1170
32;Hauts-de-France;60;3;21;035;Avricourt;255;4;259
32;Hauts-de-France;60;2;10;036;Avrigny;379;6;385
32;Hauts-de-France;60;3;17;037;Babœuf;515;7;522
32;Hauts-de-France;60;2;19;039;Bacouël;489;6;495
32;Hauts-de-France;60;2;10;040;Bailleul-le-Soc;643;11;654
32;Hauts-de-France;60;1;14;041;Bailleul-sur-Thérain;2247;52;2299
32;Hauts-de-France;60;2;05;042;Bailleval;1468;45;1513
32;Hauts-de-France;60;3;21;043;Bailly;629;13;642
32;Hauts-de-France;60;4;13;044;Balagny-sur-Thérain;1693;24;1717
32;Hauts-de-France;60;4;18;045;Barbery;574;10;584
32;Hauts-de-France;60;4;15;046;Bargny;334;7;341
32;Hauts-de-France;60;4;15;047;Baron;764;16;780
32;Hauts-de-France;60;3;10;048;Baugy;253;5;258
32;Hauts-de-France;60;1;11;049;Bazancourt;121;3;124
32;Hauts-de-France;60;2;18;050;Bazicourt;345;9;354
32;Hauts-de-France;60;1;11;051;Beaudéduit;192;1;193
32;Hauts-de-France;60;3;17;052;Beaugies-sous-Bois;99;3;102
32;Hauts-de-France;60;3;21;053;Beaulieu-les-Fontaines;602;50;652
32;Hauts-de-France;60;3;17;055;Beaurains-lès-Noyon;338;5;343
32;Hauts-de-France;60;4;18;056;Beaurepaire;66;1;67
32;Hauts-de-France;60;1;98;057;Beauvais;56605;1406;58011
32;Hauts-de-France;60;2;19;058;Beauvoir;225;4;229
32;Hauts-de-France;60;3;17;059;Béhéricourt;207;6;213
32;Hauts-de-France;60;4;12;060;Belle-Église;608;10;618
32;Hauts-de-France;60;3;10;061;Belloy;89;6;95
32;Hauts-de-France;60;3;17;062;Berlancourt;325;4;329
32;Hauts-de-France;60;1;02;063;Berneuil-en-Bray;782;36;818
32;Hauts-de-France;60;3;06;064;Berneuil-sur-Aisne;1001;16;1017
32;Hauts-de-France;60;1;04;065;Berthecourt;1625;31;1656
32;Hauts-de-France;60;4;09;066;Béthancourt-en-Valois;209;10;219
32;Hauts-de-France;60;4;09;067;Béthisy-Saint-Martin;1020;20;1040
32;Hauts-de-France;60;4;09;068;Béthisy-Saint-Pierre;3063;40;3103
32;Hauts-de-France;60;4;15;069;Betz;1140;40;1180
32;Hauts-de-France;60;3;06;070;Bienville;448;10;458
32;Hauts-de-France;60;3;10;071;Biermont;174;5;179
32;Hauts-de-France;60;3;06;072;Bitry;316;12;328
32;Hauts-de-France;60;1;11;073;Blacourt;574;6;580
32;Hauts-de-France;60;4;13;074;Blaincourt-lès-Précy;1187;29;1216
32;Hauts-de-France;60;1;19;075;Blancfossé;145;1;146
32;Hauts-de-France;60;1;11;076;Blargies;527;7;534
32;Hauts-de-France;60;1;11;077;Blicourt;352;9;361
32;Hauts-de-France;60;2;10;078;Blincourt;101;2;103
32;Hauts-de-France;60;4;15;079;Boissy-Fresnoy;985;12;997
32;Hauts-de-France;60;1;14;081;Bonlier;475;9;484
32;Hauts-de-France;60;4;09;083;Bonneuil-en-Valois;1007;23;1030
32;Hauts-de-France;60;2;19;082;Bonneuil-les-Eaux;796;18;814
32;Hauts-de-France;60;1;11;084;Bonnières;178;1;179
32;Hauts-de-France;60;2;19;085;Bonvillers;202;2;204
32;Hauts-de-France;60;4;03;086;Boran-sur-Oise;2156;44;2200
32;Hauts-de-France;60;4;15;087;Borest;338;18;356
32;Hauts-de-France;60;1;12;088;Bornel ;4799;73;4872
32;Hauts-de-France;60;1;04;089;Boubiers;409;11;420
32;Hauts-de-France;60;1;04;090;Bouconvillers;385;7;392
32;Hauts-de-France;60;4;15;091;Bouillancy;395;6;401
32;Hauts-de-France;60;4;15;092;Boullarre;220;5;225
32;Hauts-de-France;60;3;10;093;Boulogne-la-Grasse;466;9;475
32;Hauts-de-France;60;4;15;094;Boursonne;311;6;317
32;Hauts-de-France;60;1;04;095;Boury-en-Vexin;342;7;349
32;Hauts-de-France;60;1;04;097;Boutencourt;213;6;219
32;Hauts-de-France;60;1;11;098;Bouvresse;156;1;157
32;Hauts-de-France;60;3;10;099;Braisnes-sur-Aronde;171;3;174
32;Hauts-de-France;60;4;18;100;Brasseuse;108;0;108
32;Hauts-de-France;60;4;15;101;Brégy;648;13;661
32;Hauts-de-France;60;2;18;102;Brenouille;2013;40;2053
32;Hauts-de-France;60;1;14;103;Bresles;4051;54;4105
32;Hauts-de-France;60;2;19;104;Breteuil;4244;115;4359
32;Hauts-de-France;60;3;17;105;Brétigny;416;8;424
32;Hauts-de-France;60;2;05;106;Breuil-le-Sec;2663;38;2701
32;Hauts-de-France;60;2;05;107;Breuil-le-Vert;3099;147;3246
32;Hauts-de-France;60;1;11;108;Briot;288;8;296
32;Hauts-de-France;60;1;11;109;Brombos;255;4;259
32;Hauts-de-France;60;1;11;110;Broquiers;245;0;245
32;Hauts-de-France;60;2;19;111;Broyes;162;2;164
32;Hauts-de-France;60;2;19;112;Brunvillers-la-Motte;347;1;348
32;Hauts-de-France;60;2;19;113;Bucamps;193;2;195
32;Hauts-de-France;60;1;11;114;Buicourt;146;0;146
32;Hauts-de-France;60;2;19;115;Bulles;883;16;899
32;Hauts-de-France;60;2;14;116;Bury;2966;38;3004
32;Hauts-de-France;60;3;17;117;Bussy;319;13;332
32;Hauts-de-France;60;3;17;118;Caisnes;504;9;513
32;Hauts-de-France;60;2;14;120;Cambronne-lès-Clermont;1167;23;1190
32;Hauts-de-France;60;3;21;119;Cambronne-lès-Ribécourt;1951;38;1989
32;Hauts-de-France;60;3;17;121;Campagne;157;4;161
32;Hauts-de-France;60;1;11;122;Campeaux;487;9;496
32;Hauts-de-France;60;2;19;123;Campremy;482;0;482
32;Hauts-de-France;60;3;21;124;Candor;304;7;311
32;Hauts-de-France;60;3;10;125;Canly;771;19;790
32;Hauts-de-France;60;3;21;126;Cannectancourt;506;6;512
32;Hauts-de-France;60;3;21;127;Canny-sur-Matz;396;3;399
32;Hauts-de-France;60;1;11;128;Canny-sur-Thérain;227;0;227
32;Hauts-de-France;60;3;17;129;Carlepont;1521;20;1541
32;Hauts-de-France;60;2;05;130;Catenoy;1039;23;1062
32;Hauts-de-France;60;1;19;131;Catheux;107;2;109
32;Hauts-de-France;60;3;17;132;Catigny;191;3;194
32;Hauts-de-France;60;2;19;133;Catillon-Fumechon;546;4;550
32;Hauts-de-France;60;2;16;134;Cauffry;2581;24;2605
32;Hauts-de-France;60;1;04;135;Cauvigny;1651;39;1690
32;Hauts-de-France;60;1;11;136;Cempuis;499;13;512
32;Hauts-de-France;60;2;10;137;Cernoy;296;3;299
32;Hauts-de-France;60;4;20;138;Chamant;910;28;938
32;Hauts-de-France;60;4;12;139;Chambly;10174;133;10307
32;Hauts-de-France;60;1;04;140;Chambors;314;4;318
32;Hauts-de-France;60;4;03;141;Chantilly;11001;229;11230
32;Hauts-de-France;60;4;20;142;La Chapelle-en-Serval;3140;90;3230
32;Hauts-de-France;60;1;04;143;Chaumont-en-Vexin;3305;42;3347
32;Hauts-de-France;60;1;04;144;Chavençon;175;3;178
32;Hauts-de-France;60;3;07;145;Chelles;490;13;503
32;Hauts-de-France;60;2;19;146;Chepoix;447;3;450
32;Hauts-de-France;60;3;21;147;Chevincourt;843;35;878
32;Hauts-de-France;60;4;15;148;Chèvreville;417;8;425
32;Hauts-de-France;60;3;10;149;Chevrières;2022;68;2090
32;Hauts-de-France;60;3;21;150;Chiry-Ourscamp;1209;17;1226
32;Hauts-de-France;60;3;06;151;Choisy-au-Bac;3283;104;3387
32;Hauts-de-France;60;2;10;152;Choisy-la-Victoire;241;1;242
32;Hauts-de-France;60;1;19;153;Choqueuse-les-Bénards;102;0;102
32;Hauts-de-France;60;2;18;154;Cinqueux;1572;58;1630
32;Hauts-de-France;60;4;13;155;Cires-lès-Mello;3986;50;4036
32;Hauts-de-France;60;3;06;156;Clairoix;2190;46;2236
32;Hauts-de-France;60;2;05;157;Clermont;10183;220;10403
32;Hauts-de-France;60;2;10;158;Coivrel;248;2;250
32;Hauts-de-France;60;3;99;159;Compiègne;40542;1025;41567
32;Hauts-de-France;60;3;10;160;Conchy-les-Pots;715;12;727
32;Hauts-de-France;60;1;19;161;Conteville;73;0;73
32;Hauts-de-France;60;1;04;162;Corbeil-Cerf;320;8;328
32;Hauts-de-France;60;1;19;163;Cormeilles;407;6;413
32;Hauts-de-France;60;1;04;209;Corne-en-Vexin;535;10;545
32;Hauts-de-France;60;1;11;164;Le Coudray-Saint-Germer;883;10;893
32;Hauts-de-France;60;1;04;165;Le Coudray-sur-Thelle;539;15;554
32;Hauts-de-France;60;3;10;166;Coudun;1067;32;1099
32;Hauts-de-France;60;3;06;167;Couloisy;568;14;582
32;Hauts-de-France;60;2;10;168;Courcelles-Epayelles;208;2;210
32;Hauts-de-France;60;1;04;169;Courcelles-lès-Gisors;815;21;836
32;Hauts-de-France;60;4;20;170;Courteuil;586;36;622
32;Hauts-de-France;60;3;06;171;Courtieux;182;3;185
32;Hauts-de-France;60;4;03;172;Coye-la-Forêt;3954;175;4129
32;Hauts-de-France;60;4;13;173;Cramoisy;809;12;821
32;Hauts-de-France;60;3;21;174;Crapeaumesnil;204;3;207
32;Hauts-de-France;60;4;08;175;Creil;35800;255;36055
32;Hauts-de-France;60;4;09;176;Crépy-en-Valois;14796;267;15063
32;Hauts-de-France;60;2;10;177;Cressonsacq;443;8;451
32;Hauts-de-France;60;1;19;178;Crèvecœur-le-Grand;3519;133;3652
32;Hauts-de-France;60;2;10;179;Crèvecœur-le-Petit;152;1;153
32;Hauts-de-France;60;1;11;180;Crillon;498;4;502
32;Hauts-de-France;60;3;17;181;Crisolles;918;20;938
32;Hauts-de-France;60;1;19;182;Le Crocq;180;4;184
32;Hauts-de-France;60;1;19;183;Croissy-sur-Celle;261;3;264
32;Hauts-de-France;60;3;07;184;Croutoy;207;10;217
32;Hauts-de-France;60;4;03;185;Crouy-en-Thelle;1106;10;1116
32;Hauts-de-France;60;2;19;186;Cuignières;246;4;250
32;Hauts-de-France;60;1;11;187;Cuigy-en-Bray;956;14;970
32;Hauts-de-France;60;3;07;188;Cuise-la-Motte;2196;106;2302
32;Hauts-de-France;60;3;17;189;Cuts;983;21;1004
32;Hauts-de-France;60;4;15;190;Cuvergnon;294;6;300
32;Hauts-de-France;60;3;10;191;Cuvilly;631;5;636
32;Hauts-de-France;60;3;21;192;Cuy;220;5;225
32;Hauts-de-France;60;1;11;193;Daméraucourt;216;2;218
32;Hauts-de-France;60;1;11;194;Dargies;250;2;252
32;Hauts-de-France;60;1;04;195;Delincourt;487;10;497
32;Hauts-de-France;60;4;12;197;Dieudonné;853;7;860
32;Hauts-de-France;60;3;21;198;Dives;400;6;406
32;Hauts-de-France;60;1;19;199;Doméliers;252;8;260
32;Hauts-de-France;60;2;10;200;Domfront;315;2;317
32;Hauts-de-France;60;2;10;201;Dompierre;241;3;244
32;Hauts-de-France;60;1;04;196;La Drenne;1009;16;1025
32;Hauts-de-France;60;4;09;203;Duvy;435;8;443
32;Hauts-de-France;60;3;21;204;Écuvilly;308;4;312
32;Hauts-de-France;60;1;11;205;Élencourt;52;1;53
32;Hauts-de-France;60;3;21;206;Élincourt-Sainte-Marguerite;856;14;870
32;Hauts-de-France;60;4;09;207;Éméville;288;6;294
32;Hauts-de-France;60;1;04;208;Énencourt-Léage;130;7;137
32;Hauts-de-France;60;2;10;210;Épineuse;252;9;261
32;Hauts-de-France;60;1;04;211;Éragny-sur-Epte;602;5;607
32;Hauts-de-France;60;4;12;212;Ercuis;1607;27;1634
32;Hauts-de-France;60;4;15;213;Ermenonville;1004;21;1025
32;Hauts-de-France;60;1;11;214;Ernemont-Boutavent;212;3;215
32;Hauts-de-France;60;2;05;215;Erquery;596;13;609
32;Hauts-de-France;60;2;19;216;Erquinvillers;184;2;186
32;Hauts-de-France;60;1;11;217;Escames;218;4;222
32;Hauts-de-France;60;1;12;218;Esches;1592;13;1605
32;Hauts-de-France;60;1;11;219;Escles-Saint-Pierre;166;2;168
32;Hauts-de-France;60;1;11;220;Espaubourg;506;5;511
32;Hauts-de-France;60;2;19;221;Esquennoy;714;7;721
32;Hauts-de-France;60;2;19;222;Essuiles;558;16;574
32;Hauts-de-France;60;3;10;223;Estrées-Saint-Denis;3749;54;3803
32;Hauts-de-France;60;4;15;224;Étavigny;151;1;152
32;Hauts-de-France;60;2;05;225;Étouy;771;41;812
32;Hauts-de-France;60;4;15;226;Ève;421;6;427
32;Hauts-de-France;60;3;21;227;Évricourt;225;2;227
32;Hauts-de-France;60;1;04;228;Fay-les-Étangs;470;8;478
32;Hauts-de-France;60;1;14;230;Le Fay-Saint-Quentin;523;14;537
32;Hauts-de-France;60;3;10;229;Le Fayel;223;4;227
32;Hauts-de-France;60;4;09;231;Feigneux;427;14;441
32;Hauts-de-France;60;2;10;232;Ferrières;473;3;476
32;Hauts-de-France;60;1;11;233;Feuquières;1377;20;1397
32;Hauts-de-France;60;2;05;234;Fitz-James;2562;28;2590
32;Hauts-de-France;60;1;02;235;Flavacourt;662;20;682
32;Hauts-de-France;60;3;17;236;Flavy-le-Meldeux;214;0;214
32;Hauts-de-France;60;2;19;237;Fléchy;92;1;93
32;Hauts-de-France;60;4;20;238;Fleurines;1929;89;2018
32;Hauts-de-France;60;1;04;239;Fleury;560;13;573
32;Hauts-de-France;60;1;19;240;Fontaine-Bonneleau;242;3;245
32;Hauts-de-France;60;4;15;241;Fontaine-Chaalis;342;15;357
32;Hauts-de-France;60;1;11;242;Fontaine-Lavaganne;509;7;516
32;Hauts-de-France;60;1;14;243;Fontaine-Saint-Lucien;172;6;178
32;Hauts-de-France;60;1;11;244;Fontenay-Torcy;131;1;132
32;Hauts-de-France;60;1;11;245;Formerie ;2120;28;2148
32;Hauts-de-France;60;2;05;247;Fouilleuse;141;2;143
32;Hauts-de-France;60;1;11;248;Fouilloy;207;6;213
32;Hauts-de-France;60;4;13;249;Foulangues;198;2;200
32;Hauts-de-France;60;1;01;250;Fouquenies;429;15;444
32;Hauts-de-France;60;1;14;251;Fouquerolles;282;5;287
32;Hauts-de-France;60;2;19;252;Fournival;525;3;528
32;Hauts-de-France;60;1;19;253;Francastel;484;8;492
32;Hauts-de-France;60;3;10;254;Francières;548;16;564
32;Hauts-de-France;60;3;17;255;Fréniches;343;3;346
32;Hauts-de-France;60;1;04;257;Fresne-Léguillon;438;10;448
32;Hauts-de-France;60;3;21;258;Fresnières;164;6;170
32;Hauts-de-France;60;4;12;259;Fresnoy-en-Thelle;901;23;924
32;Hauts-de-France;60;4;09;260;Fresnoy-la-Rivière;665;21;686
32;Hauts-de-France;60;4;15;261;Fresnoy-le-Luat;505;12;517
32;Hauts-de-France;60;2;10;262;Le Frestoy-Vaux;249;6;255
32;Hauts-de-France;60;3;17;263;Frétoy-le-Château;259;1;260
32;Hauts-de-France;60;1;02;264;Frocourt;519;15;534
32;Hauts-de-France;60;2;19;265;Froissy;897;12;909
32;Hauts-de-France;60;1;19;267;Le Gallet;175;5;180
32;Hauts-de-France;60;2;19;268;Gannes;341;1;342
32;Hauts-de-France;60;1;11;269;Gaudechart;347;5;352
32;Hauts-de-France;60;3;17;270;Genvry;330;85;415
32;Hauts-de-France;60;1;11;271;Gerberoy;88;2;90
32;Hauts-de-France;60;4;09;272;Gilocourt;642;19;661
32;Hauts-de-France;60;3;10;273;Giraumont;539;19;558
32;Hauts-de-France;60;4;09;274;Glaignes;376;13;389
32;Hauts-de-France;60;1;11;275;Glatigny;226;0;226
32;Hauts-de-France;60;2;10;276;Godenvillers;221;2;223
32;Hauts-de-France;60;1;02;277;Goincourt;1467;37;1504
32;Hauts-de-France;60;3;17;278;Golancourt;398;3;401
32;Hauts-de-France;60;4;15;279;Gondreville;203;5;208
32;Hauts-de-France;60;1;11;280;Gourchelles;115;0;115
32;Hauts-de-France;60;3;10;281;Gournay-sur-Aronde;562;14;576
32;Hauts-de-France;60;4;03;282;Gouvieux;9023;393;9416
32;Hauts-de-France;60;2;19;283;Gouy-les-Groseillers;26;0;26
32;Hauts-de-France;60;3;10;284;Grandfresnoy;1783;59;1842
32;Hauts-de-France;60;3;17;287;Grandrû;352;4;356
32;Hauts-de-France;60;2;10;285;Grandvillers-aux-Bois;309;15;324
32;Hauts-de-France;60;1;11;286;Grandvilliers;2880;81;2961
32;Hauts-de-France;60;1;11;288;Grémévillers;466;5;471
32;Hauts-de-France;60;1;11;289;Grez;267;4;271
32;Hauts-de-France;60;1;14;290;Guignecourt;381;4;385
32;Hauts-de-France;60;3;17;291;Guiscard;1804;24;1828
32;Hauts-de-France;60;3;21;292;Gury;240;7;247
32;Hauts-de-France;60;1;04;293;Hadancourt-le-Haut-Clocher;375;8;383
32;Hauts-de-France;60;3;10;294;Hainvillers;82;1;83
32;Hauts-de-France;60;1;11;295;Halloy;451;9;460
32;Hauts-de-France;60;1;11;297;Le Hamel;187;2;189
32;Hauts-de-France;60;1;11;296;Hannaches;140;1;141
32;Hauts-de-France;60;1;11;298;Hanvoile;650;7;657
32;Hauts-de-France;60;2;19;299;Hardivillers;540;8;548
32;Hauts-de-France;60;1;11;301;Haucourt;139;5;144
32;Hauts-de-France;60;1;14;302;Haudivillers;801;23;824
32;Hauts-de-France;60;1;11;303;Hautbos;195;1;196
32;Hauts-de-France;60;1;11;304;Haute-Épine;274;9;283
32;Hauts-de-France;60;3;07;305;Hautefontaine;336;4;340
32;Hauts-de-France;60;1;04;054;Hauts-Talican ;872;21;893
32;Hauts-de-France;60;1;11;306;Hécourt;153;3;156
32;Hauts-de-France;60;2;14;307;Heilles;624;10;634
32;Hauts-de-France;60;3;10;308;Hémévillers;460;9;469
32;Hauts-de-France;60;1;04;309;Hénonville;850;21;871
32;Hauts-de-France;60;1;01;310;Herchies;634;27;661
32;Hauts-de-France;60;2;19;311;La Hérelle;241;2;243
32;Hauts-de-France;60;1;11;312;Héricourt-sur-Thérain;121;2;123
32;Hauts-de-France;60;1;14;313;Hermes;2504;41;2545
32;Hauts-de-France;60;1;11;314;Hétomesnil;316;5;321
32;Hauts-de-France;60;1;11;315;Hodenc-en-Bray;493;10;503
32;Hauts-de-France;60;1;04;316;Hodenc-l'Évêque;245;7;252
32;Hauts-de-France;60;2;14;317;Hondainville;718;8;726
32;Hauts-de-France;60;3;10;318;Houdancourt;668;13;681
32;Hauts-de-France;60;1;02;319;La Houssoye;610;6;616
32;Hauts-de-France;60;4;15;320;Ivors;255;3;258
32;Hauts-de-France;60;1;04;321;Ivry-le-Temple;804;7;811
32;Hauts-de-France;60;1;04;322;Jaméricourt;321;5;326
32;Hauts-de-France;60;3;06;323;Janville;675;11;686
32;Hauts-de-France;60;3;06;324;Jaulzy;890;11;901
32;Hauts-de-France;60;3;07;325;Jaux;2356;66;2422
32;Hauts-de-France;60;3;07;326;Jonquières;605;22;627
32;Hauts-de-France;60;1;04;327;Jouy-sous-Thelle;1036;16;1052
32;Hauts-de-France;60;1;14;328;Juvignies;315;9;324
32;Hauts-de-France;60;3;21;329;Laberlière;200;6;206
32;Hauts-de-France;60;1;04;330;Laboissière-en-Thelle;1347;26;1373
32;Hauts-de-France;60;1;02;331;Labosse;443;6;449
32;Hauts-de-France;60;2;05;332;Labruyère;700;9;709
32;Hauts-de-France;60;1;02;333;Lachapelle-aux-Pots;1668;37;1705
32;Hauts-de-France;60;1;04;334;Lachapelle-Saint-Pierre;893;15;908
32;Hauts-de-France;60;1;11;335;Lachapelle-sous-Gerberoy;148;1;149
32;Hauts-de-France;60;1;19;336;Lachaussée-du-Bois-d'Écu;195;3;198
32;Hauts-de-France;60;3;07;337;Lachelle;692;27;719
32;Hauts-de-France;60;3;07;338;Lacroix-Saint-Ouen;4894;163;5057
32;Hauts-de-France;60;1;14;339;Lafraye;367;9;376
32;Hauts-de-France;60;3;21;340;Lagny;529;18;547
32;Hauts-de-France;60;4;15;341;Lagny-le-Sec;2056;55;2111
32;Hauts-de-France;60;2;16;342;Laigneville;4712;51;4763
32;Hauts-de-France;60;1;02;343;Lalande-en-Son;640;23;663
32;Hauts-de-France;60;1;02;344;Lalandelle;490;9;499
32;Hauts-de-France;60;2;05;345;Lamécourt;191;2;193
32;Hauts-de-France;60;4;03;346;Lamorlaye;8823;231;9054
32;Hauts-de-France;60;1;11;347;Lannoy-Cuillère;283;5;288
32;Hauts-de-France;60;3;17;348;Larbroye;514;9;523
32;Hauts-de-France;60;3;21;350;Lassigny;1384;24;1408
32;Hauts-de-France;60;3;10;351;Lataule;118;2;120
32;Hauts-de-France;60;1;04;352;Lattainville;157;2;159
32;Hauts-de-France;60;1;11;353;Lavacquerie;201;1;202
32;Hauts-de-France;60;1;11;354;Laverrière;36;1;37
32;Hauts-de-France;60;1;14;355;Laversines;1175;51;1226
32;Hauts-de-France;60;1;04;356;Lavilletertre;550;16;566
32;Hauts-de-France;60;2;10;357;Léglantiers;551;7;558
32;Hauts-de-France;60;4;15;358;Lévignen;1001;26;1027
32;Hauts-de-France;60;1;11;359;Lhéraule;192;3;195
32;Hauts-de-France;60;2;05;360;Liancourt;6951;63;7014
32;Hauts-de-France;60;1;04;361;Liancourt-Saint-Pierre;599;20;619
32;Hauts-de-France;60;3;17;362;Libermont;180;6;186
32;Hauts-de-France;60;1;04;363;Lierville;219;1;220
32;Hauts-de-France;60;2;19;364;Lieuvillers;706;8;714
32;Hauts-de-France;60;1;11;365;Lihus;416;5;421
32;Hauts-de-France;60;2;14;366;Litz;360;5;365
32;Hauts-de-France;60;1;04;367;Loconville;335;8;343
32;Hauts-de-France;60;3;21;368;Longueil-Annel;2624;59;2683
32;Hauts-de-France;60;3;10;369;Longueil-Sainte-Marie;1923;35;1958
32;Hauts-de-France;60;1;12;370;Lormaison;1310;14;1324
32;Hauts-de-France;60;1;11;371;Loueuse;151;1;152
32;Hauts-de-France;60;1;19;372;Luchy;648;16;664
32;Hauts-de-France;60;3;21;373;Machemont;749;18;767
32;Hauts-de-France;60;2;10;374;Maignelay-Montigny;2685;31;2716
32;Hauts-de-France;60;2;05;375;Maimbeville;406;10;416
32;Hauts-de-France;60;1;14;376;Maisoncelle-Saint-Pierre;164;1;165
32;Hauts-de-France;60;2;19;377;Maisoncelle-Tuilerie;295;8;303
32;Hauts-de-France;60;1;02;703;Aux Marais;860;17;877
32;Hauts-de-France;60;3;21;378;Marest-sur-Matz;402;5;407
32;Hauts-de-France;60;3;21;379;Mareuil-la-Motte;627;15;642
32;Hauts-de-France;60;4;15;380;Mareuil-sur-Ourcq;1611;24;1635
32;Hauts-de-France;60;3;21;381;Margny-aux-Cerises;259;3;262
32;Hauts-de-France;60;3;06;382;Margny-lès-Compiègne;8521;174;8695
32;Hauts-de-France;60;3;10;383;Margny-sur-Matz;537;12;549
32;Hauts-de-France;60;4;15;385;Marolles;675;13;688
32;Hauts-de-France;60;3;10;386;Marquéglise;478;8;486
32;Hauts-de-France;60;1;11;387;Marseille-en-Beauvaisis;1476;10;1486
32;Hauts-de-France;60;1;11;388;Martincourt;130;6;136
32;Hauts-de-France;60;3;17;389;Maucourt;246;2;248
32;Hauts-de-France;60;1;19;390;Maulers;322;6;328
32;Hauts-de-France;60;4;13;391;Maysel;239;3;242
32;Hauts-de-France;60;3;21;392;Mélicocq;756;17;773
32;Hauts-de-France;60;4;13;393;Mello;626;13;639
32;Hauts-de-France;60;2;10;394;Ménévillers;103;1;104
32;Hauts-de-France;60;1;12;395;Méru;14609;185;14794
32;Hauts-de-France;60;2;10;396;Méry-la-Bataille;628;5;633
32;Hauts-de-France;60;1;11;397;Le Mesnil-Conteville;80;1;81
32;Hauts-de-France;60;4;03;398;Le Mesnil-en-Thelle;2217;30;2247
32;Hauts-de-France;60;2;19;399;Le Mesnil-Saint-Firmin;227;35;262
32;Hauts-de-France;60;2;19;400;Le Mesnil-sur-Bulles;268;7;275
32;Hauts-de-France;60;1;04;401;Le Mesnil-Théribus;789;44;833
32;Hauts-de-France;60;3;07;402;Le Meux;2285;61;2346
32;Hauts-de-France;60;1;01;403;Milly-sur-Thérain;1756;30;1786
32;Hauts-de-France;60;2;16;404;Mogneville;1494;37;1531
32;Hauts-de-France;60;1;11;405;Moliens;1151;16;1167
32;Hauts-de-France;60;2;18;406;Monceaux;838;16;854
32;Hauts-de-France;60;1;11;407;Monceaux-l'Abbaye;222;2;224
32;Hauts-de-France;60;3;10;408;Monchy-Humières;776;13;789
32;Hauts-de-France;60;2;16;409;Monchy-Saint-Éloi;2197;39;2236
32;Hauts-de-France;60;3;17;410;Mondescourt;245;8;253
32;Hauts-de-France;60;1;04;411;Monneville;820;12;832
32;Hauts-de-France;60;4;20;421;Mont-l'Évêque;391;7;398
32;Hauts-de-France;60;1;01;428;Le Mont-Saint-Adrien;645;27;672
32;Hauts-de-France;60;1;04;412;Montagny-en-Vexin;673;12;685
32;Hauts-de-France;60;4;15;413;Montagny-Sainte-Félicité;415;9;424
32;Hauts-de-France;60;4;13;414;Montataire;13461;163;13624
32;Hauts-de-France;60;1;04;256;Montchevreuil ;1301;26;1327
32;Hauts-de-France;60;4;18;415;Montépilloy;140;9;149
32;Hauts-de-France;60;2;10;416;Montgérain;179;2;181
32;Hauts-de-France;60;2;10;418;Montiers;418;13;431
32;Hauts-de-France;60;1;04;420;Montjavoult;481;11;492
32;Hauts-de-France;60;4;15;422;Montlognon;199;11;210
32;Hauts-de-France;60;3;21;423;Montmacq;1104;25;1129
32;Hauts-de-France;60;3;10;424;Montmartin;264;4;268
32;Hauts-de-France;60;2;19;425;Montreuil-sur-Brêche;483;16;499
32;Hauts-de-France;60;1;04;426;Montreuil-sur-Thérain;243;2;245
32;Hauts-de-France;60;1;04;427;Monts;172;1;173
32;Hauts-de-France;60;4;03;429;Morangles;378;14;392
32;Hauts-de-France;60;4;09;430;Morienval;1083;13;1096
32;Hauts-de-France;60;3;17;431;Morlincourt;540;11;551
32;Hauts-de-France;60;4;20;432;Mortefontaine;863;29;892
32;Hauts-de-France;60;1;04;433;Mortefontaine-en-Thelle;925;19;944
32;Hauts-de-France;60;3;10;434;Mortemer;223;6;229
32;Hauts-de-France;60;1;11;435;Morvillers;483;4;487
32;Hauts-de-France;60;2;19;436;Mory-Montcrux;79;2;81
32;Hauts-de-France;60;1;04;437;Mouchy-le-Châtel;82;0;82
32;Hauts-de-France;60;3;06;438;Moulin-sous-Touvent;205;5;210
32;Hauts-de-France;60;2;14;439;Mouy;5255;74;5329
32;Hauts-de-France;60;2;10;440;Moyenneville;620;17;637
32;Hauts-de-France;60;3;10;441;Moyvillers;685;7;692
32;Hauts-de-France;60;1;19;442;Muidorge;141;2;143
32;Hauts-de-France;60;3;17;443;Muirancourt;576;4;580
32;Hauts-de-France;60;1;11;444;Mureaumont;156;5;161
32;Hauts-de-France;60;3;06;445;Nampcel;317;3;320
32;Hauts-de-France;60;4;15;446;Nanteuil-le-Haudouin;4249;61;4310
32;Hauts-de-France;60;4;09;447;Néry;658;14;672
32;Hauts-de-France;60;4;15;448;Neufchelles;383;6;389
32;Hauts-de-France;60;3;10;449;Neufvy-sur-Aronde;279;4;283
32;Hauts-de-France;60;4;12;450;Neuilly-en-Thelle;3818;43;3861
32;Hauts-de-France;60;2;14;451;Neuilly-sous-Clermont;1659;28;1687
32;Hauts-de-France;60;1;04;452;Neuville-Bosc;497;14;511
32;Hauts-de-France;60;2;14;454;La Neuville-en-Hez;961;31;992
32;Hauts-de-France;60;2;10;456;La Neuville-Roy;940;29;969
32;Hauts-de-France;60;2;19;457;La Neuville-Saint-Pierre;156;2;158
32;Hauts-de-France;60;1;11;458;La Neuville-sur-Oudeuil;321;15;336
32;Hauts-de-France;60;3;10;459;La Neuville-sur-Ressons;208;3;211
32;Hauts-de-France;60;1;11;460;La Neuville-Vault;199;8;207
32;Hauts-de-France;60;1;14;461;Nivillers;188;24;212
32;Hauts-de-France;60;1;04;462;Noailles;2814;44;2858
32;Hauts-de-France;60;4;16;463;Nogent-sur-Oise;20298;362;20660
32;Hauts-de-France;60;2;05;464;Nointel;1061;16;1077
32;Hauts-de-France;60;2;19;465;Noirémont;181;6;187
32;Hauts-de-France;60;2;19;466;Noroy;245;3;248
32;Hauts-de-France;60;2;19;468;Nourard-le-Franc;325;4;329
32;Hauts-de-France;60;1;04;469;Novillers;366;9;375
32;Hauts-de-France;60;2;19;470;Noyers-Saint-Martin;869;14;883
32;Hauts-de-France;60;3;17;471;Noyon;13235;261;13496
32;Hauts-de-France;60;1;11;472;Offoy;116;1;117
32;Hauts-de-France;60;4;15;473;Ognes;294;1;295
32;Hauts-de-France;60;3;21;474;Ognolles;285;5;290
32;Hauts-de-France;60;1;11;476;Omécourt;197;8;205
32;Hauts-de-France;60;1;02;477;Ons-en-Bray;1398;23;1421
32;Hauts-de-France;60;4;15;478;Ormoy-le-Davien;349;9;358
32;Hauts-de-France;60;4;15;479;Ormoy-Villers;660;10;670
32;Hauts-de-France;60;1;14;480;Oroër;556;17;573
32;Hauts-de-France;60;4;09;481;Orrouy;600;13;613
32;Hauts-de-France;60;4;20;482;Orry-la-Ville;3337;88;3425
32;Hauts-de-France;60;3;10;483;Orvillers-Sorel;521;59;580
32;Hauts-de-France;60;1;11;484;Oudeuil;270;6;276
32;Hauts-de-France;60;2;19;485;Oursel-Maison;240;5;245
32;Hauts-de-France;60;2;19;486;Paillart;578;10;588
32;Hauts-de-France;60;1;04;487;Parnes;336;15;351
32;Hauts-de-France;60;3;17;488;Passel;278;6;284
32;Hauts-de-France;60;4;15;489;Péroy-les-Gombries;1150;14;1164
32;Hauts-de-France;60;1;01;490;Pierrefitte-en-Beauvaisis;372;14;386
32;Hauts-de-France;60;3;07;491;Pierrefonds;1839;210;2049
32;Hauts-de-France;60;3;21;492;Pimprez;860;19;879
32;Hauts-de-France;60;1;11;493;Pisseleu;503;11;514
32;Hauts-de-France;60;4;20;494;Plailly;1872;41;1913
32;Hauts-de-France;60;2;19;495;Plainval;404;5;409
32;Hauts-de-France;60;2;19;496;Plainville;162;1;163
32;Hauts-de-France;60;2;19;497;Le Plessier-sur-Bulles;213;0;213
32;Hauts-de-France;60;2;19;498;Le Plessier-sur-Saint-Just;521;3;524
32;Hauts-de-France;60;4;15;500;Le Plessis-Belleville;3620;52;3672
32;Hauts-de-France;60;3;21;501;Le Plessis-Brion;1359;31;1390
32;Hauts-de-France;60;3;21;499;Plessis-de-Roye;232;5;237
32;Hauts-de-France;60;3;17;502;Le Plessis-Patte-d'Oie;99;4;103
32;Hauts-de-France;60;2;10;503;Le Ployron;113;3;116
32;Hauts-de-France;60;1;04;504;Ponchon;1119;16;1135
32;Hauts-de-France;60;3;17;506;Pont-l'Évêque;677;12;689
32;Hauts-de-France;60;4;18;509;Pont-Sainte-Maxence;12601;123;12724
32;Hauts-de-France;60;4;20;505;Pontarmé;833;21;854
32;Hauts-de-France;60;3;17;507;Pontoise-lès-Noyon;454;10;464
32;Hauts-de-France;60;4;18;508;Pontpoint;3250;74;3324
32;Hauts-de-France;60;1;02;510;Porcheux;627;15;642
32;Hauts-de-France;60;3;17;511;Porquéricourt;396;12;408
32;Hauts-de-France;60;1;04;512;Pouilly;160;2;162
32;Hauts-de-France;60;4;13;513;Précy-sur-Oise;3212;70;3282
32;Hauts-de-France;60;1;11;514;Prévillers;237;1;238
32;Hauts-de-France;60;2;10;515;Pronleroy;379;12;391
32;Hauts-de-France;60;1;11;516;Puiseux-en-Bray;415;3;418
32;Hauts-de-France;60;4;12;517;Puiseux-le-Hauberger;857;12;869
32;Hauts-de-France;60;2;19;518;Puits-la-Vallée;205;4;209
32;Hauts-de-France;60;3;17;519;Quesmy;179;5;184
32;Hauts-de-France;60;2;19;520;Le Quesnel-Aubry;219;8;227
32;Hauts-de-France;60;1;11;521;Quincampoix-Fleuzy;398;16;414
32;Hauts-de-France;60;2;19;522;Quinquempoix;320;3;323
32;Hauts-de-France;60;1;02;523;Rainvillers;927;25;952
32;Hauts-de-France;60;2;05;524;Rantigny;2526;23;2549
32;Hauts-de-France;60;4;18;525;Raray;135;5;140
32;Hauts-de-France;60;2;19;526;Ravenel;1081;13;1094
32;Hauts-de-France;60;4;15;527;Réez-Fosse-Martin;147;1;148
32;Hauts-de-France;60;1;04;528;Reilly;128;2;130
32;Hauts-de-France;60;2;05;529;Rémécourt;78;0;78
32;Hauts-de-France;60;2;14;530;Rémérangles;217;9;226
32;Hauts-de-France;60;3;10;531;Remy;1881;38;1919
32;Hauts-de-France;60;3;10;533;Ressons-sur-Matz;1692;28;1720
32;Hauts-de-France;60;3;06;534;Rethondes;644;24;668
32;Hauts-de-France;60;2;19;535;Reuil-sur-Brêche;327;6;333
32;Hauts-de-France;60;4;18;536;Rhuis;138;8;146
32;Hauts-de-France;60;3;21;537;Ribécourt-Dreslincourt;3724;174;3898
32;Hauts-de-France;60;3;10;538;Ricquebourg;296;4;300
32;Hauts-de-France;60;2;18;539;Rieux;1556;21;1577
32;Hauts-de-France;60;3;10;540;Rivecourt;610;15;625
32;Hauts-de-France;60;4;18;541;Roberval;363;12;375
32;Hauts-de-France;60;1;14;542;Rochy-Condé;988;16;1004
32;Hauts-de-France;60;4;09;543;Rocquemont;120;1;121
32;Hauts-de-France;60;2;19;544;Rocquencourt;196;1;197
32;Hauts-de-France;60;1;11;545;Romescamps;534;8;542
32;Hauts-de-France;60;4;15;546;Rosières;138;4;142
32;Hauts-de-France;60;2;05;547;Rosoy;629;17;646
32;Hauts-de-France;60;4;15;548;Rosoy-en-Multien;603;7;610
32;Hauts-de-France;60;1;19;549;Rotangy;216;5;221
32;Hauts-de-France;60;1;11;550;Rothois;225;0;225
32;Hauts-de-France;60;2;13;551;Rousseloy;307;7;314
32;Hauts-de-France;60;4;15;552;Rouville;250;9;259
32;Hauts-de-France;60;2;10;553;Rouvillers;274;7;281
32;Hauts-de-France;60;4;15;554;Rouvres-en-Multien;469;9;478
32;Hauts-de-France;60;2;19;555;Rouvroy-les-Merles;54;0;54
32;Hauts-de-France;60;1;11;557;Roy-Boissy;313;6;319
32;Hauts-de-France;60;2;10;556;Royaucourt;206;3;209
32;Hauts-de-France;60;3;21;558;Roye-sur-Matz;463;18;481
32;Hauts-de-France;60;2;14;559;La Rue-Saint-Pierre;819;9;828
32;Hauts-de-France;60;4;18;560;Rully;723;33;756
32;Hauts-de-France;60;4;09;561;Russy-Bémont;196;6;202
32;Hauts-de-France;60;2;18;562;Sacy-le-Grand;1549;26;1575
32;Hauts-de-France;60;2;18;563;Sacy-le-Petit;574;6;580
32;Hauts-de-France;60;2;10;564;Sains-Morainvillers;277;3;280
32;Hauts-de-France;60;2;19;565;Saint-André-Farivillers;516;4;520
32;Hauts-de-France;60;1;11;566;Saint-Arnoult;211;3;214
32;Hauts-de-France;60;1;02;567;Saint-Aubin-en-Bray;1153;29;1182
32;Hauts-de-France;60;2;05;568;Saint-Aubin-sous-Erquery;332;8;340
32;Hauts-de-France;60;3;06;569;Saint-Crépin-aux-Bois;202;10;212
32;Hauts-de-France;60;1;04;570;Saint-Crépin-Ibouvillers;1548;24;1572
32;Hauts-de-France;60;1;11;571;Saint-Deniscourt;84;3;87
32;Hauts-de-France;60;3;07;572;Saint-Étienne-Roilaye;302;9;311
32;Hauts-de-France;60;2;14;574;Saint-Félix;626;16;642
32;Hauts-de-France;60;1;01;576;Saint-Germain-la-Poterie;483;14;497
32;Hauts-de-France;60;1;11;577;Saint-Germer-de-Fly;1713;35;1748
32;Hauts-de-France;60;3;07;579;Saint-Jean-aux-Bois;315;7;322
32;Hauts-de-France;60;2;19;581;Saint-Just-en-Chaussée;6033;46;6079
32;Hauts-de-France;60;3;21;582;Saint-Léger-aux-Bois;783;20;803
32;Hauts-de-France;60;1;02;583;Saint-Léger-en-Bray;348;9;357
32;Hauts-de-France;60;4;13;584;Saint-Leu-d'Esserent;4692;98;4790
32;Hauts-de-France;60;2;10;585;Saint-Martin-aux-Bois;285;5;290
32;Hauts-de-France;60;1;02;586;Saint-Martin-le-Nœud;1039;22;1061
32;Hauts-de-France;60;2;18;587;Saint-Martin-Longueau;1478;28;1506
32;Hauts-de-France;60;1;11;588;Saint-Maur;379;6;385
32;Hauts-de-France;60;4;03;589;Saint-Maximin;2872;115;2987
32;Hauts-de-France;60;1;11;590;Saint-Omer-en-Chaussée;1240;24;1264
32;Hauts-de-France;60;1;02;591;Saint-Paul;1562;63;1625
32;Hauts-de-France;60;1;11;592;Saint-Pierre-es-Champs;710;8;718
32;Hauts-de-France;60;3;06;593;Saint-Pierre-lès-Bitry;143;2;145
32;Hauts-de-France;60;1;11;594;Saint-Quentin-des-Prés;282;6;288
32;Hauts-de-France;60;2;19;595;Saint-Remy-en-l'Eau;428;3;431
32;Hauts-de-France;60;1;11;596;Saint-Samson-la-Poterie;248;2;250
32;Hauts-de-France;60;3;07;597;Saint-Sauveur;1728;32;1760
32;Hauts-de-France;60;1;04;598;Saint-Sulpice;1032;86;1118
32;Hauts-de-France;60;1;11;599;Saint-Thibault;292;5;297
32;Hauts-de-France;60;4;09;600;Saint-Vaast-de-Longmont;643;7;650
32;Hauts-de-France;60;4;13;601;Saint-Vaast-lès-Mello;1045;16;1061
32;Hauts-de-France;60;1;11;602;Saint-Valery;62;7;69
32;Hauts-de-France;60;2;19;573;Sainte-Eusoye;329;2;331
32;Hauts-de-France;60;1;04;575;Sainte-Geneviève;3301;44;3345
32;Hauts-de-France;60;4;09;578;Saintines;1069;17;1086
32;Hauts-de-France;60;3;17;603;Salency;893;22;915
32;Hauts-de-France;60;1;11;604;Sarcus;266;2;268
32;Hauts-de-France;60;1;11;605;Sarnois;348;6;354
32;Hauts-de-France;60;1;19;608;Le Saulchoy;102;1;103
32;Hauts-de-France;60;1;01;609;Savignies;865;23;888
32;Hauts-de-France;60;3;17;610;Sempigny;779;13;792
32;Hauts-de-France;60;1;11;611;Senantes;606;14;620
32;Hauts-de-France;60;4;20;612;Senlis;14891;633;15524
32;Hauts-de-France;60;1;04;613;Senots;346;7;353
32;Hauts-de-France;60;1;04;614;Serans;214;7;221
32;Hauts-de-France;60;2;19;615;Sérévillers;135;1;136
32;Hauts-de-France;60;1;02;616;Sérifontaine;2742;33;2775
32;Hauts-de-France;60;3;17;617;Sermaize;267;4;271
32;Hauts-de-France;60;4;09;618;Séry-Magneval;281;10;291
32;Hauts-de-France;60;4;15;619;Silly-le-Long;1163;26;1189
32;Hauts-de-France;60;1;04;620;Silly-Tillard;445;9;454
32;Hauts-de-France;60;3;21;621;Solente;141;1;142
32;Hauts-de-France;60;1;11;622;Sommereux;482;5;487
32;Hauts-de-France;60;1;11;623;Songeons;1013;78;1091
32;Hauts-de-France;60;1;11;624;Sully;171;4;175
32;Hauts-de-France;60;3;17;625;Suzoy;567;12;579
32;Hauts-de-France;60;1;11;626;Talmontiers;676;18;694
32;Hauts-de-France;60;2;19;627;Tartigny;266;3;269
32;Hauts-de-France;60;1;14;628;Therdonne;1065;22;1087
32;Hauts-de-France;60;1;11;629;Thérines;198;9;207
32;Hauts-de-France;60;1;04;630;Thibivillers;175;3;178
32;Hauts-de-France;60;4;20;631;Thiers-sur-Thève;1070;23;1093
32;Hauts-de-France;60;3;21;632;Thiescourt;755;16;771
32;Hauts-de-France;60;1;11;633;Thieuloy-Saint-Antoine;414;2;416
32;Hauts-de-France;60;2;19;634;Thieux;437;11;448
32;Hauts-de-France;60;4;13;635;Thiverny;1073;10;1083
32;Hauts-de-France;60;3;21;636;Thourotte;4531;73;4604
32;Hauts-de-France;60;4;15;637;Thury-en-Valois;504;5;509
32;Hauts-de-France;60;2;14;638;Thury-sous-Clermont;674;9;683
32;Hauts-de-France;60;1;14;639;Tillé;1201;23;1224
32;Hauts-de-France;60;1;04;640;Tourly;173;1;174
32;Hauts-de-France;60;3;06;641;Tracy-le-Mont;1730;49;1779
32;Hauts-de-France;60;3;21;642;Tracy-le-Val;1082;32;1114
32;Hauts-de-France;60;2;10;643;Tricot;1381;14;1395
32;Hauts-de-France;60;1;04;644;Trie-Château ;1934;31;1965
32;Hauts-de-France;60;1;04;645;Trie-la-Ville;307;5;312
32;Hauts-de-France;60;1;14;646;Troissereux;1268;31;1299
32;Hauts-de-France;60;3;06;647;Trosly-Breuil;2072;54;2126
32;Hauts-de-France;60;2;19;648;Troussencourt;328;4;332
32;Hauts-de-France;60;4;09;650;Trumilly;535;25;560
32;Hauts-de-France;60;4;13;651;Ully-Saint-Georges;1879;31;1910
32;Hauts-de-France;60;1;04;652;Valdampierre;930;10;940
32;Hauts-de-France;60;2;19;653;Valescourt;295;2;297
32;Hauts-de-France;60;3;21;654;Vandélicourt;272;5;277
32;Hauts-de-France;60;3;17;655;Varesnes;366;10;376
32;Hauts-de-France;60;4;15;656;Varinfroy;287;3;290
32;Hauts-de-France;60;3;17;657;Vauchelles;258;5;263
32;Hauts-de-France;60;4;09;658;Vauciennes;690;10;700
32;Hauts-de-France;60;1;04;659;Vaudancourt;170;2;172
32;Hauts-de-France;60;1;02;660;Le Vaumain;388;11;399
32;Hauts-de-France;60;4;09;661;Vaumoise;986;83;1069
32;Hauts-de-France;60;1;02;662;Le Vauroux;502;13;515
32;Hauts-de-France;60;1;14;663;Velennes;242;3;245
32;Hauts-de-France;60;2;19;664;Vendeuil-Caply;461;11;472
32;Hauts-de-France;60;3;07;665;Venette;2876;62;2938
32;Hauts-de-France;60;4;15;666;Ver-sur-Launette;1147;26;1173
32;Hauts-de-France;60;4;09;667;Verberie;3823;53;3876
32;Hauts-de-France;60;1;14;668;Verderel-lès-Sauqueuse;738;24;762
32;Hauts-de-France;60;2;05;669;Verderonne;487;13;500
32;Hauts-de-France;60;4;08;670;Verneuil-en-Halatte;4677;115;4792
32;Hauts-de-France;60;4;15;671;Versigny;370;20;390
32;Hauts-de-France;60;4;09;672;Vez;277;13;290
32;Hauts-de-France;60;1;19;673;Viefvillers;203;1;204
32;Hauts-de-France;60;3;07;674;Vieux-Moulin;629;31;660
32;Hauts-de-France;60;3;10;675;Vignemont;435;6;441
32;Hauts-de-France;60;3;17;676;Ville;759;16;775
32;Hauts-de-France;60;1;11;677;Villembray;252;4;256
32;Hauts-de-France;60;1;12;678;Villeneuve-les-Sablons;1176;23;1199
32;Hauts-de-France;60;4;15;679;La Villeneuve-sous-Thury;160;6;166
32;Hauts-de-France;60;4;18;680;Villeneuve-sur-Verberie;652;17;669
32;Hauts-de-France;60;1;02;681;Villers-Saint-Barthélemy;472;18;490
32;Hauts-de-France;60;4;18;682;Villers-Saint-Frambourg-Ognon ;712;38;750
32;Hauts-de-France;60;4;15;683;Villers-Saint-Genest;395;16;411
32;Hauts-de-France;60;4;16;684;Villers-Saint-Paul;6440;64;6504
32;Hauts-de-France;60;1;04;685;Villers-Saint-Sépulcre;1007;9;1016
32;Hauts-de-France;60;4;13;686;Villers-sous-Saint-Leu;2327;57;2384
32;Hauts-de-France;60;1;11;687;Villers-sur-Auchy;374;9;383
32;Hauts-de-France;60;1;11;688;Villers-sur-Bonnières;162;1;163
32;Hauts-de-France;60;3;10;689;Villers-sur-Coudun;1396;58;1454
32;Hauts-de-France;60;1;11;691;Villers-Vermont;121;1;122
32;Hauts-de-France;60;2;19;692;Villers-Vicomte;145;2;147
32;Hauts-de-France;60;3;17;693;Villeselve;423;4;427
32;Hauts-de-France;60;4;20;695;Vineuil-Saint-Firmin;1408;50;1458
32;Hauts-de-France;60;1;11;697;Vrocourt;33;1;34
32;Hauts-de-France;60;2;10;698;Wacquemoulin;290;9;299
32;Hauts-de-France;60;1;11;699;Wambez;165;5;170
32;Hauts-de-France;60;1;02;700;Warluis;1173;21;1194
32;Hauts-de-France;60;2;19;701;Wavignies;1242;7;1249
32;Hauts-de-France;60;2;10;702;Welles-Pérennes;252;3;255
28;Normandie;61;3;01;214;L' Aigle;8019;233;8252
28;Normandie;61;1;97;001;Alençon;25775;748;26523
28;Normandie;61;1;19;002;Almenêches;691;10;701
28;Normandie;61;3;09;005;Appenai-sous-Bellême;280;6;286
28;Normandie;61;2;98;006;Argentan;13730;368;14098
28;Normandie;61;3;20;422;Les Aspres;623;15;638
28;Normandie;61;2;06;007;Athis-Val de Rouvre;4236;85;4321
28;Normandie;61;3;18;008;Aube;1279;45;1324
28;Normandie;61;3;21;010;Aubry-le-Panthou;116;6;122
28;Normandie;61;2;14;011;Aubusson;423;15;438
28;Normandie;61;3;20;012;Auguaise;211;5;216
28;Normandie;61;1;17;013;Aunay-les-Bois;140;0;140
28;Normandie;61;2;04;014;Aunou-le-Faucon;245;9;254
28;Normandie;61;1;19;015;Aunou-sur-Orne;265;7;272
28;Normandie;61;3;18;017;Les Authieux-du-Puits;76;0;76
28;Normandie;61;3;21;018;Avernes-Saint-Gourgon;59;1;60
28;Normandie;61;2;15;020;Avoine;217;7;224
28;Normandie;61;2;11;021;Avrilly;105;4;109
28;Normandie;61;1;89;483;Bagnoles de l'Orne Normandie;2713;51;2764
28;Normandie;61;2;05;023;Bailleul;609;24;633
28;Normandie;61;2;12;024;Banvou;606;14;620
28;Normandie;61;1;17;026;Barville;187;8;195
28;Normandie;61;2;06;028;Bazoches-au-Houlme;465;11;476
28;Normandie;61;3;16;029;Bazoches-sur-Hoëne;850;23;873
28;Normandie;61;2;13;030;La Bazoque;267;4;271
28;Normandie;61;3;18;032;Beaufai;338;8;346
28;Normandie;61;3;20;034;Beaulieu;211;7;218
28;Normandie;61;1;12;035;Beauvain;275;2;277
28;Normandie;61;1;19;036;Belfonds;204;0;204
28;Normandie;61;3;09;196;Belforêt-en-Perche;1621;53;1674
28;Normandie;61;3;16;037;Bellavilliers;134;3;137
28;Normandie;61;3;09;038;Bellême;1456;19;1475
28;Normandie;61;1;19;039;La Bellière;128;1;129
28;Normandie;61;2;12;040;Bellou-en-Houlme;1096;31;1127
28;Normandie;61;3;09;041;Bellou-le-Trichard;211;3;214
28;Normandie;61;3;08;043;Berd'huis;1103;21;1124
28;Normandie;61;2;06;044;Berjou;454;16;470
28;Normandie;61;3;20;046;Bizou;131;0;131
28;Normandie;61;3;16;048;Boëcé;123;4;127
28;Normandie;61;2;04;375;Boischampré;1194;35;1229
28;Normandie;61;1;19;049;Boissei-la-Lande;127;2;129
28;Normandie;61;1;19;051;Boitron;356;6;362
28;Normandie;61;3;20;052;Bonnefoi;187;4;191
28;Normandie;61;3;20;053;Bonsmoulins;237;7;244
28;Normandie;61;3;21;054;Le Bosc-Renoult;250;4;254
28;Normandie;61;2;15;055;Boucé;616;11;627
28;Normandie;61;1;19;056;Le Bouillon;169;1;170
28;Normandie;61;3;20;060;Brethel;165;1;166
28;Normandie;61;3;08;061;Bretoncelles;1483;30;1513
28;Normandie;61;2;04;062;Brieux;91;2;93
28;Normandie;61;2;06;063;Briouze;1526;57;1583
28;Normandie;61;1;17;064;Brullemail;94;3;97
28;Normandie;61;1;17;066;Buré;109;5;114
28;Normandie;61;1;17;067;Bures;163;4;167
28;Normandie;61;1;17;068;Bursard;210;1;211
28;Normandie;61;2;06;069;Cahan;175;7;182
28;Normandie;61;2;13;070;Caligny;822;26;848
28;Normandie;61;3;21;071;Camembert;182;7;189
28;Normandie;61;3;21;072;Canapville;205;4;209
28;Normandie;61;1;15;074;Carrouges;656;7;663
28;Normandie;61;1;07;075;Ceaucé;1177;26;1203
28;Normandie;61;1;19;076;Le Cercueil;135;6;141
28;Normandie;61;1;02;077;Cerisé;857;16;873
28;Normandie;61;2;13;078;Cerisy-Belle-Étoile;719;47;766
28;Normandie;61;3;09;079;Ceton;1778;24;1802
28;Normandie;61;1;15;080;Chahains;83;2;85
28;Normandie;61;1;19;081;Chailloué;886;25;911
28;Normandie;61;1;17;082;Le Chalange;93;4;97
28;Normandie;61;1;15;085;Le Champ-de-la-Pierre;37;0;37
28;Normandie;61;3;18;088;Champ-Haut;48;1;49
28;Normandie;61;2;06;084;Champcerie;165;4;169
28;Normandie;61;3;21;086;Les Champeaux;111;0;111
28;Normandie;61;3;16;087;Champeaux-sur-Sarthe;165;4;169
28;Normandie;61;3;21;089;Champosoult;97;0;97
28;Normandie;61;2;11;091;Champsecret;898;22;920
28;Normandie;61;3;01;092;Chandai;671;6;677
28;Normandie;61;2;11;093;Chanu;1261;17;1278
28;Normandie;61;2;13;094;La Chapelle-au-Moine;587;17;604
28;Normandie;61;2;13;095;La Chapelle-Biche;529;8;537
28;Normandie;61;3;16;097;La Chapelle-Montligeon;518;15;533
28;Normandie;61;1;19;098;La Chapelle-près-Sées;455;31;486
28;Normandie;61;3;09;099;La Chapelle-Souëf;250;8;258
28;Normandie;61;3;20;100;La Chapelle-Viel;277;17;294
28;Normandie;61;3;20;429;Charencey;791;25;816
28;Normandie;61;1;19;101;Le Château-d'Almenêches;204;9;213
28;Normandie;61;2;13;102;Le Châtellier;407;10;417
28;Normandie;61;3;21;103;Chaumont;174;1;175
28;Normandie;61;1;15;104;La Chaux;52;1;53
28;Normandie;61;3;09;105;Chemilli;193;8;201
28;Normandie;61;1;15;107;Ciral;393;11;404
28;Normandie;61;3;21;108;Cisai-Saint-Aubin;160;4;164
28;Normandie;61;1;10;111;Colombiers;332;13;345
28;Normandie;61;3;16;113;Comblot;63;1;64
28;Normandie;61;2;04;114;Commeaux;154;5;159
28;Normandie;61;1;10;117;Condé-sur-Sarthe;2478;48;2526
28;Normandie;61;3;16;118;Corbon;130;6;136
28;Normandie;61;2;05;120;Coudehard;76;0;76
28;Normandie;61;3;16;121;Coulimer;290;8;298
28;Normandie;61;3;21;122;Coulmer;84;6;90
28;Normandie;61;2;05;123;Coulonces;222;5;227
28;Normandie;61;2;12;124;La Coulonche;496;5;501
28;Normandie;61;1;17;126;Coulonges-sur-Sarthe;529;11;540
28;Normandie;61;3;08;050;Cour-Maugis sur Huisne;601;22;623
28;Normandie;61;3;16;129;Courgeon;369;11;380
28;Normandie;61;3;16;130;Courgeoût;456;13;469
28;Normandie;61;1;17;133;Courtomer;700;17;717
28;Normandie;61;2;06;137;Craménil;140;5;145
28;Normandie;61;3;21;138;Croisilles;209;4;213
28;Normandie;61;3;21;139;Crouttes;306;11;317
28;Normandie;61;3;20;140;Crulai;854;16;870
28;Normandie;61;1;10;141;Cuissai;412;18;430
28;Normandie;61;3;09;142;Dame-Marie;141;4;145
28;Normandie;61;1;10;143;Damigny;2479;63;2542
28;Normandie;61;2;11;145;Domfront en Poiraie;4211;124;4335
28;Normandie;61;2;12;146;Dompierre;402;5;407
28;Normandie;61;2;06;148;Durcet;305;11;316
28;Normandie;61;2;12;149;Échalou;388;8;396
28;Normandie;61;3;18;150;Échauffour;742;13;755
28;Normandie;61;3;18;151;Écorcei;392;11;403
28;Normandie;61;2;05;152;Écorches;94;0;94
28;Normandie;61;2;87;153;Écouché-les-Vallées;2180;48;2228
28;Normandie;61;1;17;341;Écouves ;1695;55;1750
28;Normandie;61;1;17;156;Essay;536;14;550
28;Normandie;61;2;06;158;Faverolles;147;2;149
28;Normandie;61;3;18;159;Fay;71;1;72
28;Normandie;61;3;16;160;Feings;189;5;194
28;Normandie;61;3;20;162;La Ferrière-au-Doyen;164;3;167
28;Normandie;61;2;12;163;La Ferrière-aux-Étangs;1538;22;1560
28;Normandie;61;1;19;164;La Ferrière-Béchet;241;2;243
28;Normandie;61;1;10;165;La Ferrière-Bochard;744;14;758
28;Normandie;61;1;17;166;Ferrières-la-Verrerie;143;3;146
28;Normandie;61;3;18;167;La Ferté-en-Ouche;3154;63;3217
28;Normandie;61;2;  ;168;Ferté Macé ;5207;402;5609
28;Normandie;61;2;99;169;Flers;14779;362;15141
28;Normandie;61;2;15;170;Fleuré;201;3;204
28;Normandie;61;2;05;171;Fontaine-les-Bassets;104;1;105
28;Normandie;61;1;19;176;Francheville;146;2;148
28;Normandie;61;3;21;178;La Fresnaie-Fayel;54;2;56
28;Normandie;61;3;21;180;Fresnay-le-Samson;85;1;86
28;Normandie;61;3;21;181;Gacé;1836;61;1897
28;Normandie;61;1;10;182;Gandelain;415;5;420
28;Normandie;61;1;17;183;Gâprée;138;3;141
28;Normandie;61;3;20;187;Les Genettes;193;7;200
28;Normandie;61;3;18;188;La Genevraie;92;5;97
28;Normandie;61;2;06;189;Giel-Courteilles;448;226;674
28;Normandie;61;2;05;190;Ginai;76;1;77
28;Normandie;61;3;18;192;Godisson;109;3;112
28;Normandie;61;3;18;193;La Gonfrière;292;3;295
28;Normandie;61;2;05;474;Gouffern en Auge;3712;80;3792
28;Normandie;61;2;06;195;Le Grais;194;4;198
28;Normandie;61;2;05;197;Guêprei;136;4;140
28;Normandie;61;3;21;198;Guerquesalles;134;0;134
28;Normandie;61;2;06;199;Habloville;326;7;333
28;Normandie;61;1;17;202;Hauterive;466;11;477
28;Normandie;61;1;10;203;Héloup;910;26;936
28;Normandie;61;3;20;206;L' Hôme-Chamondot;251;4;255
28;Normandie;61;3;09;207;Igé;614;23;637
28;Normandie;61;3;20;208;Irai;617;15;632
28;Normandie;61;1;15;209;Joué-du-Bois;420;2;422
28;Normandie;61;2;15;210;Joué-du-Plain;251;9;260
28;Normandie;61;2;04;212;Juvigny-sur-Orne;124;4;128
28;Normandie;61;1;07;211;Juvigny Val d'Andaine;2180;55;2235
28;Normandie;61;1;10;213;Lalacelle;279;10;289
28;Normandie;61;1;17;215;Laleu;358;7;365
28;Normandie;61;1;15;216;La Lande-de-Goult;191;3;194
28;Normandie;61;2;15;217;La Lande-de-Lougé;51;1;52
28;Normandie;61;2;13;218;La Lande-Patry;1805;54;1859
28;Normandie;61;2;06;219;La Lande-Saint-Siméon;155;1;156
28;Normandie;61;2;14;221;Landigou;449;8;457
28;Normandie;61;2;13;222;Landisacq;753;20;773
28;Normandie;61;1;17;224;Larré;444;6;450
28;Normandie;61;3;18;225;Lignères;29;0;29
28;Normandie;61;2;06;227;Lignou;146;3;149
28;Normandie;61;3;16;229;Loisail;126;4;130
28;Normandie;61;3;20;230;Longny les Villages ;3002;50;3052
28;Normandie;61;2;11;232;Lonlay-l'Abbaye;1121;39;1160
28;Normandie;61;2;12;233;Lonlay-le-Tesson;225;7;232
28;Normandie;61;1;10;234;Lonrai;1127;37;1164
28;Normandie;61;2;15;237;Lougé-sur-Maire;315;1;316
28;Normandie;61;2;05;238;Louvières-en-Auge;82;1;83
28;Normandie;61;1;19;240;Macé;388;5;393
28;Normandie;61;3;08;241;La Madeleine-Bouvet;409;11;420
28;Normandie;61;3;20;242;Le Mage;227;10;237
28;Normandie;61;1;15;243;Magny-le-Désert;1401;42;1443
28;Normandie;61;3;18;244;Mahéru;268;12;280
28;Normandie;61;1;07;248;Mantilly;528;8;536
28;Normandie;61;1;17;251;Marchemaisons;153;6;159
28;Normandie;61;3;21;252;Mardilly;138;4;142
28;Normandie;61;3;16;255;Mauves-sur-Huisne;539;12;551
28;Normandie;61;1;19;256;Médavy;153;5;158
28;Normandie;61;1;15;257;Méhoudin;120;2;122
28;Normandie;61;1;17;258;Le Mêle-sur-Sarthe;679;11;690
28;Normandie;61;3;20;259;Le Ménil-Bérard;75;0;75
28;Normandie;61;1;17;261;Le Ménil-Broût;168;3;171
28;Normandie;61;2;11;262;Le Ménil-Ciboult;114;1;115
28;Normandie;61;2;06;260;Le Ménil-de-Briouze;551;10;561
28;Normandie;61;1;17;263;Ménil-Erreux;213;7;220
28;Normandie;61;3;18;264;Ménil-Froger;55;1;56
28;Normandie;61;2;06;265;Ménil-Gondouin;169;4;173
28;Normandie;61;1;17;266;Le Ménil-Guyon;77;0;77
28;Normandie;61;2;06;267;Ménil-Hermei;204;3;207
28;Normandie;61;3;21;268;Ménil-Hubert-en-Exmes;111;5;116
28;Normandie;61;2;06;269;Ménil-Hubert-sur-Orne;483;8;491
28;Normandie;61;1;15;271;Le Ménil-Scelleur;88;0;88
28;Normandie;61;3;18;272;Le Ménil-Vicomte;23;1;24
28;Normandie;61;2;06;273;Ménil-Vin;52;3;55
28;Normandie;61;3;20;274;Les Menus;237;6;243
28;Normandie;61;3;18;275;Le Merlerault;791;19;810
28;Normandie;61;2;05;276;Merri;158;6;164
28;Normandie;61;3;16;277;La Mesnière;285;6;291
28;Normandie;61;2;12;278;Messei;1881;55;1936
28;Normandie;61;1;10;279;Mieuxcé;617;15;632
28;Normandie;61;2;13;281;Moncy;253;7;260
28;Normandie;61;2;05;289;Mont-Ormel;51;0;51
28;Normandie;61;2;04;283;Montabard;283;9;292
28;Normandie;61;1;17;284;Montchevrel;228;2;230
28;Normandie;61;3;16;286;Montgaudry;79;0;79
28;Normandie;61;2;14;287;Montilly-sur-Noireau;722;19;741
28;Normandie;61;1;19;288;Montmerrei;514;7;521
28;Normandie;61;2;06;290;Montreuil-au-Houlme;132;4;136
28;Normandie;61;2;05;291;Montreuil-la-Cambe;65;0;65
28;Normandie;61;2;12;463;Les Monts d'Andaine;1753;34;1787
28;Normandie;61;2;15;194;Monts-sur-Orne ;890;14;904
28;Normandie;61;2;11;292;Montsecret-Clairefougère;657;9;666
28;Normandie;61;3;16;293;Mortagne-au-Perche;3801;296;4097
28;Normandie;61;1;19;294;Mortrée ;1160;27;1187
28;Normandie;61;1;15;295;La Motte-Fouquet;162;2;164
28;Normandie;61;3;20;297;Moulins-la-Marche;718;10;728
28;Normandie;61;2;04;298;Moulins-sur-Orne;313;11;324
28;Normandie;61;3;08;300;Moutiers-au-Perche;387;8;395
28;Normandie;61;1;19;301;Neauphe-sous-Essai;211;1;212
28;Normandie;61;2;05;302;Neauphe-sur-Dive;136;3;139
28;Normandie;61;2;04;303;Nécy;517;13;530
28;Normandie;61;1;17;304;Neuilly-le-Bisson;301;6;307
28;Normandie;61;3;21;307;Neuville-sur-Touques;227;2;229
28;Normandie;61;2;06;308;Neuvy-au-Houlme;208;4;212
28;Normandie;61;3;18;310;Nonant-le-Pin;470;31;501
28;Normandie;61;2;04;314;Occagnes;662;17;679
28;Normandie;61;2;05;316;Ommoy;119;3;122
28;Normandie;61;1;15;228;Orée-d'Écouves ;757;16;773
28;Normandie;61;3;21;317;Orgères;176;5;181
28;Normandie;61;3;09;319;Origny-le-Roux;265;7;272
28;Normandie;61;1;10;321;Pacé;409;6;415
28;Normandie;61;3;16;322;Parfondeval;109;2;111
28;Normandie;61;3;20;323;Le Pas-Saint-l'Homer;130;2;132
28;Normandie;61;1;07;324;Passais Villages;1176;14;1190
28;Normandie;61;3;08;309;Perche en Nocé;2029;63;2092
28;Normandie;61;1;07;326;Perrou;307;6;313
28;Normandie;61;3;16;327;Pervenchères;340;11;351
28;Normandie;61;2;05;328;Le Pin-au-Haras;271;5;276
28;Normandie;61;3;16;329;Le Pin-la-Garenne;645;11;656
28;Normandie;61;3;18;330;Planches;187;3;190
28;Normandie;61;1;17;331;Le Plantis;142;2;144
28;Normandie;61;2;06;332;Pointel;319;57;376
28;Normandie;61;3;21;333;Pontchardon;177;4;181
28;Normandie;61;3;09;336;Pouvrai;105;7;112
28;Normandie;61;2;06;339;Putanges-le-Lac;2160;32;2192
28;Normandie;61;3;18;342;Rai;1414;30;1444
28;Normandie;61;2;15;344;Rânes;1039;13;1052
28;Normandie;61;3;08;345;Rémalard en Perche;1927;42;1969
28;Normandie;61;3;21;346;Le Renouard;202;6;208
28;Normandie;61;3;21;347;Résenlieu;173;0;173
28;Normandie;61;3;16;348;Réveillon;373;6;379
28;Normandie;61;2;04;349;Ri;164;3;167
28;Normandie;61;1;07;096;Rives d'Andaine ;3050;108;3158
28;Normandie;61;1;10;350;La Roche-Mabile;159;8;167
28;Normandie;61;3;21;351;Roiville;132;4;136
28;Normandie;61;2;04;352;Rônai;173;5;178
28;Normandie;61;1;15;357;Rouperroux;194;3;197
28;Normandie;61;3;08;116;Sablons sur Huisne;2111;41;2152
28;Normandie;61;2;04;358;Sai;223;5;228
28;Normandie;61;1;17;360;Saint-Agnan-sur-Sarthe;97;2;99
28;Normandie;61;2;06;361;Saint-André-de-Briouze;176;6;182
28;Normandie;61;2;12;362;Saint-André-de-Messei;558;19;577
28;Normandie;61;3;16;363;Saint-Aquilin-de-Corbion;63;2;65
28;Normandie;61;1;17;365;Saint-Aubin-d'Appenai;404;9;413
28;Normandie;61;3;21;366;Saint-Aubin-de-Bonneval;134;2;136
28;Normandie;61;3;16;367;Saint-Aubin-de-Courteraie;132;2;134
28;Normandie;61;2;11;369;Saint-Bômer-les-Forges;1033;37;1070
28;Normandie;61;2;11;370;Saint-Brice;152;2;154
28;Normandie;61;2;15;371;Saint-Brice-sous-Rânes;137;2;139
28;Normandie;61;1;10;372;Saint-Céneri-le-Gérei;117;4;121
28;Normandie;61;2;11;374;Saint-Christophe-de-Chaulieu;97;4;101
28;Normandie;61;2;13;376;Saint-Clair-de-Halouze;866;18;884
28;Normandie;61;3;08;379;Saint-Cyr-la-Rosière;232;5;237
28;Normandie;61;3;16;381;Saint-Denis-sur-Huisne;57;5;62
28;Normandie;61;1;10;382;Saint-Denis-sur-Sarthon;1120;19;1139
28;Normandie;61;1;15;384;Saint-Ellier-les-Bois;253;2;255
28;Normandie;61;3;21;385;Saint-Evroult-de-Montfort;339;8;347
28;Normandie;61;3;18;386;Saint-Evroult-Notre-Dame-du-Bois;448;31;479
28;Normandie;61;1;07;387;Saint-Fraimbault;541;18;559
28;Normandie;61;3;09;388;Saint-Fulgent-des-Ormes;160;2;162
28;Normandie;61;2;15;390;Saint-Georges-d'Annebecq;152;1;153
28;Normandie;61;2;14;391;Saint-Georges-des-Groseillers;3160;112;3272
28;Normandie;61;3;21;392;Saint-Germain-d'Aunay;144;4;148
28;Normandie;61;3;18;393;Saint-Germain-de-Clairefeuille;137;5;142
28;Normandie;61;3;09;394;Saint-Germain-de-la-Coudre;779;19;798
28;Normandie;61;3;16;396;Saint-Germain-de-Martigny;78;5;83
28;Normandie;61;3;08;395;Saint-Germain-des-Grois;236;7;243
28;Normandie;61;1;03;397;Saint-Germain-du-Corbéis;3789;132;3921
28;Normandie;61;1;17;398;Saint-Germain-le-Vieux;59;1;60
28;Normandie;61;2;05;399;Saint-Gervais-des-Sablons;73;3;76
28;Normandie;61;1;19;400;Saint-Gervais-du-Perron;367;7;374
28;Normandie;61;2;11;401;Saint-Gilles-des-Marais;109;4;113
28;Normandie;61;2;06;402;Saint-Hilaire-de-Briouze;308;8;316
28;Normandie;61;3;16;404;Saint-Hilaire-le-Châtel;639;29;668
28;Normandie;61;3;09;405;Saint-Hilaire-sur-Erre;532;12;544
28;Normandie;61;3;20;406;Saint-Hilaire-sur-Risle;316;5;321
28;Normandie;61;3;16;411;Saint-Jouin-de-Blavou;281;11;292
28;Normandie;61;1;17;412;Saint-Julien-sur-Sarthe;677;15;692
28;Normandie;61;2;05;413;Saint-Lambert-sur-Dive;143;4;147
28;Normandie;61;3;16;414;Saint-Langis-lès-Mortagne;900;21;921
28;Normandie;61;1;17;415;Saint-Léger-sur-Sarthe;327;6;333
28;Normandie;61;1;17;416;Saint-Léonard-des-Parcs;77;1;78
28;Normandie;61;3;16;418;Saint-Mard-de-Réno;420;11;431
28;Normandie;61;1;07;421;Saint-Mars-d'Égrenne;669;18;687
28;Normandie;61;3;01;423;Saint-Martin-d'Écublei;646;27;673
28;Normandie;61;1;15;424;Saint-Martin-des-Landes;207;4;211
28;Normandie;61;3;16;425;Saint-Martin-des-Pézerits;142;2;144
28;Normandie;61;3;09;426;Saint-Martin-du-Vieux-Bellême;570;17;587
28;Normandie;61;1;15;427;Saint-Martin-l'Aiguillon;195;4;199
28;Normandie;61;3;01;432;Saint-Michel-Tubœuf;624;22;646
28;Normandie;61;3;18;435;Saint-Nicolas-de-Sommaire;274;4;278
28;Normandie;61;1;10;433;Saint-Nicolas-des-Bois;283;8;291
28;Normandie;61;3;16;438;Saint-Ouen-de-Sécherouvre;176;5;181
28;Normandie;61;1;15;439;Saint-Ouen-le-Brisoult;122;4;126
28;Normandie;61;3;01;440;Saint-Ouen-sur-Iton;827;35;862
28;Normandie;61;1;15;442;Saint-Patrice-du-Désert;208;6;214
28;Normandie;61;2;13;443;Saint-Paul;689;15;704
28;Normandie;61;2;06;444;Saint-Philbert-sur-Orne;117;3;120
28;Normandie;61;2;13;445;Saint-Pierre-d'Entremont;677;10;687
28;Normandie;61;3;18;446;Saint-Pierre-des-Loges;155;5;160
28;Normandie;61;2;14;447;Saint-Pierre-du-Regard;1413;20;1433
28;Normandie;61;3;08;448;Saint-Pierre-la-Bruyère;431;6;437
28;Normandie;61;1;17;450;Saint-Quentin-de-Blavou;72;1;73
28;Normandie;61;2;11;451;Saint-Quentin-les-Chardonnets;324;6;330
28;Normandie;61;1;07;452;Saint-Roch-sur-Égrenne;177;0;177
28;Normandie;61;1;15;453;Saint-Sauveur-de-Carrouges;248;7;255
28;Normandie;61;3;01;456;Saint-Sulpice-sur-Risle;1667;49;1716
28;Normandie;61;3;18;457;Saint-Symphorien-des-Bruyères;481;8;489
28;Normandie;61;3;16;373;Sainte-Céronne-lès-Mortagne;245;8;253
28;Normandie;61;3;18;389;Sainte-Gauburge-Sainte-Colombe;1059;24;1083
28;Normandie;61;2;06;407;Sainte-Honorine-la-Chardonne;712;13;725
28;Normandie;61;2;06;408;Sainte-Honorine-la-Guillaume;333;9;342
28;Normandie;61;1;15;419;Sainte-Marguerite-de-Carrouges;219;7;226
28;Normandie;61;1;15;420;Sainte-Marie-la-Robert;86;1;87
28;Normandie;61;2;06;436;Sainte-Opportune;240;2;242
28;Normandie;61;1;17;454;Sainte-Scolasse-sur-Sarthe;611;16;627
28;Normandie;61;2;12;459;Saires-la-Verrerie;308;6;314
28;Normandie;61;3;21;461;Le Sap-André;121;3;124
28;Normandie;61;3;21;460;Sap-en-Auge;957;10;967
28;Normandie;61;2;04;462;Sarceaux;1045;34;1079
28;Normandie;61;1;19;464;Sées;4193;444;4637
28;Normandie;61;2;14;466;La Selle-la-Forge;1471;39;1510
28;Normandie;61;1;17;467;Semallé;344;11;355
28;Normandie;61;2;04;472;Sévigny;307;12;319
28;Normandie;61;2;15;473;Sevrai;259;6;265
28;Normandie;61;3;16;475;Soligny-la-Trappe;671;15;686
28;Normandie;61;3;09;476;Suré;278;5;283
28;Normandie;61;2;15;479;Tanques;157;4;161
28;Normandie;61;1;19;480;Tanville;232;5;237
28;Normandie;61;1;17;481;Tellières-le-Plessis;73;3;76
28;Normandie;61;1;07;482;Tessé-Froulay;385;9;394
28;Normandie;61;3;21;485;Ticheville;201;7;208
28;Normandie;61;2;11;486;Tinchebray-Bocage;4902;88;4990
28;Normandie;61;1;07;487;Torchamp;297;4;301
28;Normandie;61;3;18;488;Touquettes;91;2;93
28;Normandie;61;2;05;490;Tournai-sur-Dive;305;1;306
28;Normandie;61;3;20;491;Tourouvre au Perche;3115;50;3165
28;Normandie;61;1;17;492;Trémont;120;4;124
28;Normandie;61;3;21;493;La Trinité-des-Laitiers;63;6;69
28;Normandie;61;2;05;494;Trun;1240;66;1306
28;Normandie;61;3;09;484;Val-au-Perche;3526;75;3601
28;Normandie;61;1;10;497;Valframbert;1771;29;1800
28;Normandie;61;3;09;498;Vaunoise;101;4;105
28;Normandie;61;1;17;499;Les Ventes-de-Bourse;148;3;151
28;Normandie;61;3;20;500;La Ventrouze;125;4;129
28;Normandie;61;3;08;501;Verrières;423;5;428
28;Normandie;61;1;17;502;Vidai;97;0;97
28;Normandie;61;2;15;503;Vieux-Pont;197;4;201
28;Normandie;61;2;05;505;Villedieu-lès-Bailleul;214;6;220
28;Normandie;61;3;16;507;Villiers-sous-Mortagne;282;5;287
28;Normandie;61;3;21;508;Vimoutiers;3224;91;3315
28;Normandie;61;3;01;510;Vitrai-sous-Laigle;230;4;234
28;Normandie;61;2;06;512;Les Yveteaux;105;3;108
32;Hauts-de-France;62;7;17;001;Ablain-Saint-Nazaire;1824;37;1861
32;Hauts-de-France;62;1;09;002;Ablainzevelle;227;3;230
32;Hauts-de-France;62;7;08;003;Acheville;615;22;637
32;Hauts-de-France;62;1;04;004;Achicourt;7878;107;7985
32;Hauts-de-France;62;1;09;005;Achiet-le-Grand;978;5;983
32;Hauts-de-France;62;1;09;006;Achiet-le-Petit;307;4;311
32;Hauts-de-France;62;1;02;007;Acq;786;5;791
32;Hauts-de-France;62;5;33;008;Acquin-Westbécourt;821;11;832
32;Hauts-de-France;62;1;07;009;Adinfer;267;7;274
32;Hauts-de-France;62;5;33;010;Affringues;242;0;242
32;Hauts-de-France;62;1;07;011;Agnez-lès-Duisans;649;16;665
32;Hauts-de-France;62;1;07;012;Agnières;248;4;252
32;Hauts-de-France;62;1;04;013;Agny;1906;35;1941
32;Hauts-de-France;62;5;01;014;Aire-sur-la-Lys;9772;268;10040
32;Hauts-de-France;62;4;10;015;Airon-Notre-Dame;229;2;231
32;Hauts-de-France;62;4;10;016;Airon-Saint-Vaast;188;5;193
32;Hauts-de-France;62;4;33;017;Aix-en-Ergny;196;1;197
32;Hauts-de-France;62;4;06;018;Aix-en-Issart;264;5;269
32;Hauts-de-France;62;7;17;019;Aix-Noulette;3915;42;3957
32;Hauts-de-France;62;6;19;020;Alembon;627;11;638
32;Hauts-de-France;62;4;33;021;Alette;386;1;387
32;Hauts-de-France;62;3;22;022;Alincthun;322;11;333
32;Hauts-de-France;62;2;31;023;Allouagne;2906;30;2936
32;Hauts-de-France;62;5;33;024;Alquines;992;12;1004
32;Hauts-de-France;62;3;22;025;Ambleteuse;1895;30;1925
32;Hauts-de-France;62;4;25;026;Ambricourt;115;9;124
32;Hauts-de-France;62;1;07;027;Ambrines;226;0;226
32;Hauts-de-France;62;2;31;028;Ames;632;8;640
32;Hauts-de-France;62;2;31;029;Amettes;473;1;474
32;Hauts-de-France;62;1;07;030;Amplier;301;4;305
32;Hauts-de-France;62;6;19;031;Andres;1556;23;1579
32;Hauts-de-France;62;7;17;032;Angres;4613;56;4669
32;Hauts-de-France;62;7;29;033;Annay;4377;25;4402
32;Hauts-de-France;62;2;23;034;Annequin;2166;14;2180
32;Hauts-de-France;62;2;11;035;Annezin;5871;46;5917
32;Hauts-de-France;62;1;38;036;Anvin;760;17;777
32;Hauts-de-France;62;1;02;037;Anzin-Saint-Aubin;2773;87;2860
32;Hauts-de-France;62;6;19;038;Ardres;4403;47;4450
32;Hauts-de-France;62;1;15;039;Arleux-en-Gohelle;858;17;875
32;Hauts-de-France;62;5;32;040;Arques;9654;127;9781
32;Hauts-de-France;62;1;96;041;Arras;41555;786;42341
32;Hauts-de-France;62;1;03;042;Athies;1034;13;1047
32;Hauts-de-France;62;6;19;043;Les Attaques;2009;28;2037
32;Hauts-de-France;62;4;10;044;Attin;756;8;764
32;Hauts-de-France;62;1;07;045;Aubigny-en-Artois;1466;19;1485
32;Hauts-de-France;62;4;06;046;Aubin-Saint-Vaast;751;6;757
32;Hauts-de-France;62;1;38;047;Aubrometz;152;1;153
32;Hauts-de-France;62;2;05;048;Auchel;10399;44;10443
32;Hauts-de-France;62;2;31;049;Auchy-au-Bois;517;2;519
32;Hauts-de-France;62;4;06;050;Auchy-lès-Hesdin;1574;16;1590
32;Hauts-de-France;62;2;23;051;Auchy-les-Mines;4700;32;4732
32;Hauts-de-France;62;3;22;052;Audembert;444;12;456
32;Hauts-de-France;62;5;25;053;Audincthun;664;6;670
32;Hauts-de-France;62;3;22;054;Audinghen;585;7;592
32;Hauts-de-France;62;5;33;055;Audrehem;546;8;554
32;Hauts-de-France;62;3;22;056;Audresselles;636;5;641
32;Hauts-de-France;62;6;34;057;Audruicq;5442;53;5495
32;Hauts-de-France;62;1;38;058;Aumerval;200;5;205
32;Hauts-de-France;62;6;19;059;Autingues;290;14;304
32;Hauts-de-France;62;1;06;060;Auxi-le-Château;2606;24;2630
32;Hauts-de-France;62;1;38;061;Averdoingt;294;7;301
32;Hauts-de-France;62;4;33;062;Avesnes;53;1;54
32;Hauts-de-France;62;1;07;063;Avesnes-le-Comte;1853;31;1884
32;Hauts-de-France;62;1;09;064;Avesnes-lès-Bapaume;165;2;167
32;Hauts-de-France;62;7;08;065;Avion;17583;139;17722
32;Hauts-de-France;62;4;25;066;Avondance;37;2;39
32;Hauts-de-France;62;5;25;067;Avroult;610;4;614
32;Hauts-de-France;62;1;09;068;Ayette;323;7;330
32;Hauts-de-France;62;4;06;069;Azincourt;308;8;316
32;Hauts-de-France;62;1;07;070;Bailleul-aux-Cornailles;262;5;267
32;Hauts-de-France;62;1;38;071;Bailleul-lès-Pernes;413;7;420
32;Hauts-de-France;62;1;03;073;Bailleul-Sir-Berthoult;1417;25;1442
32;Hauts-de-France;62;1;07;072;Bailleulmont;233;3;236
32;Hauts-de-France;62;1;07;074;Bailleulval;230;8;238
32;Hauts-de-France;62;3;14;075;Baincthun;1293;30;1323
32;Hauts-de-France;62;6;19;076;Bainghen;223;1;224
32;Hauts-de-France;62;2;16;077;Bajus;362;6;368
32;Hauts-de-France;62;6;19;078;Balinghem;1166;10;1176
32;Hauts-de-France;62;1;09;079;Bancourt;87;0;87
32;Hauts-de-France;62;1;09;080;Bapaume;3817;318;4135
32;Hauts-de-France;62;1;09;081;Baralle;479;10;489
32;Hauts-de-France;62;1;09;082;Barastre;307;4;311
32;Hauts-de-France;62;2;35;083;Barlin;7603;45;7648
32;Hauts-de-France;62;1;07;084;Barly;216;8;224
32;Hauts-de-France;62;1;07;085;Basseux;136;5;141
32;Hauts-de-France;62;1;07;086;Bavincourt;378;7;385
32;Hauts-de-France;62;5;37;087;Bayenghem-lès-Éperlecques;1006;22;1028
32;Hauts-de-France;62;5;33;088;Bayenghem-lès-Seninghem;326;6;332
32;Hauts-de-France;62;3;22;089;Bazinghen;391;13;404
32;Hauts-de-France;62;4;06;090;Béalencourt;131;5;136
32;Hauts-de-France;62;1;07;091;Beaudricourt;88;1;89
32;Hauts-de-France;62;1;07;092;Beaufort-Blavincourt;400;3;403
32;Hauts-de-France;62;1;09;093;Beaulencourt;233;0;233
32;Hauts-de-France;62;4;10;094;Beaumerie-Saint-Martin;403;4;407
32;Hauts-de-France;62;5;25;095;Beaumetz-lès-Aire;239;1;240
32;Hauts-de-France;62;1;09;096;Beaumetz-lès-Cambrai;576;3;579
32;Hauts-de-France;62;1;02;097;Beaumetz-lès-Loges;1000;14;1014
32;Hauts-de-France;62;1;04;099;Beaurains;5596;63;5659
32;Hauts-de-France;62;4;06;100;Beaurainville;2095;27;2122
32;Hauts-de-France;62;1;06;881;Beauvoir-Wavans;378;10;388
32;Hauts-de-France;62;1;38;101;Beauvois;140;1;141
32;Hauts-de-France;62;4;33;102;Bécourt;273;3;276
32;Hauts-de-France;62;1;09;103;Béhagnies;128;2;130
32;Hauts-de-France;62;3;22;105;Belle-et-Houllefort;564;16;580
32;Hauts-de-France;62;3;22;104;Bellebrune;416;7;423
32;Hauts-de-France;62;5;25;471;Bellinghem;1068;22;1090
32;Hauts-de-France;62;1;15;106;Bellonne;207;6;213
32;Hauts-de-France;62;7;39;107;Bénifontaine;355;9;364
32;Hauts-de-France;62;4;10;108;Berck;13791;336;14127
32;Hauts-de-France;62;1;38;109;Bergueneuse;219;1;220
32;Hauts-de-France;62;1;07;111;Berlencourt-le-Cauroy;279;80;359
32;Hauts-de-France;62;1;07;112;Berles-au-Bois;515;8;523
32;Hauts-de-France;62;1;07;113;Berles-Monchel;489;12;501
32;Hauts-de-France;62;1;38;114;Bermicourt;166;4;170
32;Hauts-de-France;62;1;07;115;Berneville;470;18;488
32;Hauts-de-France;62;4;10;116;Bernieulles;183;1;184
32;Hauts-de-France;62;1;09;117;Bertincourt;917;14;931
32;Hauts-de-France;62;1;07;118;Béthonsart;144;4;148
32;Hauts-de-France;62;2;11;119;Béthune;25193;351;25544
32;Hauts-de-France;62;2;16;120;Beugin;469;8;477
32;Hauts-de-France;62;1;09;121;Beugnâtre;171;4;175
32;Hauts-de-France;62;1;09;122;Beugny;367;4;371
32;Hauts-de-France;62;4;33;123;Beussent;543;4;547
32;Hauts-de-France;62;4;10;124;Beutin;459;5;464
32;Hauts-de-France;62;3;22;125;Beuvrequen;461;13;474
32;Hauts-de-France;62;2;12;126;Beuvry;9331;166;9497
32;Hauts-de-France;62;4;33;127;Bezinghem;380;11;391
32;Hauts-de-France;62;1;15;128;Biache-Saint-Vaast;4197;46;4243
32;Hauts-de-France;62;1;09;129;Biefvillers-lès-Bapaume;96;2;98
32;Hauts-de-France;62;1;07;130;Bienvillers-au-Bois;647;13;660
32;Hauts-de-France;62;1;09;131;Bihucourt;345;3;348
32;Hauts-de-France;62;2;23;132;Billy-Berclau;4693;39;4732
32;Hauts-de-France;62;7;26;133;Billy-Montigny;8167;41;8208
32;Hauts-de-France;62;4;33;134;Bimont;113;2;115
32;Hauts-de-France;62;1;07;135;Blairville;307;3;310
32;Hauts-de-France;62;1;38;137;Blangerval-Blangermont;101;1;102
32;Hauts-de-France;62;4;06;138;Blangy-sur-Ternoise;718;13;731
32;Hauts-de-France;62;5;32;139;Blendecques;4974;133;5107
32;Hauts-de-France;62;5;33;140;Bléquin;509;5;514
32;Hauts-de-France;62;2;01;141;Blessy;875;13;888
32;Hauts-de-France;62;4;06;142;Blingel;163;7;170
32;Hauts-de-France;62;1;06;143;Boffles;49;1;50
32;Hauts-de-France;62;1;04;144;Boiry-Becquerelle;460;7;467
32;Hauts-de-France;62;1;15;145;Boiry-Notre-Dame;449;6;455
32;Hauts-de-France;62;1;07;146;Boiry-Saint-Martin;275;0;275
32;Hauts-de-France;62;1;07;147;Boiry-Sainte-Rictrude;408;5;413
32;Hauts-de-France;62;7;26;148;Bois-Bernard;819;9;828
32;Hauts-de-France;62;5;33;149;Boisdinghem;247;8;255
32;Hauts-de-France;62;4;06;150;Boisjean;500;7;507
32;Hauts-de-France;62;1;04;151;Boisleux-au-Mont;514;10;524
32;Hauts-de-France;62;1;04;152;Boisleux-Saint-Marc;247;3;250
32;Hauts-de-France;62;5;25;153;Bomy;638;7;645
32;Hauts-de-France;62;1;38;154;Bonnières ;675;14;689
32;Hauts-de-France;62;5;33;155;Bonningues-lès-Ardres;648;14;662
32;Hauts-de-France;62;6;18;156;Bonningues-lès-Calais;559;13;572
32;Hauts-de-France;62;4;06;157;Boubers-lès-Hesmond;84;3;87
32;Hauts-de-France;62;1;38;158;Boubers-sur-Canche;587;13;600
32;Hauts-de-France;62;4;06;661;Bouin-Plumoison;498;9;507
32;Hauts-de-France;62;3;97;160;Boulogne-sur-Mer;40664;442;41106
32;Hauts-de-France;62;6;19;161;Bouquehault;776;5;781
32;Hauts-de-France;62;2;31;162;Bourecq;622;6;628
32;Hauts-de-France;62;1;38;163;Bouret-sur-Canche;252;3;255
32;Hauts-de-France;62;1;09;164;Bourlon;1150;18;1168
32;Hauts-de-France;62;3;22;165;Bournonville;237;5;242
32;Hauts-de-France;62;1;38;166;Bours;617;7;624
32;Hauts-de-France;62;6;19;167;Boursin;255;4;259
32;Hauts-de-France;62;4;33;168;Bourthes;840;12;852
32;Hauts-de-France;62;5;33;169;Bouvelinghem;229;6;235
32;Hauts-de-France;62;7;17;170;Bouvigny-Boyeffles;2379;93;2472
32;Hauts-de-France;62;1;38;171;Boyaval;132;2;134
32;Hauts-de-France;62;1;04;172;Boyelles;359;3;362
32;Hauts-de-France;62;1;15;173;Brebières;5083;63;5146
32;Hauts-de-France;62;6;19;174;Brêmes;1290;13;1303
32;Hauts-de-France;62;4;06;175;Brévillers;157;5;162
32;Hauts-de-France;62;4;24;176;Bréxent-Énocq;668;18;686
32;Hauts-de-France;62;1;38;180;Brias;291;6;297
32;Hauts-de-France;62;4;06;177;Brimeux;847;21;868
32;Hauts-de-France;62;2;16;178;Bruay-la-Buissière;21851;408;22259
32;Hauts-de-France;62;3;22;179;Brunembert;414;7;421
32;Hauts-de-France;62;1;09;181;Bucquoy;1457;90;1547
32;Hauts-de-France;62;1;06;182;Buire-au-Bois;232;7;239
32;Hauts-de-France;62;4;06;183;Buire-le-Sec;771;4;775
32;Hauts-de-France;62;1;09;184;Buissy;276;3;279
32;Hauts-de-France;62;1;09;185;Bullecourt;234;1;235
32;Hauts-de-France;62;7;17;186;Bully-les-Mines;12117;78;12195
32;Hauts-de-France;62;1;38;187;Buneville;182;2;184
32;Hauts-de-France;62;2;31;188;Burbure;2845;31;2876
32;Hauts-de-France;62;1;09;189;Bus;130;2;132
32;Hauts-de-France;62;2;31;190;Busnes;1269;19;1288
32;Hauts-de-France;62;6;19;191;Caffiers;741;3;744
32;Hauts-de-France;62;1;15;192;Cagnicourt;431;7;438
32;Hauts-de-France;62;6;98;193;Calais;72929;626;73555
32;Hauts-de-France;62;2;05;194;Calonne-Ricouart;5520;34;5554
32;Hauts-de-France;62;2;31;195;Calonne-sur-la-Lys;1539;19;1558
32;Hauts-de-France;62;4;10;196;La Calotterie;628;11;639
32;Hauts-de-France;62;2;05;197;Camblain-Châtelain;1774;16;1790
32;Hauts-de-France;62;1;07;199;Camblain-l'Abbé;655;129;784
32;Hauts-de-France;62;1;07;198;Cambligneul;335;10;345
32;Hauts-de-France;62;2;23;200;Cambrin;1236;13;1249
32;Hauts-de-France;62;4;24;201;Camiers;2748;40;2788
32;Hauts-de-France;62;4;33;202;Campagne-lès-Boulonnais;655;98;753
32;Hauts-de-France;62;6;19;203;Campagne-lès-Guines;447;11;458
32;Hauts-de-France;62;4;06;204;Campagne-lès-Hesdin;1927;36;1963
32;Hauts-de-France;62;5;32;205;Campagne-lès-Wardrecques;1258;26;1284
32;Hauts-de-France;62;4;10;206;Campigneulles-les-Grandes;294;16;310
32;Hauts-de-France;62;4;10;207;Campigneulles-les-Petites;557;22;579
32;Hauts-de-France;62;1;07;208;Canettemont;70;2;72
32;Hauts-de-France;62;4;25;209;Canlers;157;10;167
32;Hauts-de-France;62;1;07;211;Capelle-Fermont;220;4;224
32;Hauts-de-France;62;3;13;908;La Capelle-lès-Boulogne;1619;38;1657
32;Hauts-de-France;62;4;06;212;Capelle-lès-Hesdin;499;11;510
32;Hauts-de-France;62;7;17;213;Carency;765;11;776
32;Hauts-de-France;62;3;22;214;Carly;570;10;580
32;Hauts-de-France;62;7;21;215;Carvin;17399;102;17501
32;Hauts-de-France;62;1;07;216;La Cauchie;209;2;211
32;Hauts-de-France;62;2;05;217;Cauchy-à-la-Tour;2768;15;2783
32;Hauts-de-France;62;2;16;218;Caucourt;341;8;349
32;Hauts-de-France;62;4;06;219;Caumont;161;4;165
32;Hauts-de-France;62;4;06;220;Cavron-Saint-Martin;453;6;459
32;Hauts-de-France;62;1;07;221;Chelers;251;5;256
32;Hauts-de-France;62;4;06;222;Chériennes;156;2;158
32;Hauts-de-France;62;1;09;223;Chérisy;292;5;297
32;Hauts-de-France;62;2;11;224;Chocques;2841;27;2868
32;Hauts-de-France;62;5;37;225;Clairmarais;615;11;626
32;Hauts-de-France;62;4;33;227;Clenleu;192;2;194
32;Hauts-de-France;62;5;33;228;Clerques;327;3;330
32;Hauts-de-France;62;5;33;229;Cléty;786;16;802
32;Hauts-de-France;62;3;22;230;Colembert;955;13;968
32;Hauts-de-France;62;4;10;231;Colline-Beaumont;134;0;134
32;Hauts-de-France;62;2;16;232;La Comté;915;15;930
32;Hauts-de-France;62;4;10;233;Conchil-le-Temple;1129;14;1143
32;Hauts-de-France;62;1;38;234;Conchy-sur-Canche;219;4;223
32;Hauts-de-France;62;3;36;235;Condette;2486;89;2575
32;Hauts-de-France;62;4;06;236;Contes;334;9;343
32;Hauts-de-France;62;1;38;238;Conteville-en-Ternois;86;1;87
32;Hauts-de-France;62;3;13;237;Conteville-lès-Boulogne;491;9;500
32;Hauts-de-France;62;6;18;239;Coquelles;2603;35;2638
32;Hauts-de-France;62;1;15;240;Corbehem;2339;17;2356
32;Hauts-de-France;62;4;24;241;Cormont;312;5;317
32;Hauts-de-France;62;1;07;242;Couin;104;6;110
32;Hauts-de-France;62;1;07;243;Coullemont;122;3;125
32;Hauts-de-France;62;6;19;244;Coulogne;5401;208;5609
32;Hauts-de-France;62;5;33;245;Coulomby;747;7;754
32;Hauts-de-France;62;4;25;246;Coupelle-Neuve;158;0;158
32;Hauts-de-France;62;4;25;247;Coupelle-Vieille;606;11;617
32;Hauts-de-France;62;1;09;248;Courcelles-le-Comte;465;6;471
32;Hauts-de-France;62;7;28;249;Courcelles-lès-Lens;7918;39;7957
32;Hauts-de-France;62;7;21;250;Courrières;10544;96;10640
32;Hauts-de-France;62;3;22;251;Courset;515;191;706
32;Hauts-de-France;62;2;12;252;La Couture;2720;72;2792
32;Hauts-de-France;62;1;07;253;Couturelle;68;0;68
32;Hauts-de-France;62;5;25;254;Coyecques;606;15;621
32;Hauts-de-France;62;3;22;255;Crémarest;789;15;804
32;Hauts-de-France;62;4;25;256;Crépy;150;2;152
32;Hauts-de-France;62;4;25;257;Créquy;478;10;488
32;Hauts-de-France;62;1;38;258;Croisette;276;5;281
32;Hauts-de-France;62;1;09;259;Croisilles;1950;24;1974
32;Hauts-de-France;62;1;38;260;Croix-en-Ternois;327;3;330
32;Hauts-de-France;62;4;24;261;Cucq;5092;93;5185
32;Hauts-de-France;62;2;23;262;Cuinchy;1746;23;1769
32;Hauts-de-France;62;1;02;263;Dainville;5665;112;5777
32;Hauts-de-France;62;3;36;264;Dannes;1303;4;1307
32;Hauts-de-France;62;5;25;265;Delettes;1179;16;1195
32;Hauts-de-France;62;1;07;266;Denier;87;2;89
32;Hauts-de-France;62;5;25;267;Dennebrœucq;391;6;397
32;Hauts-de-France;62;3;22;268;Desvres;4930;39;4969
32;Hauts-de-France;62;2;05;269;Diéval;742;11;753
32;Hauts-de-France;62;2;05;270;Divion;6977;40;7017
32;Hauts-de-France;62;5;33;271;Dohem;825;17;842
32;Hauts-de-France;62;1;09;272;Douchy-lès-Ayette;311;2;313
32;Hauts-de-France;62;3;22;273;Doudeauville;609;9;618
32;Hauts-de-France;62;7;27;274;Dourges;5935;44;5979
32;Hauts-de-France;62;4;06;275;Douriez;314;7;321
32;Hauts-de-France;62;2;23;276;Douvrin;5544;45;5589
32;Hauts-de-France;62;7;28;277;Drocourt;2924;12;2936
32;Hauts-de-France;62;2;35;278;Drouvin-le-Marais;605;19;624
32;Hauts-de-France;62;1;07;279;Duisans;1323;124;1447
32;Hauts-de-France;62;1;15;280;Dury;339;2;341
32;Hauts-de-France;62;3;14;281;Echinghen;386;6;392
32;Hauts-de-France;62;4;06;282;Éclimeux;179;0;179
32;Hauts-de-France;62;1;38;283;Écoivres;134;0;134
32;Hauts-de-France;62;1;09;284;Écourt-Saint-Quentin;1679;19;1698
32;Hauts-de-France;62;1;09;285;Écoust-Saint-Mein;493;9;502
32;Hauts-de-France;62;2;31;286;Ecquedecques;507;4;511
32;Hauts-de-France;62;5;25;288;Ecques;2152;44;2196
32;Hauts-de-France;62;4;10;289;Écuires;709;21;730
32;Hauts-de-France;62;1;02;290;Écurie;381;7;388
32;Hauts-de-France;62;7;30;291;Éleu-dit-Leauwette;2880;33;2913
32;Hauts-de-France;62;5;33;292;Elnes;894;15;909
32;Hauts-de-France;62;4;25;293;Embry;236;5;241
32;Hauts-de-France;62;5;25;295;Enquin-lez-Guinegatte ;1616;27;1643
32;Hauts-de-France;62;4;33;296;Enquin-sur-Baillons;279;2;281
32;Hauts-de-France;62;5;37;297;Éperlecques;3668;46;3714
32;Hauts-de-France;62;1;09;298;Épinoy;547;10;557
32;Hauts-de-France;62;1;38;299;Eps;249;5;254
32;Hauts-de-France;62;3;36;300;Équihen-Plage;2700;36;2736
32;Hauts-de-France;62;1;38;301;Équirre;80;1;81
32;Hauts-de-France;62;4;33;302;Ergny;233;2;235
32;Hauts-de-France;62;1;38;303;Érin;239;6;245
32;Hauts-de-France;62;5;25;304;Erny-Saint-Julien;328;2;330
32;Hauts-de-France;62;1;09;306;Ervillers;396;3;399
32;Hauts-de-France;62;6;18;307;Escalles;222;9;231
32;Hauts-de-France;62;5;33;308;Escœuilles;479;10;489
32;Hauts-de-France;62;5;33;309;Esquerdes;1627;21;1648
32;Hauts-de-France;62;2;12;310;Essars;1742;19;1761
32;Hauts-de-France;62;7;39;311;Estevelles;2039;10;2049
32;Hauts-de-France;62;4;10;312;Estrée;291;6;297
32;Hauts-de-France;62;2;01;313;Estrée-Blanche;934;6;940
32;Hauts-de-France;62;2;16;314;Estrée-Cauchy;368;2;370
32;Hauts-de-France;62;1;07;316;Estrée-Wamin;184;5;189
32;Hauts-de-France;62;4;10;315;Estréelles;350;9;359
32;Hauts-de-France;62;1;15;317;Étaing;455;3;458
32;Hauts-de-France;62;4;24;318;Étaples;10926;114;11040
32;Hauts-de-France;62;1;15;319;Éterpigny;258;3;261
32;Hauts-de-France;62;1;02;320;Étrun;310;8;318
32;Hauts-de-France;62;7;28;321;Évin-Malmaison;4588;26;4614
32;Hauts-de-France;62;1;07;322;Famechon;117;1;118
32;Hauts-de-France;62;1;03;323;Fampoux;1197;21;1218
32;Hauts-de-France;62;1;03;324;Farbus;577;13;590
32;Hauts-de-France;62;5;25;325;Fauquembergues;972;20;992
32;Hauts-de-France;62;1;09;326;Favreuil;243;5;248
32;Hauts-de-France;62;5;25;327;Febvin-Palfart;604;4;608
32;Hauts-de-France;62;2;31;328;Ferfay;908;10;918
32;Hauts-de-France;62;3;22;329;Ferques;1785;21;1806
32;Hauts-de-France;62;2;23;330;Festubert;1297;24;1321
32;Hauts-de-France;62;1;03;331;Feuchy;1029;20;1049
32;Hauts-de-France;62;1;07;332;Ficheux;516;10;526
32;Hauts-de-France;62;1;38;333;Fiefs;385;6;391
32;Hauts-de-France;62;6;19;334;Fiennes;879;16;895
32;Hauts-de-France;62;4;06;335;Fillièvres;517;5;522
32;Hauts-de-France;62;5;25;336;Fléchin;479;7;486
32;Hauts-de-France;62;1;38;337;Flers;224;5;229
32;Hauts-de-France;62;2;12;338;Fleurbaix;2719;55;2774
32;Hauts-de-France;62;1;38;339;Fleury;116;1;117
32;Hauts-de-France;62;1;38;340;Floringhem;890;7;897
32;Hauts-de-France;62;1;07;341;Foncquevillers;427;8;435
32;Hauts-de-France;62;1;06;345;Fontaine-l'Étalon;100;1;101
32;Hauts-de-France;62;1;38;342;Fontaine-lès-Boulans;103;1;104
32;Hauts-de-France;62;1;09;343;Fontaine-lès-Croisilles;272;2;274
32;Hauts-de-France;62;1;38;344;Fontaine-lès-Hermans;108;3;111
32;Hauts-de-France;62;1;38;346;Fortel-en-Artois;212;4;216
32;Hauts-de-France;62;1;07;347;Fosseux;133;3;136
32;Hauts-de-France;62;1;38;348;Foufflin-Ricametz;163;2;165
32;Hauts-de-France;62;2;35;349;Fouquereuil;1590;22;1612
32;Hauts-de-France;62;2;35;350;Fouquières-lès-Béthune;1045;20;1065
32;Hauts-de-France;62;7;26;351;Fouquières-lès-Lens;6399;38;6437
32;Hauts-de-France;62;1;38;352;Framecourt;106;2;108
32;Hauts-de-France;62;1;09;353;Frémicourt;240;6;246
32;Hauts-de-France;62;4;24;354;Frencq;860;17;877
32;Hauts-de-France;62;1;15;355;Fresnes-lès-Montauban;577;5;582
32;Hauts-de-France;62;2;16;356;Fresnicourt-le-Dolmen;785;8;793
32;Hauts-de-France;62;4;06;357;Fresnoy;69;1;70
32;Hauts-de-France;62;1;15;358;Fresnoy-en-Gohelle;221;6;227
32;Hauts-de-France;62;4;25;359;Fressin;578;13;591
32;Hauts-de-France;62;6;18;360;Fréthun;1355;14;1369
32;Hauts-de-France;62;1;38;361;Frévent;3498;57;3555
32;Hauts-de-France;62;1;07;362;Frévillers;237;3;240
32;Hauts-de-France;62;1;07;363;Frévin-Capelle;383;9;392
32;Hauts-de-France;62;4;25;364;Fruges;2354;242;2596
32;Hauts-de-France;62;4;06;365;Galametz;197;0;197
32;Hauts-de-France;62;2;16;366;Gauchin-Légal;315;7;322
32;Hauts-de-France;62;1;38;367;Gauchin-Verloingt;835;37;872
32;Hauts-de-France;62;1;07;368;Gaudiempré;198;0;198
32;Hauts-de-France;62;1;03;369;Gavrelle;636;14;650
32;Hauts-de-France;62;1;06;370;Gennes-Ivergny;126;1;127
32;Hauts-de-France;62;7;30;371;Givenchy-en-Gohelle;1990;43;2033
32;Hauts-de-France;62;1;07;372;Givenchy-le-Noble;150;3;153
32;Hauts-de-France;62;2;23;373;Givenchy-lès-la-Bassée;1026;11;1037
32;Hauts-de-France;62;1;09;374;Gomiécourt;155;8;163
32;Hauts-de-France;62;1;07;375;Gommecourt;94;1;95
32;Hauts-de-France;62;2;31;376;Gonnehem;2522;38;2560
32;Hauts-de-France;62;2;35;377;Gosnay;955;7;962
32;Hauts-de-France;62;1;07;378;Gouves;197;4;201
32;Hauts-de-France;62;1;07;379;Gouy-en-Artois;328;8;336
32;Hauts-de-France;62;1;38;381;Gouy-en-Ternois;133;2;135
32;Hauts-de-France;62;4;06;382;Gouy-Saint-André;648;13;661
32;Hauts-de-France;62;7;17;380;Gouy-Servins;344;1;345
32;Hauts-de-France;62;1;15;383;Gouy-sous-Bellonne;1373;19;1392
32;Hauts-de-France;62;1;09;384;Graincourt-lès-Havrincourt;642;8;650
32;Hauts-de-France;62;1;07;385;Grand-Rullecourt;397;5;402
32;Hauts-de-France;62;7;39;386;Grenay;6851;32;6883
32;Hauts-de-France;62;1;09;387;Grévillers;364;10;374
32;Hauts-de-France;62;4;06;388;Grigny;296;1;297
32;Hauts-de-France;62;1;07;389;Grincourt-lès-Pas;30;2;32
32;Hauts-de-France;62;4;10;390;Groffliers;1514;44;1558
32;Hauts-de-France;62;2;01;391;Guarbecque;1416;14;1430
32;Hauts-de-France;62;1;04;392;Guémappe;349;8;357
32;Hauts-de-France;62;6;34;393;Guemps;1086;21;1107
32;Hauts-de-France;62;4;06;395;Guigny;137;4;141
32;Hauts-de-France;62;1;38;396;Guinecourt;16;1;17
32;Hauts-de-France;62;6;19;397;Guînes;5619;78;5697
32;Hauts-de-France;62;4;06;398;Guisy;271;12;283
32;Hauts-de-France;62;1;07;399;Habarcq;667;14;681
32;Hauts-de-France;62;2;35;400;Haillicourt;4831;37;4868
32;Hauts-de-France;62;2;23;401;Haisnes;4380;33;4413
32;Hauts-de-France;62;3;22;402;Halinghen;319;6;325
32;Hauts-de-France;62;5;32;403;Hallines;1200;15;1215
32;Hauts-de-France;62;1;07;404;Halloy;210;2;212
32;Hauts-de-France;62;2;31;407;Ham-en-Artois;976;13;989
32;Hauts-de-France;62;1;15;405;Hamblain-les-Prés;493;10;503
32;Hauts-de-France;62;1;09;406;Hamelincourt;259;8;267
32;Hauts-de-France;62;6;18;408;Hames-Boucres;1463;18;1481
32;Hauts-de-France;62;1;07;409;Hannescamps;194;3;197
32;Hauts-de-France;62;1;09;410;Haplincourt;182;6;188
32;Hauts-de-France;62;1;06;411;Haravesnes;51;0;51
32;Hauts-de-France;62;6;19;412;Hardinghen;1215;6;1221
32;Hauts-de-France;62;7;26;413;Harnes;12324;94;12418
32;Hauts-de-France;62;1;15;414;Haucourt;229;2;231
32;Hauts-de-France;62;5;33;419;Haut-Loquin;182;1;183
32;Hauts-de-France;62;1;07;415;Haute-Avesnes;440;9;449
32;Hauts-de-France;62;1;38;416;Hautecloque;217;1;218
32;Hauts-de-France;62;1;07;418;Hauteville;314;8;322
32;Hauts-de-France;62;1;09;421;Havrincourt;403;11;414
32;Hauts-de-France;62;1;07;422;Hébuterne;522;6;528
32;Hauts-de-France;62;5;32;423;Helfaut;1714;30;1744
32;Hauts-de-France;62;1;15;424;Hendecourt-lès-Cagnicourt;314;11;325
32;Hauts-de-France;62;1;07;425;Hendecourt-lès-Ransart;136;4;140
32;Hauts-de-France;62;7;99;427;Hénin-Beaumont;25917;372;26289
32;Hauts-de-France;62;1;04;428;Hénin-sur-Cojeul;523;7;530
32;Hauts-de-France;62;1;04;426;Héninel;180;2;182
32;Hauts-de-France;62;3;22;429;Henneveux;293;4;297
32;Hauts-de-France;62;1;07;430;Hénu;165;2;167
32;Hauts-de-France;62;6;19;432;Herbinghen;388;8;396
32;Hauts-de-France;62;1;38;433;Héricourt;91;7;98
32;Hauts-de-France;62;1;07;434;La Herlière;145;5;150
32;Hauts-de-France;62;1;38;436;Herlin-le-Sec;166;3;169
32;Hauts-de-France;62;1;38;435;Herlincourt;105;1;106
32;Hauts-de-France;62;4;33;437;Herly;305;7;312
32;Hauts-de-France;62;1;07;438;Hermaville;535;8;543
32;Hauts-de-France;62;6;19;439;Hermelinghen;426;3;429
32;Hauts-de-France;62;1;09;440;Hermies;1204;21;1225
32;Hauts-de-France;62;2;16;441;Hermin;212;2;214
32;Hauts-de-France;62;1;38;442;Hernicourt;565;5;570
32;Hauts-de-France;62;2;35;443;Hersin-Coupigny;6263;42;6305
32;Hauts-de-France;62;3;22;444;Hervelinghen;230;6;236
32;Hauts-de-France;62;2;35;445;Hesdigneul-lès-Béthune;823;17;840
32;Hauts-de-France;62;3;36;446;Hesdigneul-lès-Boulogne;688;21;709
32;Hauts-de-France;62;4;06;447;Hesdin;2219;14;2233
32;Hauts-de-France;62;3;36;448;Hesdin-l'Abbé;1911;28;1939
32;Hauts-de-France;62;4;06;449;Hesmond;160;6;166
32;Hauts-de-France;62;1;38;450;Hestrus;237;6;243
32;Hauts-de-France;62;1;38;451;Heuchin;514;10;524
32;Hauts-de-France;62;5;25;452;Heuringhem;1350;36;1386
32;Hauts-de-France;62;4;25;453;Hézecques;124;3;127
32;Hauts-de-France;62;2;12;454;Hinges;2426;47;2473
32;Hauts-de-France;62;6;19;455;Hocquinghen;111;1;112
32;Hauts-de-France;62;2;35;456;Houchin;716;12;728
32;Hauts-de-France;62;2;16;457;Houdain;7178;58;7236
32;Hauts-de-France;62;5;37;458;Houlle;1137;13;1150
32;Hauts-de-France;62;1;07;459;Houvin-Houvigneul;235;4;239
32;Hauts-de-France;62;4;10;460;Hubersent;269;7;276
32;Hauts-de-France;62;4;06;461;Huby-Saint-Leu;886;10;896
32;Hauts-de-France;62;1;38;462;Huclier;140;5;145
32;Hauts-de-France;62;4;33;463;Hucqueliers;451;37;488
32;Hauts-de-France;62;7;39;464;Hulluch;3429;18;3447
32;Hauts-de-France;62;1;07;465;Humbercamps;219;0;219
32;Hauts-de-France;62;4;33;466;Humbert;232;1;233
32;Hauts-de-France;62;1;38;467;Humerœuille;178;0;178
32;Hauts-de-France;62;1;38;468;Humières;224;2;226
32;Hauts-de-France;62;1;09;469;Inchy-en-Artois;609;7;616
32;Hauts-de-France;62;4;06;470;Incourt;86;0;86
32;Hauts-de-France;62;4;10;472;Inxent;162;6;168
32;Hauts-de-France;62;2;01;473;Isbergues;8745;78;8823
32;Hauts-de-France;62;3;36;474;Isques;1156;21;1177
32;Hauts-de-France;62;1;07;475;Ivergny;254;3;257
32;Hauts-de-France;62;1;15;476;Izel-lès-Équerchin;1037;11;1048
32;Hauts-de-France;62;1;07;477;Izel-lès-Hameau;728;17;745
32;Hauts-de-France;62;5;33;478;Journy;283;5;288
32;Hauts-de-France;62;2;11;479;Labeuvrière;1645;14;1659
32;Hauts-de-France;62;2;35;480;Labourse;2878;22;2900
32;Hauts-de-France;62;4;06;481;Labroye;159;3;162
32;Hauts-de-France;62;3;22;483;Lacres;247;2;249
32;Hauts-de-France;62;1;09;484;Lagnicourt-Marcel;327;6;333
32;Hauts-de-France;62;5;25;485;Laires;368;1;369
32;Hauts-de-France;62;2;01;486;Lambres;1059;14;1073
32;Hauts-de-France;62;3;22;487;Landrethun-le-Nord;1283;23;1306
32;Hauts-de-France;62;6;19;488;Landrethun-lès-Ardres;760;20;780
32;Hauts-de-France;62;2;11;489;Lapugnoy;3467;29;3496
32;Hauts-de-France;62;1;07;490;Lattre-Saint-Quentin;268;3;271
32;Hauts-de-France;62;2;12;491;Laventie;5000;83;5083
32;Hauts-de-France;62;4;25;492;Lebiez;247;3;250
32;Hauts-de-France;62;1;09;493;Lebucquière;234;4;238
32;Hauts-de-France;62;1;09;494;Léchelle;48;1;49
32;Hauts-de-France;62;5;33;495;Ledinghem;334;6;340
32;Hauts-de-France;62;4;24;496;Lefaux;236;6;242
32;Hauts-de-France;62;7;28;497;Leforest;7232;50;7282
32;Hauts-de-France;62;7;29;498;Lens;31606;192;31798
32;Hauts-de-France;62;4;10;499;Lépine;280;8;288
32;Hauts-de-France;62;2;31;500;Lespesses;405;3;408
32;Hauts-de-France;62;4;06;501;Lespinoy;221;2;223
32;Hauts-de-France;62;2;31;502;Lestrem;4610;72;4682
32;Hauts-de-France;62;3;22;503;Leubringhen;294;6;300
32;Hauts-de-France;62;5;33;504;Leulinghem;252;7;259
32;Hauts-de-France;62;3;22;505;Leulinghen-Bernes;484;9;493
32;Hauts-de-France;62;7;21;907;Libercourt;8337;40;8377
32;Hauts-de-France;62;6;19;506;Licques;1631;20;1651
32;Hauts-de-France;62;1;07;507;Liencourt;293;6;299
32;Hauts-de-France;62;2;31;508;Lières;380;10;390
32;Hauts-de-France;62;2;01;509;Liettres;331;5;336
32;Hauts-de-France;62;7;30;510;Liévin;30423;366;30789
32;Hauts-de-France;62;1;07;511;Lignereuil;139;1;140
32;Hauts-de-France;62;2;01;512;Ligny-lès-Aire;582;15;597
32;Hauts-de-France;62;1;38;514;Ligny-Saint-Flochel;248;3;251
32;Hauts-de-France;62;1;38;513;Ligny-sur-Canche;192;6;198
32;Hauts-de-France;62;1;09;515;Ligny-Thilloy;523;17;540
32;Hauts-de-France;62;2;31;516;Lillers;9910;89;9999
32;Hauts-de-France;62;2;01;517;Linghem;200;6;206
32;Hauts-de-France;62;1;38;518;Linzeux;159;1;160
32;Hauts-de-France;62;1;38;519;Lisbourg;600;8;608
32;Hauts-de-France;62;2;12;520;Locon;2430;59;2489
32;Hauts-de-France;62;4;06;521;La Loge;204;4;208
32;Hauts-de-France;62;7;29;523;Loison-sous-Lens;5379;52;5431
32;Hauts-de-France;62;4;06;522;Loison-sur-Créquoise;269;3;272
32;Hauts-de-France;62;3;22;524;Longfossé;1469;18;1487
32;Hauts-de-France;62;5;32;525;Longuenesse;10736;546;11282
32;Hauts-de-France;62;3;22;526;Longueville;141;2;143
32;Hauts-de-France;62;4;24;527;Longvilliers;250;6;256
32;Hauts-de-France;62;7;39;528;Loos-en-Gohelle;6855;62;6917
32;Hauts-de-France;62;2;23;529;Lorgies;1572;18;1590
32;Hauts-de-France;62;3;22;530;Lottinghen;540;9;549
32;Hauts-de-France;62;6;19;531;Louches;955;19;974
32;Hauts-de-France;62;2;05;532;Lozinghem;1273;13;1286
32;Hauts-de-France;62;4;25;533;Lugy;146;3;149
32;Hauts-de-France;62;5;33;534;Lumbres;3607;74;3681
32;Hauts-de-France;62;4;10;535;La Madelaine-sous-Montreuil;158;8;166
32;Hauts-de-France;62;1;07;536;Magnicourt-en-Comte;646;5;651
32;Hauts-de-France;62;1;07;537;Magnicourt-sur-Canche;112;4;116
32;Hauts-de-France;62;4;06;538;Maintenay;436;9;445
32;Hauts-de-France;62;1;38;539;Maisnil;242;3;245
32;Hauts-de-France;62;2;16;540;Maisnil-lès-Ruitz;1696;15;1711
32;Hauts-de-France;62;4;06;541;Maisoncelle;123;4;127
32;Hauts-de-France;62;1;07;542;Maizières;195;4;199
32;Hauts-de-France;62;5;25;543;Mametz;2002;32;2034
32;Hauts-de-France;62;1;07;544;Manin;184;1;185
32;Hauts-de-France;62;4;33;545;Maninghem;149;0;149
32;Hauts-de-France;62;3;22;546;Maninghen-Henne;304;16;320
32;Hauts-de-France;62;4;06;547;Marant;64;1;65
32;Hauts-de-France;62;6;34;548;Marck;10649;126;10775
32;Hauts-de-France;62;4;06;549;Marconne;1082;64;1146
32;Hauts-de-France;62;4;06;550;Marconnelle;1116;20;1136
32;Hauts-de-France;62;4;06;551;Marenla;238;2;240
32;Hauts-de-France;62;4;06;552;Maresquel-Ecquemicourt;1008;8;1016
32;Hauts-de-France;62;1;38;553;Marest;283;6;289
32;Hauts-de-France;62;4;24;554;Maresville;103;0;103
32;Hauts-de-France;62;2;05;555;Marles-les-Mines;5561;26;5587
32;Hauts-de-France;62;4;06;556;Marles-sur-Canche;304;4;308
32;Hauts-de-France;62;1;38;558;Marquay;176;1;177
32;Hauts-de-France;62;1;09;559;Marquion;972;14;986
32;Hauts-de-France;62;3;22;560;Marquise;5064;60;5124
32;Hauts-de-France;62;1;09;561;Martinpuich;196;1;197
32;Hauts-de-France;62;1;02;557;Marœuil;2461;55;2516
32;Hauts-de-France;62;4;25;562;Matringhem;180;3;183
32;Hauts-de-France;62;7;17;563;Mazingarbe;8036;42;8078
32;Hauts-de-France;62;2;01;564;Mazinghem;471;9;480
32;Hauts-de-France;62;4;25;565;Mencas;77;0;77
32;Hauts-de-France;62;3;22;566;Menneville;685;17;702
32;Hauts-de-France;62;5;37;567;Mentque-Nortbécourt;644;9;653
32;Hauts-de-France;62;1;04;568;Mercatel;707;10;717
32;Hauts-de-France;62;5;25;569;Merck-Saint-Liévin;659;6;665
32;Hauts-de-France;62;7;08;570;Méricourt;11346;69;11415
32;Hauts-de-France;62;4;24;571;Merlimont;3374;69;3443
32;Hauts-de-France;62;1;09;572;Metz-en-Couture;644;10;654
32;Hauts-de-France;62;7;39;573;Meurchin;3767;23;3790
32;Hauts-de-France;62;1;07;574;Mingoval;231;5;236
32;Hauts-de-France;62;1;38;576;Moncheaux-lès-Frévent;141;0;141
32;Hauts-de-France;62;1;38;577;Monchel-sur-Canche;85;2;87
32;Hauts-de-France;62;1;07;578;Monchiet;96;2;98
32;Hauts-de-France;62;1;07;579;Monchy-au-Bois;556;5;561
32;Hauts-de-France;62;1;38;580;Monchy-Breton;497;11;508
32;Hauts-de-France;62;1;38;581;Monchy-Cayeux;298;3;301
32;Hauts-de-France;62;1;03;582;Monchy-le-Preux;649;38;687
32;Hauts-de-France;62;1;07;583;Mondicourt;575;9;584
32;Hauts-de-France;62;2;31;584;Mont-Bernanchon;1348;33;1381
32;Hauts-de-France;62;1;02;589;Mont-Saint-Éloi;1019;20;1039
32;Hauts-de-France;62;4;10;585;Montcavrel;406;5;411
32;Hauts-de-France;62;1;07;586;Montenescourt;455;5;460
32;Hauts-de-France;62;7;27;587;Montigny-en-Gohelle;10315;54;10369
32;Hauts-de-France;62;4;10;588;Montreuil;1952;124;2076
32;Hauts-de-France;62;1;38;590;Monts-en-Ternois;62;0;62
32;Hauts-de-France;62;1;09;591;Morchies;209;5;214
32;Hauts-de-France;62;5;37;592;Moringhem;557;12;569
32;Hauts-de-France;62;1;09;593;Morval;92;0;92
32;Hauts-de-France;62;1;09;594;Mory;307;3;310
32;Hauts-de-France;62;5;37;595;Moulle;1124;29;1153
32;Hauts-de-France;62;4;06;596;Mouriez;246;5;251
32;Hauts-de-France;62;1;09;597;Moyenneville;277;3;280
32;Hauts-de-France;62;6;34;598;Muncq-Nieurlet;734;7;741
32;Hauts-de-France;62;3;22;599;Nabringhen;217;7;224
32;Hauts-de-France;62;1;38;600;Nédon;151;3;154
32;Hauts-de-France;62;1;38;601;Nédonchel;316;5;321
32;Hauts-de-France;62;4;10;602;Nempont-Saint-Firmin;200;2;202
32;Hauts-de-France;62;3;36;603;Nesles;991;7;998
32;Hauts-de-France;62;3;36;604;Neufchâtel-Hardelot;3744;71;3815
32;Hauts-de-France;62;4;06;605;Neulette;28;0;28
32;Hauts-de-France;62;2;12;606;Neuve-Chapelle;1445;12;1457
32;Hauts-de-France;62;1;38;607;Neuville-au-Cornet;69;3;72
32;Hauts-de-France;62;1;09;608;Neuville-Bourjonval;168;1;169
32;Hauts-de-France;62;1;02;609;Neuville-Saint-Vaast;1549;36;1585
32;Hauts-de-France;62;4;10;610;Neuville-sous-Montreuil;646;9;655
32;Hauts-de-France;62;1;04;611;Neuville-Vitasse;499;8;507
32;Hauts-de-France;62;1;15;612;Neuvireuil;580;12;592
32;Hauts-de-France;62;6;19;614;Nielles-lès-Ardres;569;14;583
32;Hauts-de-France;62;5;33;613;Nielles-lès-Bléquin;869;9;878
32;Hauts-de-France;62;6;18;615;Nielles-lès-Calais;288;5;293
32;Hauts-de-France;62;5;37;618;Nordausques;1310;14;1324
32;Hauts-de-France;62;1;09;619;Noreuil;154;2;156
32;Hauts-de-France;62;2;31;620;Norrent-Fontes;1387;22;1409
32;Hauts-de-France;62;5;37;622;Nort-Leulinghem;250;3;253
32;Hauts-de-France;62;6;34;621;Nortkerque;1656;29;1685
32;Hauts-de-France;62;6;34;623;Nouvelle-Église;688;8;696
32;Hauts-de-France;62;1;07;630;Noyelle-Vion;294;5;299
32;Hauts-de-France;62;7;28;624;Noyelles-Godault;5828;33;5861
32;Hauts-de-France;62;4;06;625;Noyelles-lès-Humières;55;2;57
32;Hauts-de-France;62;2;23;626;Noyelles-lès-Vermelles;2362;20;2382
32;Hauts-de-France;62;1;15;627;Noyelles-sous-Bellonne;818;20;838
32;Hauts-de-France;62;7;26;628;Noyelles-sous-Lens;6646;47;6693
32;Hauts-de-France;62;1;07;629;Noyellette;169;1;170
32;Hauts-de-France;62;1;38;631;Nuncq-Hautecôte;490;8;498
32;Hauts-de-France;62;1;06;616;Nœux-lès-Auxi;180;2;182
32;Hauts-de-France;62;2;35;617;Nœux-les-Mines;11813;70;11883
32;Hauts-de-France;62;2;11;632;Oblinghem;380;6;386
32;Hauts-de-France;62;6;34;634;Offekerque;1172;19;1191
32;Hauts-de-France;62;4;06;635;Offin;204;2;206
32;Hauts-de-France;62;3;22;636;Offrethun;259;13;272
32;Hauts-de-France;62;7;27;637;Oignies;9841;48;9889
32;Hauts-de-France;62;1;09;638;Oisy-le-Verger;1208;14;1222
32;Hauts-de-France;62;1;15;639;Oppy;394;9;403
32;Hauts-de-France;62;1;07;640;Orville;391;1;392
32;Hauts-de-France;62;1;38;641;Ostreville;225;3;228
32;Hauts-de-France;62;2;05;642;Ourton;767;9;776
32;Hauts-de-France;62;3;36;643;Outreau;13575;173;13748
32;Hauts-de-France;62;5;33;644;Ouve-Wirquin;504;7;511
32;Hauts-de-France;62;6;34;645;Oye-Plage;5478;83;5561
32;Hauts-de-France;62;1;09;646;Palluel;566;7;573
32;Hauts-de-France;62;4;06;647;Le Parcq;760;15;775
32;Hauts-de-France;62;4;33;648;Parenty;516;11;527
32;Hauts-de-France;62;1;07;649;Pas-en-Artois;762;10;772
32;Hauts-de-France;62;1;15;650;Pelves;751;8;759
32;Hauts-de-France;62;1;07;651;Penin;480;6;486
32;Hauts-de-France;62;1;38;652;Pernes;1659;30;1689
32;Hauts-de-France;62;3;13;653;Pernes-lès-Boulogne;425;19;444
32;Hauts-de-France;62;6;18;654;Peuplingues;782;11;793
32;Hauts-de-France;62;1;38;655;Pierremont;301;7;308
32;Hauts-de-France;62;5;33;656;Pihem;948;27;975
32;Hauts-de-France;62;6;18;657;Pihen-lès-Guînes;498;7;505
32;Hauts-de-France;62;3;13;658;Pittefaux;122;9;131
32;Hauts-de-France;62;4;25;659;Planques;88;3;91
32;Hauts-de-France;62;1;15;660;Plouvain;457;7;464
32;Hauts-de-France;62;6;34;662;Polincove;859;21;880
32;Hauts-de-France;62;1;07;663;Pommera;307;4;311
32;Hauts-de-France;62;1;07;664;Pommier;235;5;240
32;Hauts-de-France;62;1;06;665;Le Ponchel;211;6;217
32;Hauts-de-France;62;7;39;666;Pont-à-Vendin;3167;17;3184
32;Hauts-de-France;62;3;14;667;Le Portel;9157;111;9268
32;Hauts-de-France;62;1;38;668;Prédefin;191;2;193
32;Hauts-de-France;62;1;38;669;Pressy;317;5;322
32;Hauts-de-France;62;4;33;670;Preures;612;7;619
32;Hauts-de-France;62;1;09;671;Pronville-en-Artois;321;4;325
32;Hauts-de-France;62;1;07;672;Puisieux;654;5;659
32;Hauts-de-France;62;1;09;673;Quéant;653;8;661
32;Hauts-de-France;62;5;33;674;Quelmes;565;19;584
32;Hauts-de-France;62;5;33;675;Quercamps;272;2;274
32;Hauts-de-France;62;2;01;676;Quernes;453;7;460
32;Hauts-de-France;62;4;06;677;Le Quesnoy-en-Artois;348;5;353
32;Hauts-de-France;62;3;22;678;Quesques;681;3;684
32;Hauts-de-France;62;3;22;679;Questrecques;313;8;321
32;Hauts-de-France;62;1;15;680;Quiéry-la-Motte;733;13;746
32;Hauts-de-France;62;5;25;681;Quiestède;621;23;644
32;Hauts-de-France;62;4;33;682;Quilen;62;0;62
32;Hauts-de-France;62;1;06;683;Quœux-Haut-Maînil;247;3;250
32;Hauts-de-France;62;5;25;684;Racquinghem;2255;32;2287
32;Hauts-de-France;62;4;25;685;Radinghem;273;163;436
32;Hauts-de-France;62;1;38;686;Ramecourt;371;6;377
32;Hauts-de-France;62;4;10;688;Rang-du-Fliers;4224;115;4339
32;Hauts-de-France;62;1;07;689;Ransart;396;2;398
32;Hauts-de-France;62;4;06;690;Raye-sur-Authie;244;7;251
32;Hauts-de-France;62;5;33;692;Rebergues;371;4;375
32;Hauts-de-France;62;2;16;693;Rebreuve-Ranchicourt;1078;22;1100
32;Hauts-de-France;62;1;07;694;Rebreuve-sur-Canche;191;2;193
32;Hauts-de-France;62;1;07;695;Rebreuviette;266;2;268
32;Hauts-de-France;62;5;25;696;Reclinghem;236;3;239
32;Hauts-de-France;62;1;15;697;Récourt;209;0;209
32;Hauts-de-France;62;4;10;698;Recques-sur-Course;275;5;280
32;Hauts-de-France;62;6;34;699;Recques-sur-Hem;640;13;653
32;Hauts-de-France;62;4;06;700;Regnauville;214;1;215
32;Hauts-de-France;62;2;01;701;Rely;452;2;454
32;Hauts-de-France;62;5;33;702;Remilly-Wirquin;355;6;361
32;Hauts-de-France;62;1;15;703;Rémy;389;3;392
32;Hauts-de-France;62;5;25;704;Renty;603;18;621
32;Hauts-de-France;62;3;22;705;Rety;2100;16;2116
32;Hauts-de-France;62;2;12;706;Richebourg;2638;57;2695
32;Hauts-de-France;62;1;09;708;Riencourt-lès-Bapaume;33;1;34
32;Hauts-de-France;62;1;15;709;Riencourt-lès-Cagnicourt;258;5;263
32;Hauts-de-France;62;4;25;710;Rimboval;156;3;159
32;Hauts-de-France;62;3;22;711;Rinxent;3015;30;3045
32;Hauts-de-France;62;1;07;712;Rivière;1121;29;1150
32;Hauts-de-France;62;2;31;713;Robecq;1351;23;1374
32;Hauts-de-France;62;1;02;714;Roclincourt;792;18;810
32;Hauts-de-France;62;1;09;715;Rocquigny;286;0;286
32;Hauts-de-France;62;6;19;716;Rodelinghem;520;6;526
32;Hauts-de-France;62;1;38;717;Roëllecourt;537;10;547
32;Hauts-de-France;62;4;06;719;Rollancourt;294;37;331
32;Hauts-de-France;62;2;01;720;Rombly;45;2;47
32;Hauts-de-France;62;5;01;721;Roquetoire;1940;49;1989
32;Hauts-de-France;62;1;06;722;Rougefay;87;3;90
32;Hauts-de-France;62;4;06;723;Roussent;240;1;241
32;Hauts-de-France;62;7;26;724;Rouvroy;8912;36;8948
32;Hauts-de-France;62;4;25;725;Royon;136;0;136
32;Hauts-de-France;62;4;25;726;Ruisseauville;201;5;206
32;Hauts-de-France;62;2;35;727;Ruitz;1562;24;1586
32;Hauts-de-France;62;1;09;728;Rumaucourt;684;11;695
32;Hauts-de-France;62;4;33;729;Rumilly;254;6;260
32;Hauts-de-France;62;6;34;730;Ruminghem;1641;22;1663
32;Hauts-de-France;62;1;09;731;Ruyaulcourt;290;3;293
32;Hauts-de-France;62;1;15;718;Rœux;1430;22;1452
32;Hauts-de-France;62;1;38;732;Sachin;338;2;340
32;Hauts-de-France;62;1;07;733;Sailly-au-Bois;308;2;310
32;Hauts-de-France;62;1;15;734;Sailly-en-Ostrevent;705;8;713
32;Hauts-de-France;62;2;23;735;Sailly-Labourse;2377;17;2394
32;Hauts-de-France;62;2;12;736;Sailly-sur-la-Lys;3946;72;4018
32;Hauts-de-France;62;7;17;737;Sains-en-Gohelle;6077;34;6111
32;Hauts-de-France;62;4;25;738;Sains-lès-Fressin;160;4;164
32;Hauts-de-France;62;1;09;739;Sains-lès-Marquion;325;3;328
32;Hauts-de-France;62;1;38;740;Sains-lès-Pernes;300;9;309
32;Hauts-de-France;62;1;07;741;Saint-Amand;120;3;123
32;Hauts-de-France;62;4;24;742;Saint-Aubin;267;6;273
32;Hauts-de-France;62;5;25;691;Saint-Augustin;803;13;816
32;Hauts-de-France;62;4;06;745;Saint-Denœux;157;1;158
32;Hauts-de-France;62;3;36;746;Saint-Étienne-au-Mont;5118;64;5182
32;Hauts-de-France;62;2;31;747;Saint-Floris;605;16;621
32;Hauts-de-France;62;6;34;748;Saint-Folquin;2303;41;2344
32;Hauts-de-France;62;4;06;749;Saint-Georges;331;6;337
32;Hauts-de-France;62;2;01;750;Saint-Hilaire-Cottes;806;9;815
32;Hauts-de-France;62;3;22;751;Saint-Inglevert;791;9;800
32;Hauts-de-France;62;4;24;752;Saint-Josse;1128;26;1154
32;Hauts-de-France;62;1;03;753;Saint-Laurent-Blangy;6575;65;6640
32;Hauts-de-France;62;1;09;754;Saint-Léger;462;4;466
32;Hauts-de-France;62;3;36;755;Saint-Léonard;3394;51;3445
32;Hauts-de-France;62;3;14;758;Saint-Martin-Boulogne;11226;186;11412
32;Hauts-de-France;62;3;22;759;Saint-Martin-Choquel;474;8;482
32;Hauts-de-France;62;5;25;760;Saint-Martin-d'Hardinghem;282;7;289
32;Hauts-de-France;62;5;37;757;Saint-Martin-lez-Tatinghem;5914;134;6048
32;Hauts-de-France;62;1;04;761;Saint-Martin-sur-Cojeul;210;4;214
32;Hauts-de-France;62;4;33;762;Saint-Michel-sous-Bois;120;5;125
32;Hauts-de-France;62;1;38;763;Saint-Michel-sur-Ternoise;871;16;887
32;Hauts-de-France;62;1;03;764;Saint-Nicolas;4724;53;4777
32;Hauts-de-France;62;5;37;765;Saint-Omer;14726;653;15379
32;Hauts-de-France;62;6;34;766;Saint-Omer-Capelle;1105;12;1117
32;Hauts-de-France;62;1;38;767;Saint-Pol-sur-Ternoise;4942;161;5103
32;Hauts-de-France;62;4;06;768;Saint-Rémy-au-Bois;103;2;105
32;Hauts-de-France;62;6;18;769;Saint-Tricat;757;14;771
32;Hauts-de-France;62;2;31;770;Saint-Venant;3036;86;3122
32;Hauts-de-France;62;4;06;743;Sainte-Austreberthe;394;8;402
32;Hauts-de-France;62;1;02;744;Sainte-Catherine;3503;57;3560
32;Hauts-de-France;62;6;34;756;Sainte-Marie-Kerque;1653;30;1683
32;Hauts-de-France;62;7;08;771;Sallaumines;9654;41;9695
32;Hauts-de-France;62;5;37;772;Salperwick;485;25;510
32;Hauts-de-France;62;3;22;773;Samer;4611;146;4757
32;Hauts-de-France;62;6;18;774;Sangatte;4852;128;4980
32;Hauts-de-France;62;6;19;775;Sanghen;341;2;343
32;Hauts-de-France;62;1;09;776;Sapignies;195;4;199
32;Hauts-de-France;62;1;09;777;Le Sars;173;1;174
32;Hauts-de-France;62;1;07;778;Sars-le-Bois;80;1;81
32;Hauts-de-France;62;1;07;779;Sarton;184;1;185
32;Hauts-de-France;62;1;09;780;Sauchy-Cauchy;361;3;364
32;Hauts-de-France;62;1;09;781;Sauchy-Lestrée;457;3;460
32;Hauts-de-France;62;1;15;782;Saudemont;444;8;452
32;Hauts-de-France;62;4;06;783;Saulchoy;317;5;322
32;Hauts-de-France;62;1;07;784;Saulty;770;12;782
32;Hauts-de-France;62;1;07;785;Savy-Berlette;900;185;1085
32;Hauts-de-France;62;3;22;786;Selles;331;3;334
32;Hauts-de-France;62;4;06;787;Sempy;321;3;324
32;Hauts-de-France;62;5;33;788;Seninghem;708;16;724
32;Hauts-de-France;62;3;22;789;Senlecques;272;1;273
32;Hauts-de-France;62;4;25;790;Senlis;162;4;166
32;Hauts-de-France;62;1;38;791;Séricourt;52;0;52
32;Hauts-de-France;62;5;37;792;Serques;1149;32;1181
32;Hauts-de-France;62;7;17;793;Servins;1106;19;1125
32;Hauts-de-France;62;5;33;794;Setques;602;11;613
32;Hauts-de-France;62;1;38;795;Sibiville;111;2;113
32;Hauts-de-France;62;1;07;796;Simencourt;557;12;569
32;Hauts-de-France;62;1;38;797;Siracourt;266;3;269
32;Hauts-de-France;62;1;07;798;Sombrin;239;7;246
32;Hauts-de-France;62;4;10;799;Sorrus;849;26;875
32;Hauts-de-France;62;1;07;800;Souastre;376;3;379
32;Hauts-de-France;62;7;17;801;Souchez;2545;48;2593
32;Hauts-de-France;62;1;07;802;Le Souich;164;2;166
32;Hauts-de-France;62;5;33;803;Surques;636;5;641
32;Hauts-de-France;62;1;07;804;Sus-Saint-Léger;372;5;377
32;Hauts-de-France;62;1;38;805;Tangry;264;1;265
32;Hauts-de-France;62;3;22;806;Tardinghen;152;4;156
32;Hauts-de-France;62;1;38;808;Teneur;257;0;257
32;Hauts-de-France;62;1;38;809;Ternas;137;3;140
32;Hauts-de-France;62;1;03;810;Thélus;1207;36;1243
32;Hauts-de-France;62;5;25;811;Thérouanne;1095;25;1120
32;Hauts-de-France;62;5;25;812;Thiembronne;819;7;826
32;Hauts-de-France;62;1;38;813;La Thieuloye;499;2;501
32;Hauts-de-France;62;1;07;814;Thièvres;112;1;113
32;Hauts-de-France;62;4;10;815;Tigny-Noyelle;174;0;174
32;Hauts-de-France;62;1;07;816;Tilloy-lès-Hermaville;221;5;226
32;Hauts-de-France;62;1;04;817;Tilloy-lès-Mofflaines;1413;119;1532
32;Hauts-de-France;62;1;38;818;Tilly-Capelle;157;1;158
32;Hauts-de-France;62;5;37;819;Tilques;1092;30;1122
32;Hauts-de-France;62;1;07;820;Tincques;820;19;839
32;Hauts-de-France;62;3;22;821;Tingry;292;7;299
32;Hauts-de-France;62;1;06;822;Tollent;92;3;95
32;Hauts-de-France;62;4;25;823;Torcy;169;5;174
32;Hauts-de-France;62;4;06;824;Tortefontaine;218;5;223
32;Hauts-de-France;62;1;15;825;Tortequesne;836;8;844
32;Hauts-de-France;62;4;24;826;Le Touquet-Paris-Plage;4229;255;4484
32;Hauts-de-France;62;5;37;827;Tournehem-sur-la-Hem;1418;17;1435
32;Hauts-de-France;62;4;06;828;Tramecourt;60;0;60
32;Hauts-de-France;62;1;09;829;Le Transloy;421;3;424
32;Hauts-de-France;62;1;09;830;Trescault;177;2;179
32;Hauts-de-France;62;1;38;831;Troisvaux;274;7;281
32;Hauts-de-France;62;4;24;832;Tubersent;550;17;567
32;Hauts-de-France;62;1;38;833;Vacquerie-le-Boucq;79;2;81
32;Hauts-de-France;62;4;06;834;Vacqueriette-Erquières;250;4;254
32;Hauts-de-France;62;1;38;835;Valhuon;562;19;581
32;Hauts-de-France;62;2;35;836;Vaudricourt;1006;27;1033
32;Hauts-de-France;62;5;33;837;Vaudringhem;519;8;527
32;Hauts-de-France;62;1;06;838;Vaulx;90;3;93
32;Hauts-de-France;62;1;09;839;Vaulx-Vraucourt;1017;9;1026
32;Hauts-de-France;62;1;09;840;Vélu;134;0;134
32;Hauts-de-France;62;7;39;842;Vendin-le-Vieil;8543;44;8587
32;Hauts-de-France;62;2;11;841;Vendin-lès-Béthune;2452;24;2476
32;Hauts-de-France;62;4;25;843;Verchin;238;2;240
32;Hauts-de-France;62;4;33;844;Verchocq;630;14;644
32;Hauts-de-France;62;3;22;845;Verlincthun;463;4;467
32;Hauts-de-France;62;2;23;846;Vermelles;4741;41;4782
32;Hauts-de-France;62;2;12;847;Verquigneul;1974;24;1998
32;Hauts-de-France;62;2;12;848;Verquin;3476;34;3510
32;Hauts-de-France;62;4;10;849;Verton;2472;53;2525
32;Hauts-de-France;62;4;06;850;Vieil-Hesdin;345;6;351
32;Hauts-de-France;62;3;22;853;Vieil-Moutier;384;10;394
32;Hauts-de-France;62;2;12;851;Vieille-Chapelle;784;18;802
32;Hauts-de-France;62;6;34;852;Vieille-Église;1400;11;1411
32;Hauts-de-France;62;7;17;854;Villers-au-Bois;583;10;593
32;Hauts-de-France;62;1;09;855;Villers-au-Flos;263;1;264
32;Hauts-de-France;62;1;07;856;Villers-Brûlin;364;4;368
32;Hauts-de-France;62;1;07;857;Villers-Châtel;130;9;139
32;Hauts-de-France;62;1;06;859;Villers-l'Hôpital;263;4;267
32;Hauts-de-France;62;1;15;858;Villers-lès-Cagnicourt;260;5;265
32;Hauts-de-France;62;1;07;860;Villers-Sir-Simon;118;3;121
32;Hauts-de-France;62;7;30;861;Vimy;4250;76;4326
32;Hauts-de-France;62;4;25;862;Vincly;161;3;164
32;Hauts-de-France;62;2;23;863;Violaines;3720;33;3753
32;Hauts-de-France;62;1;15;864;Vis-en-Artois;651;15;666
32;Hauts-de-France;62;1;15;865;Vitry-en-Artois;4676;51;4727
32;Hauts-de-France;62;4;10;866;Waben;433;15;448
32;Hauts-de-France;62;3;22;867;Wacquinghen;265;7;272
32;Hauts-de-France;62;4;06;868;Wail;261;6;267
32;Hauts-de-France;62;1;02;869;Wailly;1091;32;1123
32;Hauts-de-France;62;4;10;870;Wailly-Beaucamp;1017;23;1040
32;Hauts-de-France;62;4;06;871;Wambercourt;250;1;251
32;Hauts-de-France;62;4;06;872;Wamin;235;5;240
32;Hauts-de-France;62;1;04;873;Wancourt;644;10;654
32;Hauts-de-France;62;1;07;874;Wanquetin;720;15;735
32;Hauts-de-France;62;5;25;875;Wardrecques;1336;23;1359
32;Hauts-de-France;62;1;09;876;Warlencourt-Eaucourt;136;2;138
32;Hauts-de-France;62;1;07;877;Warlincourt-lès-Pas;161;5;166
32;Hauts-de-France;62;1;07;878;Warlus;376;7;383
32;Hauts-de-France;62;1;07;879;Warluzel;232;3;235
32;Hauts-de-France;62;3;22;880;Le Wast;204;3;207
32;Hauts-de-France;62;5;33;882;Wavrans-sur-l'Aa;1255;34;1289
32;Hauts-de-France;62;1;38;883;Wavrans-sur-Ternoise;197;0;197
32;Hauts-de-France;62;2;31;885;Westrehem;249;1;250
32;Hauts-de-France;62;4;33;886;Wicquinghem;263;3;266
32;Hauts-de-France;62;4;24;887;Widehem;244;1;245
32;Hauts-de-France;62;3;22;888;Wierre-au-Bois;226;0;226
32;Hauts-de-France;62;3;22;889;Wierre-Effroy;863;19;882
32;Hauts-de-France;62;4;06;890;Willeman;184;1;185
32;Hauts-de-France;62;1;06;891;Willencourt;135;4;139
32;Hauts-de-France;62;1;03;892;Willerval;650;20;670
32;Hauts-de-France;62;3;13;893;Wimereux;6356;162;6518
32;Hauts-de-France;62;3;13;894;Wimille;4031;80;4111
32;Hauts-de-France;62;7;39;895;Wingles;8754;64;8818
32;Hauts-de-France;62;3;22;896;Wirwignes;742;21;763
32;Hauts-de-France;62;5;33;897;Wismes;499;9;508
32;Hauts-de-France;62;5;33;898;Wisques;223;9;232
32;Hauts-de-France;62;3;22;899;Wissant;896;18;914
32;Hauts-de-France;62;2;01;900;Witternesse;587;15;602
32;Hauts-de-France;62;5;01;901;Wittes;985;13;998
32;Hauts-de-France;62;5;32;902;Wizernes;3272;52;3324
32;Hauts-de-France;62;1;09;909;Ytres;435;5;440
32;Hauts-de-France;62;4;33;903;Zoteux;623;4;627
32;Hauts-de-France;62;5;37;904;Zouafques;594;10;604
32;Hauts-de-France;62;5;33;905;Zudausques;941;46;987
32;Hauts-de-France;62;6;34;906;Zutkerque;1773;22;1795
32;Hauts-de-France;62;1;38;633;Œuf-en-Ternois;250;3;253
84;Auvergne-Rhône-Alpes;63;4;01;001;Aigueperse;2756;34;2790
84;Auvergne-Rhône-Alpes;63;1;22;002;Aix-la-Fayette;93;0;93
84;Auvergne-Rhône-Alpes;63;1;02;003;Ambert;6634;245;6879
84;Auvergne-Rhône-Alpes;63;4;27;004;Les Ancizes-Comps;1652;28;1680
84;Auvergne-Rhône-Alpes;63;3;06;005;Antoingt;403;5;408
84;Auvergne-Rhône-Alpes;63;3;06;006;Anzat-le-Luguet;176;2;178
84;Auvergne-Rhône-Alpes;63;3;06;007;Apchat;166;3;169
84;Auvergne-Rhône-Alpes;63;5;30;008;Arconsat;594;10;604
84;Auvergne-Rhône-Alpes;63;3;06;009;Ardes;583;6;589
84;Auvergne-Rhône-Alpes;63;1;02;010;Arlanc;1854;40;1894
84;Auvergne-Rhône-Alpes;63;4;26;011;Ars-les-Favets;223;11;234
84;Auvergne-Rhône-Alpes;63;4;01;012;Artonne;906;17;923
84;Auvergne-Rhône-Alpes;63;4;01;013;Aubiat;903;12;915
84;Auvergne-Rhône-Alpes;63;2;03;014;Aubière;10745;152;10897
84;Auvergne-Rhône-Alpes;63;5;22;015;Aubusson-d'Auvergne;249;2;251
84;Auvergne-Rhône-Alpes;63;5;22;016;Augerolles;887;25;912
84;Auvergne-Rhône-Alpes;63;3;06;017;Augnat;183;1;184
84;Auvergne-Rhône-Alpes;63;3;18;160;Aulhat-Flat;914;31;945
84;Auvergne-Rhône-Alpes;63;2;17;019;Aulnat;4073;39;4112
84;Auvergne-Rhône-Alpes;63;3;23;020;Aurières;346;12;358
84;Auvergne-Rhône-Alpes;63;2;21;021;Authezat;684;8;692
84;Auvergne-Rhône-Alpes;63;3;06;022;Auzat-la-Combelle;2040;28;2068
84;Auvergne-Rhône-Alpes;63;1;22;023;Auzelles;373;10;383
84;Auvergne-Rhône-Alpes;63;3;29;024;Avèze;179;4;183
84;Auvergne-Rhône-Alpes;63;4;26;025;Ayat-sur-Sioule;142;5;147
84;Auvergne-Rhône-Alpes;63;2;23;026;Aydat;2422;45;2467
84;Auvergne-Rhône-Alpes;63;1;02;027;Baffie;112;1;113
84;Auvergne-Rhône-Alpes;63;3;29;028;Bagnols;428;17;445
84;Auvergne-Rhône-Alpes;63;3;06;029;Bansat;255;3;258
84;Auvergne-Rhône-Alpes;63;4;20;030;Bas-et-Lezat;337;6;343
84;Auvergne-Rhône-Alpes;63;3;06;031;Beaulieu;465;5;470
84;Auvergne-Rhône-Alpes;63;2;04;032;Beaumont;10793;231;11024
84;Auvergne-Rhône-Alpes;63;4;20;033;Beaumont-lès-Randan;301;2;303
84;Auvergne-Rhône-Alpes;63;2;05;034;Beauregard-l'Évêque;1528;27;1555
84;Auvergne-Rhône-Alpes;63;4;27;035;Beauregard-Vendon;1216;19;1235
84;Auvergne-Rhône-Alpes;63;3;06;036;Bergonne;329;4;333
84;Auvergne-Rhône-Alpes;63;1;22;037;Bertignat;454;14;468
84;Auvergne-Rhône-Alpes;63;3;29;038;Besse-et-Saint-Anastaise;1501;68;1569
84;Auvergne-Rhône-Alpes;63;1;02;039;Beurières;293;10;303
84;Auvergne-Rhône-Alpes;63;2;05;040;Billom;4754;80;4834
84;Auvergne-Rhône-Alpes;63;4;26;041;Biollet;325;9;334
84;Auvergne-Rhône-Alpes;63;2;07;042;Blanzat;3736;55;3791
84;Auvergne-Rhône-Alpes;63;4;27;043;Blot-l'Église;439;3;442
84;Auvergne-Rhône-Alpes;63;2;05;044;Bongheat;427;7;434
84;Auvergne-Rhône-Alpes;63;5;19;045;Bort-l'Étang;673;16;689
84;Auvergne-Rhône-Alpes;63;3;06;046;Boudes;291;4;295
84;Auvergne-Rhône-Alpes;63;3;29;047;La Bourboule;1778;36;1814
84;Auvergne-Rhône-Alpes;63;4;28;048;Bourg-Lastic;872;27;899
84;Auvergne-Rhône-Alpes;63;2;05;049;Bouzel;728;7;735
84;Auvergne-Rhône-Alpes;63;3;06;050;Brassac-les-Mines;3349;122;3471
84;Auvergne-Rhône-Alpes;63;3;18;051;Brenat;626;13;639
84;Auvergne-Rhône-Alpes;63;3;06;052;Le Breuil-sur-Couze;1039;86;1125
84;Auvergne-Rhône-Alpes;63;4;28;053;Briffons;264;12;276
84;Auvergne-Rhône-Alpes;63;3;18;054;Le Broc;695;17;712
84;Auvergne-Rhône-Alpes;63;4;28;055;Bromont-Lamothe;977;16;993
84;Auvergne-Rhône-Alpes;63;1;22;056;Brousse;338;4;342
84;Auvergne-Rhône-Alpes;63;1;22;057;Le Brugeron;244;6;250
84;Auvergne-Rhône-Alpes;63;5;19;058;Bulhon;531;9;540
84;Auvergne-Rhône-Alpes;63;2;31;059;Busséol;216;5;221
84;Auvergne-Rhône-Alpes;63;4;26;060;Bussières;91;0;91
84;Auvergne-Rhône-Alpes;63;4;01;061;Bussières-et-Pruns;457;7;464
84;Auvergne-Rhône-Alpes;63;4;26;062;Buxières-sous-Montaigut;237;2;239
84;Auvergne-Rhône-Alpes;63;2;07;063;Cébazat;8727;108;8835
84;Auvergne-Rhône-Alpes;63;1;22;065;Ceilloux;176;3;179
84;Auvergne-Rhône-Alpes;63;4;28;064;La Celle;81;0;81
84;Auvergne-Rhône-Alpes;63;5;30;066;Celles-sur-Durolle;1707;31;1738
84;Auvergne-Rhône-Alpes;63;4;26;067;La Cellette;168;2;170
84;Auvergne-Rhône-Alpes;63;2;16;069;Le Cendre;5489;59;5548
84;Auvergne-Rhône-Alpes;63;2;04;070;Ceyrat;6390;123;6513
84;Auvergne-Rhône-Alpes;63;3;23;071;Ceyssat;695;11;706
84;Auvergne-Rhône-Alpes;63;5;30;072;Chabreloche;1210;17;1227
84;Auvergne-Rhône-Alpes;63;3;31;073;Chadeleuf;430;13;443
84;Auvergne-Rhône-Alpes;63;3;06;074;Chalus;181;0;181
84;Auvergne-Rhône-Alpes;63;2;08;075;Chamalières;17210;625;17835
84;Auvergne-Rhône-Alpes;63;4;25;244;Chambaron sur Morge;1776;26;1802
84;Auvergne-Rhône-Alpes;63;1;22;076;Chambon-sur-Dolore;155;2;157
84;Auvergne-Rhône-Alpes;63;3;29;077;Chambon-sur-Lac;417;4;421
84;Auvergne-Rhône-Alpes;63;3;06;079;Champagnat-le-Jeune;150;2;152
84;Auvergne-Rhône-Alpes;63;3;29;080;Champeix;1382;22;1404
84;Auvergne-Rhône-Alpes;63;1;02;081;Champétières;273;6;279
84;Auvergne-Rhône-Alpes;63;4;27;082;Champs;401;9;410
84;Auvergne-Rhône-Alpes;63;4;23;083;Chanat-la-Mouteyre;934;27;961
84;Auvergne-Rhône-Alpes;63;2;21;084;Chanonat;1694;36;1730
84;Auvergne-Rhône-Alpes;63;4;28;085;Chapdes-Beaufort;1117;7;1124
84;Auvergne-Rhône-Alpes;63;1;22;086;La Chapelle-Agnon;341;12;353
84;Auvergne-Rhône-Alpes;63;3;06;087;La Chapelle-Marcousse;64;1;65
84;Auvergne-Rhône-Alpes;63;3;06;088;La Chapelle-sur-Usson;80;0;80
84;Auvergne-Rhône-Alpes;63;4;01;089;Chappes;1642;26;1668
84;Auvergne-Rhône-Alpes;63;4;01;090;Chaptuzat;497;8;505
84;Auvergne-Rhône-Alpes;63;3;06;091;Charbonnier-les-Mines;899;15;914
84;Auvergne-Rhône-Alpes;63;4;28;092;Charbonnières-les-Varennes;1759;26;1785
84;Auvergne-Rhône-Alpes;63;4;27;093;Charbonnières-les-Vieilles;1098;21;1119
84;Auvergne-Rhône-Alpes;63;4;26;094;Charensat;497;5;502
84;Auvergne-Rhône-Alpes;63;5;20;095;Charnat;208;3;211
84;Auvergne-Rhône-Alpes;63;2;05;096;Chas;385;6;391
84;Auvergne-Rhône-Alpes;63;3;06;097;Chassagne;76;2;78
84;Auvergne-Rhône-Alpes;63;3;29;098;Chastreix;224;8;232
84;Auvergne-Rhône-Alpes;63;4;26;101;Château-sur-Cher;71;1;72
84;Auvergne-Rhône-Alpes;63;2;09;099;Châteaugay;3091;53;3144
84;Auvergne-Rhône-Alpes;63;4;26;100;Châteauneuf-les-Bains;318;4;322
84;Auvergne-Rhône-Alpes;63;4;09;103;Châtel-Guyon;6195;181;6376
84;Auvergne-Rhône-Alpes;63;5;20;102;Châteldon;772;14;786
84;Auvergne-Rhône-Alpes;63;1;02;104;La Chaulme;113;5;118
84;Auvergne-Rhône-Alpes;63;1;02;105;Chaumont-le-Bourg;230;6;236
84;Auvergne-Rhône-Alpes;63;2;05;106;Chauriat;1688;18;1706
84;Auvergne-Rhône-Alpes;63;4;01;107;Chavaroux;487;8;495
84;Auvergne-Rhône-Alpes;63;4;25;108;Le Cheix;670;14;684
84;Auvergne-Rhône-Alpes;63;3;29;109;Chidrac;527;12;539
84;Auvergne-Rhône-Alpes;63;4;28;110;Cisternes-la-Forêt;462;5;467
84;Auvergne-Rhône-Alpes;63;3;29;111;Clémensat;117;5;122
84;Auvergne-Rhône-Alpes;63;4;01;112;Clerlande;578;7;585
84;Auvergne-Rhône-Alpes;63;2;99;113;Clermont-Ferrand;146734;2730;149464
84;Auvergne-Rhône-Alpes;63;3;06;114;Collanges;158;1;159
84;Auvergne-Rhône-Alpes;63;4;28;115;Combrailles;218;4;222
84;Auvergne-Rhône-Alpes;63;4;27;116;Combronde;2198;35;2233
84;Auvergne-Rhône-Alpes;63;3;29;117;Compains;128;3;131
84;Auvergne-Rhône-Alpes;63;4;28;118;Condat-en-Combraille;417;7;424
84;Auvergne-Rhône-Alpes;63;1;22;119;Condat-lès-Montboissier;227;3;230
84;Auvergne-Rhône-Alpes;63;2;21;120;Corent;766;9;775
84;Auvergne-Rhône-Alpes;63;3;31;121;Coudes;1270;14;1284
84;Auvergne-Rhône-Alpes;63;3;29;122;Courgoul;62;1;63
84;Auvergne-Rhône-Alpes;63;2;23;123;Cournols;239;7;246
84;Auvergne-Rhône-Alpes;63;2;16;124;Cournon-d'Auvergne;20157;369;20526
84;Auvergne-Rhône-Alpes;63;5;22;125;Courpière;4034;147;4181
84;Auvergne-Rhône-Alpes;63;2;21;126;Le Crest;1270;26;1296
84;Auvergne-Rhône-Alpes;63;5;19;128;Crevant-Laveine;962;16;978
84;Auvergne-Rhône-Alpes;63;3;29;129;Cros;171;1;172
84;Auvergne-Rhône-Alpes;63;4;26;130;La Crouzille;262;11;273
84;Auvergne-Rhône-Alpes;63;5;19;131;Culhat;1128;19;1147
84;Auvergne-Rhône-Alpes;63;1;22;132;Cunlhat;1275;26;1301
84;Auvergne-Rhône-Alpes;63;3;06;134;Dauzat-sur-Vodable;74;2;76
84;Auvergne-Rhône-Alpes;63;4;27;135;Davayat;612;5;617
84;Auvergne-Rhône-Alpes;63;1;22;136;Domaize;388;8;396
84;Auvergne-Rhône-Alpes;63;1;02;137;Doranges;167;4;171
84;Auvergne-Rhône-Alpes;63;5;30;138;Dorat;701;9;710
84;Auvergne-Rhône-Alpes;63;1;02;139;Dore-l'Église;645;8;653
84;Auvergne-Rhône-Alpes;63;4;26;140;Durmignat;210;5;215
84;Auvergne-Rhône-Alpes;63;2;07;141;Durtol;2028;47;2075
84;Auvergne-Rhône-Alpes;63;1;22;142;Échandelys;255;12;267
84;Auvergne-Rhône-Alpes;63;4;01;143;Effiat;1124;18;1142
84;Auvergne-Rhône-Alpes;63;3;29;144;Égliseneuve-d'Entraigues;347;9;356
84;Auvergne-Rhône-Alpes;63;3;06;145;Égliseneuve-des-Liards;148;6;154
84;Auvergne-Rhône-Alpes;63;2;05;146;Égliseneuve-près-Billom;806;64;870
84;Auvergne-Rhône-Alpes;63;1;02;147;Églisolles;257;3;260
84;Auvergne-Rhône-Alpes;63;4;01;148;Ennezat;2483;52;2535
84;Auvergne-Rhône-Alpes;63;4;01;149;Entraigues;667;9;676
84;Auvergne-Rhône-Alpes;63;4;09;150;Enval;1520;30;1550
84;Auvergne-Rhône-Alpes;63;5;30;151;Escoutoux;1338;38;1376
84;Auvergne-Rhône-Alpes;63;4;26;152;Espinasse;293;4;297
84;Auvergne-Rhône-Alpes;63;3;29;153;Espinchal;105;2;107
84;Auvergne-Rhône-Alpes;63;2;05;154;Espirat;424;6;430
84;Auvergne-Rhône-Alpes;63;2;05;155;Estandeuil;473;13;486
84;Auvergne-Rhône-Alpes;63;3;06;156;Esteil;61;0;61
84;Auvergne-Rhône-Alpes;63;2;05;157;Fayet-le-Château;362;10;372
84;Auvergne-Rhône-Alpes;63;1;22;158;Fayet-Ronaye;106;6;112
84;Auvergne-Rhône-Alpes;63;4;28;159;Fernoël;132;0;132
84;Auvergne-Rhône-Alpes;63;1;02;161;La Forie;324;10;334
84;Auvergne-Rhône-Alpes;63;1;22;162;Fournols;326;8;334
84;Auvergne-Rhône-Alpes;63;3;23;163;Gelles;968;56;1024
84;Auvergne-Rhône-Alpes;63;2;17;164;Gerzat;10315;87;10402
84;Auvergne-Rhône-Alpes;63;4;28;165;Giat;807;37;844
84;Auvergne-Rhône-Alpes;63;3;06;166;Gignat;240;5;245
84;Auvergne-Rhône-Alpes;63;4;27;167;Gimeaux;399;6;405
84;Auvergne-Rhône-Alpes;63;2;05;168;Glaine-Montaigut;579;13;592
84;Auvergne-Rhône-Alpes;63;3;06;169;La Godivelle;15;0;15
84;Auvergne-Rhône-Alpes;63;4;28;170;La Goutelle;625;15;640
84;Auvergne-Rhône-Alpes;63;4;26;171;Gouttières;333;13;346
84;Auvergne-Rhône-Alpes;63;3;29;172;Grandeyrolles;53;2;55
84;Auvergne-Rhône-Alpes;63;1;02;173;Grandrif;193;7;200
84;Auvergne-Rhône-Alpes;63;1;22;174;Grandval;118;2;120
84;Auvergne-Rhône-Alpes;63;4;28;175;Herment;240;8;248
84;Auvergne-Rhône-Alpes;63;3;23;176;Heume-l'Église;106;3;109
84;Auvergne-Rhône-Alpes;63;2;05;177;Isserteaux;412;10;422
84;Auvergne-Rhône-Alpes;63;3;18;178;Issoire;15214;403;15617
84;Auvergne-Rhône-Alpes;63;1;02;179;Job;1023;29;1052
84;Auvergne-Rhône-Alpes;63;5;19;180;Joze;1112;17;1129
84;Auvergne-Rhône-Alpes;63;4;27;181;Jozerand;552;14;566
84;Auvergne-Rhône-Alpes;63;3;06;182;Jumeaux;612;15;627
84;Auvergne-Rhône-Alpes;63;3;29;183;Labessette;63;0;63
84;Auvergne-Rhône-Alpes;63;5;20;184;Lachaux;279;3;282
84;Auvergne-Rhône-Alpes;63;3;06;185;Lamontgie;644;8;652
84;Auvergne-Rhône-Alpes;63;4;28;186;Landogne;234;8;242
84;Auvergne-Rhône-Alpes;63;4;26;187;Lapeyrouse;537;12;549
84;Auvergne-Rhône-Alpes;63;2;31;188;Laps;591;16;607
84;Auvergne-Rhône-Alpes;63;3;23;189;Laqueuille;369;4;373
84;Auvergne-Rhône-Alpes;63;3;29;190;Larodde;271;7;278
84;Auvergne-Rhône-Alpes;63;4;28;191;Lastic;107;3;110
84;Auvergne-Rhône-Alpes;63;3;06;448;Le Vernet-Chaméane ;808;64;872
84;Auvergne-Rhône-Alpes;63;2;24;193;Lempdes;8543;430;8973
84;Auvergne-Rhône-Alpes;63;5;19;194;Lempty;389;7;396
84;Auvergne-Rhône-Alpes;63;5;19;195;Lezoux;6224;73;6297
84;Auvergne-Rhône-Alpes;63;4;20;196;Limons;750;13;763
84;Auvergne-Rhône-Alpes;63;4;27;197;Lisseuil;124;2;126
84;Auvergne-Rhône-Alpes;63;4;27;198;Loubeyrat;1362;18;1380
84;Auvergne-Rhône-Alpes;63;3;29;199;Ludesse;498;5;503
84;Auvergne-Rhône-Alpes;63;4;01;200;Lussat;916;18;934
84;Auvergne-Rhône-Alpes;63;4;20;201;Luzillat;1132;17;1149
84;Auvergne-Rhône-Alpes;63;3;06;202;Madriat;108;3;111
84;Auvergne-Rhône-Alpes;63;4;09;203;Malauzat;1154;17;1171
84;Auvergne-Rhône-Alpes;63;4;17;204;Malintrat;1132;20;1152
84;Auvergne-Rhône-Alpes;63;2;31;205;Manglieu;466;4;470
84;Auvergne-Rhône-Alpes;63;4;27;206;Manzat;1374;19;1393
84;Auvergne-Rhône-Alpes;63;1;22;207;Marat;814;11;825
84;Auvergne-Rhône-Alpes;63;4;27;208;Marcillat;289;5;294
84;Auvergne-Rhône-Alpes;63;3;06;209;Mareugheol;203;5;208
84;Auvergne-Rhône-Alpes;63;4;20;210;Maringues;3138;50;3188
84;Auvergne-Rhône-Alpes;63;1;02;211;Marsac-en-Livradois;1458;47;1505
84;Auvergne-Rhône-Alpes;63;4;09;212;Marsat;1399;37;1436
84;Auvergne-Rhône-Alpes;63;4;01;213;Les Martres-d'Artière;2135;21;2156
84;Auvergne-Rhône-Alpes;63;2;21;214;Les Martres-de-Veyre;3985;55;4040
84;Auvergne-Rhône-Alpes;63;4;01;215;Martres-sur-Morge;673;7;680
84;Auvergne-Rhône-Alpes;63;2;05;216;Mauzun;117;4;121
84;Auvergne-Rhône-Alpes;63;1;02;218;Mayres;201;6;207
84;Auvergne-Rhône-Alpes;63;3;23;219;Mazaye;720;11;731
84;Auvergne-Rhône-Alpes;63;3;06;220;Mazoires;97;3;100
84;Auvergne-Rhône-Alpes;63;1;02;221;Medeyrolles;120;0;120
84;Auvergne-Rhône-Alpes;63;3;18;222;Meilhaud;494;8;502
84;Auvergne-Rhône-Alpes;63;4;26;223;Menat;544;11;555
84;Auvergne-Rhône-Alpes;63;4;09;224;Ménétrol;1631;24;1655
84;Auvergne-Rhône-Alpes;63;4;28;225;Messeix;1048;40;1088
84;Auvergne-Rhône-Alpes;63;2;31;227;Mirefleurs;2406;59;2465
84;Auvergne-Rhône-Alpes;63;4;28;228;Miremont;296;10;306
84;Auvergne-Rhône-Alpes;63;5;19;229;Moissat;1222;23;1245
84;Auvergne-Rhône-Alpes;63;1;22;230;Le Monestier;219;5;224
84;Auvergne-Rhône-Alpes;63;5;30;231;La Monnerie-le-Montel;1703;35;1738
84;Auvergne-Rhône-Alpes;63;4;20;232;Mons;540;13;553
84;Auvergne-Rhône-Alpes;63;3;29;236;Mont-Dore;1280;18;1298
84;Auvergne-Rhône-Alpes;63;4;26;233;Montaigut;986;9;995
84;Auvergne-Rhône-Alpes;63;3;29;234;Montaigut-le-Blanc;869;17;886
84;Auvergne-Rhône-Alpes;63;4;27;235;Montcel;521;6;527
84;Auvergne-Rhône-Alpes;63;4;28;237;Montel-de-Gelat;432;6;438
84;Auvergne-Rhône-Alpes;63;4;28;238;Montfermy;227;1;228
84;Auvergne-Rhône-Alpes;63;2;05;239;Montmorin;720;23;743
84;Auvergne-Rhône-Alpes;63;4;01;240;Montpensier;457;9;466
84;Auvergne-Rhône-Alpes;63;3;31;241;Montpeyroux;329;15;344
84;Auvergne-Rhône-Alpes;63;3;06;242;Moriat;373;10;383
84;Auvergne-Rhône-Alpes;63;4;26;243;Moureuille;372;5;377
84;Auvergne-Rhône-Alpes;63;4;09;245;Mozac;3877;66;3943
84;Auvergne-Rhône-Alpes;63;2;24;226;Mur-sur-Allier ;3419;75;3494
84;Auvergne-Rhône-Alpes;63;3;29;246;Murat-le-Quaire;477;17;494
84;Auvergne-Rhône-Alpes;63;3;29;247;Murol;582;10;592
84;Auvergne-Rhône-Alpes;63;3;23;248;Nébouzat;842;21;863
84;Auvergne-Rhône-Alpes;63;5;22;249;Néronde-sur-Dore;520;10;530
84;Auvergne-Rhône-Alpes;63;3;31;250;Neschers;845;17;862
84;Auvergne-Rhône-Alpes;63;4;26;251;Neuf-Église;294;7;301
84;Auvergne-Rhône-Alpes;63;2;05;252;Neuville;381;7;388
84;Auvergne-Rhône-Alpes;63;5;20;253;Noalhat;243;2;245
84;Auvergne-Rhône-Alpes;63;2;07;254;Nohanent;2222;36;2258
84;Auvergne-Rhône-Alpes;63;3;06;255;Nonette-Orsonnette;588;16;604
84;Auvergne-Rhône-Alpes;63;1;02;256;Novacelles;150;2;152
84;Auvergne-Rhône-Alpes;63;3;23;257;Olby;812;11;823
84;Auvergne-Rhône-Alpes;63;1;22;258;Olliergues;756;20;776
84;Auvergne-Rhône-Alpes;63;2;23;259;Olloix;313;10;323
84;Auvergne-Rhône-Alpes;63;5;22;260;Olmet;161;5;166
84;Auvergne-Rhône-Alpes;63;3;18;261;Orbeil;843;29;872
84;Auvergne-Rhône-Alpes;63;2;21;262;Orcet;2702;39;2741
84;Auvergne-Rhône-Alpes;63;2;23;263;Orcines;3440;104;3544
84;Auvergne-Rhône-Alpes;63;3;23;264;Orcival;245;1;246
84;Auvergne-Rhône-Alpes;63;5;19;265;Orléat;2174;43;2217
84;Auvergne-Rhône-Alpes;63;5;30;267;Palladuc;541;18;559
84;Auvergne-Rhône-Alpes;63;3;18;268;Pardines;285;4;289
84;Auvergne-Rhône-Alpes;63;3;31;269;Parent;876;15;891
84;Auvergne-Rhône-Alpes;63;3;06;270;Parentignat;510;16;526
84;Auvergne-Rhône-Alpes;63;5;20;271;Paslières;1496;37;1533
84;Auvergne-Rhône-Alpes;63;2;03;272;Pérignat-lès-Sarliève;2693;53;2746
84;Auvergne-Rhône-Alpes;63;2;31;273;Pérignat-sur-Allier;1516;31;1547
84;Auvergne-Rhône-Alpes;63;3;23;274;Perpezat;430;15;445
84;Auvergne-Rhône-Alpes;63;3;18;275;Perrier;889;19;908
84;Auvergne-Rhône-Alpes;63;5;19;276;Peschadoires;2126;45;2171
84;Auvergne-Rhône-Alpes;63;3;06;277;Peslières;66;0;66
84;Auvergne-Rhône-Alpes;63;4;25;278;Pessat-Villeneuve;678;5;683
84;Auvergne-Rhône-Alpes;63;3;29;279;Picherande;333;6;339
84;Auvergne-Rhône-Alpes;63;2;31;280;Pignols;339;6;345
84;Auvergne-Rhône-Alpes;63;4;26;281;Pionsat;1075;19;1094
84;Auvergne-Rhône-Alpes;63;3;31;282;Plauzat;1688;21;1709
84;Auvergne-Rhône-Alpes;63;2;24;284;Pont-du-Château;11802;300;12102
84;Auvergne-Rhône-Alpes;63;4;28;283;Pontaumur;639;114;753
84;Auvergne-Rhône-Alpes;63;4;28;285;Pontgibaud;761;17;778
84;Auvergne-Rhône-Alpes;63;4;27;286;Pouzol;273;5;278
84;Auvergne-Rhône-Alpes;63;3;06;287;Les Pradeaux;340;7;347
84;Auvergne-Rhône-Alpes;63;4;27;288;Prompsat;441;14;455
84;Auvergne-Rhône-Alpes;63;4;28;289;Prondines;260;9;269
84;Auvergne-Rhône-Alpes;63;4;28;290;Pulvérières;406;9;415
84;Auvergne-Rhône-Alpes;63;5;20;291;Puy-Guillaume;2772;46;2818
84;Auvergne-Rhône-Alpes;63;4;28;292;Puy-Saint-Gulmier;154;5;159
84;Auvergne-Rhône-Alpes;63;4;26;293;Le Quartier;215;8;223
84;Auvergne-Rhône-Alpes;63;4;27;294;Queuille;283;6;289
84;Auvergne-Rhône-Alpes;63;4;20;295;Randan;1576;15;1591
84;Auvergne-Rhône-Alpes;63;5;19;296;Ravel;747;15;762
84;Auvergne-Rhône-Alpes;63;2;05;297;Reignat;385;3;388
84;Auvergne-Rhône-Alpes;63;5;22;298;La Renaudie;126;4;130
84;Auvergne-Rhône-Alpes;63;3;06;299;Rentières;108;0;108
84;Auvergne-Rhône-Alpes;63;4;25;300;Riom;19011;771;19782
84;Auvergne-Rhône-Alpes;63;5;20;301;Ris;748;9;757
84;Auvergne-Rhône-Alpes;63;2;21;302;La Roche-Blanche;3474;67;3541
84;Auvergne-Rhône-Alpes;63;3;06;303;Roche-Charles-la-Mayrand;41;1;42
84;Auvergne-Rhône-Alpes;63;4;26;304;Roche-d'Agoux;108;0;108
84;Auvergne-Rhône-Alpes;63;2;31;306;La Roche-Noire;620;10;630
84;Auvergne-Rhône-Alpes;63;3;23;305;Rochefort-Montagne;863;143;1006
84;Auvergne-Rhône-Alpes;63;2;03;307;Romagnat;7793;178;7971
84;Auvergne-Rhône-Alpes;63;2;08;308;Royat;4505;120;4625
84;Auvergne-Rhône-Alpes;63;1;02;309;Saillant;298;3;301
84;Auvergne-Rhône-Alpes;63;4;01;311;Saint-Agoulin;334;2;336
84;Auvergne-Rhône-Alpes;63;1;02;312;Saint-Alyre-d'Arlanc;160;4;164
84;Auvergne-Rhône-Alpes;63;3;06;313;Saint-Alyre-ès-Montagne;119;5;124
84;Auvergne-Rhône-Alpes;63;1;22;314;Saint-Amant-Roche-Savine;502;28;530
84;Auvergne-Rhône-Alpes;63;2;21;315;Saint-Amant-Tallende;1730;38;1768
84;Auvergne-Rhône-Alpes;63;4;20;317;Saint-André-le-Coq;528;3;531
84;Auvergne-Rhône-Alpes;63;4;27;318;Saint-Angel;445;9;454
84;Auvergne-Rhône-Alpes;63;1;02;319;Saint-Anthème;702;24;726
84;Auvergne-Rhône-Alpes;63;4;28;320;Saint-Avit;226;5;231
84;Auvergne-Rhône-Alpes;63;3;18;321;Saint-Babel;940;15;955
84;Auvergne-Rhône-Alpes;63;4;17;322;Saint-Beauzire;2219;30;2249
84;Auvergne-Rhône-Alpes;63;1;22;323;Saint-Bonnet-le-Bourg;165;3;168
84;Auvergne-Rhône-Alpes;63;1;22;324;Saint-Bonnet-le-Chastel;209;8;217
84;Auvergne-Rhône-Alpes;63;2;05;325;Saint-Bonnet-lès-Allier;423;6;429
84;Auvergne-Rhône-Alpes;63;3;23;326;Saint-Bonnet-près-Orcival;500;8;508
84;Auvergne-Rhône-Alpes;63;4;25;327;Saint-Bonnet-près-Riom;2074;39;2113
84;Auvergne-Rhône-Alpes;63;3;29;330;Saint-Cirgues-sur-Couze;349;6;355
84;Auvergne-Rhône-Alpes;63;4;20;332;Saint-Clément-de-Régnat;548;10;558
84;Auvergne-Rhône-Alpes;63;1;02;331;Saint-Clément-de-Valorgue;231;6;237
84;Auvergne-Rhône-Alpes;63;4;20;333;Saint-Denis-Combarnazat;231;8;239
84;Auvergne-Rhône-Alpes;63;2;05;334;Saint-Dier-d'Auvergne;530;20;550
84;Auvergne-Rhône-Alpes;63;3;29;335;Saint-Diéry ;519;12;531
84;Auvergne-Rhône-Alpes;63;3;29;336;Saint-Donat;203;4;207
84;Auvergne-Rhône-Alpes;63;1;22;337;Saint-Éloy-la-Glacière;59;1;60
84;Auvergne-Rhône-Alpes;63;4;26;338;Saint-Éloy-les-Mines;3651;142;3793
84;Auvergne-Rhône-Alpes;63;4;28;339;Saint-Étienne-des-Champs;138;2;140
84;Auvergne-Rhône-Alpes;63;3;06;340;Saint-Étienne-sur-Usson;267;3;270
84;Auvergne-Rhône-Alpes;63;1;02;341;Saint-Ferréol-des-Côtes;546;16;562
84;Auvergne-Rhône-Alpes;63;3;29;342;Saint-Floret;248;7;255
84;Auvergne-Rhône-Alpes;63;5;22;343;Saint-Flour;282;7;289
84;Auvergne-Rhône-Alpes;63;4;27;344;Saint-Gal-sur-Sioule;140;4;144
84;Auvergne-Rhône-Alpes;63;2;04;345;Saint-Genès-Champanelle;3641;105;3746
84;Auvergne-Rhône-Alpes;63;3;29;346;Saint-Genès-Champespe;218;7;225
84;Auvergne-Rhône-Alpes;63;4;01;347;Saint-Genès-du-Retz;473;18;491
84;Auvergne-Rhône-Alpes;63;3;06;348;Saint-Genès-la-Tourette;182;1;183
84;Auvergne-Rhône-Alpes;63;4;27;349;Saint-Georges-de-Mons;1946;49;1995
84;Auvergne-Rhône-Alpes;63;2;31;350;Saint-Georges-sur-Allier;1256;18;1274
84;Auvergne-Rhône-Alpes;63;1;22;353;Saint-Germain-l'Herm;486;27;513
84;Auvergne-Rhône-Alpes;63;3;06;352;Saint-Germain-Lembron;1995;42;2037
84;Auvergne-Rhône-Alpes;63;4;28;351;Saint-Germain-près-Herment;78;2;80
84;Auvergne-Rhône-Alpes;63;4;26;354;Saint-Gervais-d'Auvergne;1307;131;1438
84;Auvergne-Rhône-Alpes;63;1;22;355;Saint-Gervais-sous-Meymont;229;4;233
84;Auvergne-Rhône-Alpes;63;3;06;356;Saint-Gervazy;333;13;346
84;Auvergne-Rhône-Alpes;63;3;06;357;Saint-Hérent;115;2;117
84;Auvergne-Rhône-Alpes;63;4;26;360;Saint-Hilaire;157;3;160
84;Auvergne-Rhône-Alpes;63;4;27;358;Saint-Hilaire-la-Croix;354;3;357
84;Auvergne-Rhône-Alpes;63;4;28;359;Saint-Hilaire-les-Monges;87;1;88
84;Auvergne-Rhône-Alpes;63;4;01;362;Saint-Ignat;909;17;926
84;Auvergne-Rhône-Alpes;63;4;28;363;Saint-Jacques-d'Ambur;277;6;283
84;Auvergne-Rhône-Alpes;63;5;19;364;Saint-Jean-d'Heurs;658;8;666
84;Auvergne-Rhône-Alpes;63;2;05;365;Saint-Jean-des-Ollières;440;11;451
84;Auvergne-Rhône-Alpes;63;3;06;366;Saint-Jean-en-Val;353;3;356
84;Auvergne-Rhône-Alpes;63;3;06;367;Saint-Jean-Saint-Gervais;123;1;124
84;Auvergne-Rhône-Alpes;63;2;05;368;Saint-Julien-de-Coppel;1283;26;1309
84;Auvergne-Rhône-Alpes;63;4;26;369;Saint-Julien-la-Geneste;121;3;124
84;Auvergne-Rhône-Alpes;63;3;28;370;Saint-Julien-Puy-Lavèze;362;5;367
84;Auvergne-Rhône-Alpes;63;1;02;371;Saint-Just;155;5;160
84;Auvergne-Rhône-Alpes;63;4;01;372;Saint-Laure;658;5;663
84;Auvergne-Rhône-Alpes;63;4;26;373;Saint-Maigner;190;3;193
84;Auvergne-Rhône-Alpes;63;3;06;376;Saint-Martin-d'Ollières;149;7;156
84;Auvergne-Rhône-Alpes;63;1;02;374;Saint-Martin-des-Olmes;287;7;294
84;Auvergne-Rhône-Alpes;63;3;06;375;Saint-Martin-des-Plains;160;1;161
84;Auvergne-Rhône-Alpes;63;2;31;378;Saint-Maurice;905;8;913
84;Auvergne-Rhône-Alpes;63;4;26;377;Saint-Maurice-près-Pionsat;372;6;378
84;Auvergne-Rhône-Alpes;63;4;27;379;Saint-Myon;501;6;507
84;Auvergne-Rhône-Alpes;63;3;29;380;Saint-Nectaire;753;3;756
84;Auvergne-Rhône-Alpes;63;4;28;381;Saint-Ours;1650;22;1672
84;Auvergne-Rhône-Alpes;63;4;27;382;Saint-Pardoux;399;13;412
84;Auvergne-Rhône-Alpes;63;3;29;383;Saint-Pierre-Colamine;248;5;253
84;Auvergne-Rhône-Alpes;63;1;22;384;Saint-Pierre-la-Bourlhonne;129;5;134
84;Auvergne-Rhône-Alpes;63;4;28;385;Saint-Pierre-le-Chastel;439;9;448
84;Auvergne-Rhône-Alpes;63;3;23;386;Saint-Pierre-Roche;478;5;483
84;Auvergne-Rhône-Alpes;63;4;20;387;Saint-Priest-Bramefant;859;17;876
84;Auvergne-Rhône-Alpes;63;4;26;388;Saint-Priest-des-Champs;702;17;719
84;Auvergne-Rhône-Alpes;63;3;06;389;Saint-Quentin-sur-Sauxillanges;112;2;114
84;Auvergne-Rhône-Alpes;63;4;27;390;Saint-Quintin-sur-Sioule;383;13;396
84;Auvergne-Rhône-Alpes;63;4;27;391;Saint-Rémy-de-Blot;234;4;238
84;Auvergne-Rhône-Alpes;63;3;06;392;Saint-Rémy-de-Chargnat;580;9;589
84;Auvergne-Rhône-Alpes;63;5;30;393;Saint-Rémy-sur-Durolle;1747;33;1780
84;Auvergne-Rhône-Alpes;63;1;02;394;Saint-Romain;209;6;215
84;Auvergne-Rhône-Alpes;63;2;23;395;Saint-Sandoux;957;19;976
84;Auvergne-Rhône-Alpes;63;2;23;396;Saint-Saturnin;1167;77;1244
84;Auvergne-Rhône-Alpes;63;3;29;397;Saint-Sauves-d'Auvergne;1129;20;1149
84;Auvergne-Rhône-Alpes;63;1;02;398;Saint-Sauveur-la-Sagne;92;3;95
84;Auvergne-Rhône-Alpes;63;4;28;399;Saint-Sulpice;86;6;92
84;Auvergne-Rhône-Alpes;63;4;20;400;Saint-Sylvestre-Pragoulin;1083;19;1102
84;Auvergne-Rhône-Alpes;63;3;29;401;Saint-Victor-la-Rivière;251;6;257
84;Auvergne-Rhône-Alpes;63;5;30;402;Saint-Victor-Montvianeix;250;7;257
84;Auvergne-Rhône-Alpes;63;3;29;403;Saint-Vincent;413;11;424
84;Auvergne-Rhône-Alpes;63;3;18;404;Saint-Yvoine;605;11;616
84;Auvergne-Rhône-Alpes;63;5;30;310;Sainte-Agathe;177;2;179
84;Auvergne-Rhône-Alpes;63;1;22;328;Sainte-Catherine;52;2;54
84;Auvergne-Rhône-Alpes;63;4;26;329;Sainte-Christine;126;5;131
84;Auvergne-Rhône-Alpes;63;2;31;405;Sallèdes;586;12;598
84;Auvergne-Rhône-Alpes;63;4;01;406;Sardon;309;6;315
84;Auvergne-Rhône-Alpes;63;2;23;407;Saulzet-le-Froid;278;7;285
84;Auvergne-Rhône-Alpes;63;4;26;408;Sauret-Besserve;165;5;170
84;Auvergne-Rhône-Alpes;63;3;29;409;Saurier;275;2;277
84;Auvergne-Rhône-Alpes;63;4;28;410;Sauvagnat;134;3;137
84;Auvergne-Rhône-Alpes;63;3;31;411;Sauvagnat-Sainte-Marthe;478;9;487
84;Auvergne-Rhône-Alpes;63;1;02;412;Sauvessanges;528;7;535
84;Auvergne-Rhône-Alpes;63;2;21;413;La Sauvetat;715;12;727
84;Auvergne-Rhône-Alpes;63;5;22;414;Sauviat;544;12;556
84;Auvergne-Rhône-Alpes;63;3;06;415;Sauxillanges;1276;13;1289
84;Auvergne-Rhône-Alpes;63;4;28;416;Savennes;94;3;97
84;Auvergne-Rhône-Alpes;63;4;07;417;Sayat;2387;46;2433
84;Auvergne-Rhône-Alpes;63;5;22;418;Sermentizon;574;9;583
84;Auvergne-Rhône-Alpes;63;4;26;419;Servant;541;12;553
84;Auvergne-Rhône-Alpes;63;5;19;420;Seychalles;789;9;798
84;Auvergne-Rhône-Alpes;63;3;29;421;Singles;163;5;168
84;Auvergne-Rhône-Alpes;63;3;29;422;Solignat;504;9;513
84;Auvergne-Rhône-Alpes;63;3;06;423;Sugères;604;9;613
84;Auvergne-Rhône-Alpes;63;4;01;424;Surat;567;12;579
84;Auvergne-Rhône-Alpes;63;2;21;425;Tallende;1503;42;1545
84;Auvergne-Rhône-Alpes;63;3;29;426;Tauves;772;17;789
84;Auvergne-Rhône-Alpes;63;4;27;427;Teilhède;471;15;486
84;Auvergne-Rhône-Alpes;63;4;26;428;Teilhet;281;2;283
84;Auvergne-Rhône-Alpes;63;3;06;429;Ternant-les-Eaux;34;2;36
84;Auvergne-Rhône-Alpes;63;5;30;430;Thiers;11778;364;12142
84;Auvergne-Rhône-Alpes;63;1;02;431;Thiolières;158;1;159
84;Auvergne-Rhône-Alpes;63;4;01;432;Thuret;918;44;962
84;Auvergne-Rhône-Alpes;63;4;28;433;Tortebesse;71;3;74
84;Auvergne-Rhône-Alpes;63;3;29;192;La Tour-d'Auvergne;635;31;666
84;Auvergne-Rhône-Alpes;63;1;22;434;Tours-sur-Meymont;514;24;538
84;Auvergne-Rhône-Alpes;63;3;29;435;Tourzel-Ronzières;231;7;238
84;Auvergne-Rhône-Alpes;63;4;28;436;Tralaigues;78;0;78
84;Auvergne-Rhône-Alpes;63;3;29;437;Trémouille-Saint-Loup;149;4;153
84;Auvergne-Rhône-Alpes;63;2;05;438;Trézioux;479;5;484
84;Auvergne-Rhône-Alpes;63;3;06;439;Usson;295;2;297
84;Auvergne-Rhône-Alpes;63;3;29;440;Valbeleix;128;0;128
84;Auvergne-Rhône-Alpes;63;1;02;441;Valcivières;208;3;211
84;Auvergne-Rhône-Alpes;63;3;06;442;Valz-sous-Châteauneuf;52;3;55
84;Auvergne-Rhône-Alpes;63;4;01;443;Varennes-sur-Morge;411;12;423
84;Auvergne-Rhône-Alpes;63;3;06;444;Varennes-sur-Usson;293;4;297
84;Auvergne-Rhône-Alpes;63;2;05;445;Vassel;291;5;296
84;Auvergne-Rhône-Alpes;63;4;01;446;Vensat;510;4;514
84;Auvergne-Rhône-Alpes;63;4;26;447;Vergheas;63;4;67
84;Auvergne-Rhône-Alpes;63;3;23;449;Le Vernet-Sainte-Marguerite;297;4;301
84;Auvergne-Rhône-Alpes;63;4;28;450;Verneugheol;239;10;249
84;Auvergne-Rhône-Alpes;63;3;23;451;Vernines;417;23;440
84;Auvergne-Rhône-Alpes;63;3;29;452;Verrières;72;1;73
84;Auvergne-Rhône-Alpes;63;2;05;453;Vertaizon;3184;31;3215
84;Auvergne-Rhône-Alpes;63;1;22;454;Vertolaye;532;10;542
84;Auvergne-Rhône-Alpes;63;2;21;455;Veyre-Monton;3566;56;3622
84;Auvergne-Rhône-Alpes;63;2;31;457;Vic-le-Comte;5191;100;5291
84;Auvergne-Rhône-Alpes;63;3;06;456;Vichel;348;14;362
84;Auvergne-Rhône-Alpes;63;3;06;458;Villeneuve;156;1;157
84;Auvergne-Rhône-Alpes;63;4;20;459;Villeneuve-les-Cerfs;527;4;531
84;Auvergne-Rhône-Alpes;63;4;28;460;Villosanges;363;10;373
84;Auvergne-Rhône-Alpes;63;5;19;461;Vinzelles;354;3;357
84;Auvergne-Rhône-Alpes;63;4;26;462;Virlet;270;5;275
84;Auvergne-Rhône-Alpes;63;5;30;463;Viscomtat;522;9;531
84;Auvergne-Rhône-Alpes;63;4;27;464;Vitrac;349;12;361
84;Auvergne-Rhône-Alpes;63;1;02;465;Viverols;407;9;416
84;Auvergne-Rhône-Alpes;63;3;29;466;Vodable;196;3;199
84;Auvergne-Rhône-Alpes;63;4;28;467;Voingt;31;1;32
84;Auvergne-Rhône-Alpes;63;5;30;468;Vollore-Montagne;302;9;311
84;Auvergne-Rhône-Alpes;63;5;22;469;Vollore-Ville;728;16;744
84;Auvergne-Rhône-Alpes;63;4;09;470;Volvic;4555;70;4625
84;Auvergne-Rhône-Alpes;63;4;26;471;Youx;912;19;931
84;Auvergne-Rhône-Alpes;63;2;31;472;Yronde-et-Buron;652;17;669
84;Auvergne-Rhône-Alpes;63;4;27;473;Yssac-la-Tourette;388;6;394
75;Nouvelle-Aquitaine;64;3;27;001;Aast;185;7;192
75;Nouvelle-Aquitaine;64;3;23;002;Abère;165;1;166
75;Nouvelle-Aquitaine;64;3;09;003;Abidos;220;8;228
75;Nouvelle-Aquitaine;64;2;16;004;Abitain;106;1;107
75;Nouvelle-Aquitaine;64;3;09;005;Abos;539;13;552
75;Nouvelle-Aquitaine;64;2;14;006;Accous;460;12;472
75;Nouvelle-Aquitaine;64;2;14;007;Agnos;1022;25;1047
75;Nouvelle-Aquitaine;64;1;12;008;Ahaxe-Alciette-Bascassan;271;9;280
75;Nouvelle-Aquitaine;64;1;26;009;Ahetze;2114;32;2146
75;Nouvelle-Aquitaine;64;1;22;010;Aïcirits-Camou-Suhast;669;16;685
75;Nouvelle-Aquitaine;64;1;12;011;Aincille;114;6;120
75;Nouvelle-Aquitaine;64;2;12;012;Ainharp;139;1;140
75;Nouvelle-Aquitaine;64;1;12;013;Ainhice-Mongelos;172;5;177
75;Nouvelle-Aquitaine;64;1;26;014;Ainhoa;671;7;678
75;Nouvelle-Aquitaine;64;1;12;016;Aldudes;327;6;333
75;Nouvelle-Aquitaine;64;2;12;017;Alos-Sibas-Abense;323;3;326
75;Nouvelle-Aquitaine;64;2;12;015;Alçay-Alçabéhéty-Sunharette;220;3;223
75;Nouvelle-Aquitaine;64;1;22;018;Amendeuix-Oneix;448;9;457
75;Nouvelle-Aquitaine;64;1;22;019;Amorots-Succos;229;1;230
75;Nouvelle-Aquitaine;64;2;14;225;Ance Féas;613;16;629
75;Nouvelle-Aquitaine;64;3;23;021;Andoins;650;20;670
75;Nouvelle-Aquitaine;64;2;16;022;Andrein;133;3;136
75;Nouvelle-Aquitaine;64;3;27;023;Angaïs;896;23;919
75;Nouvelle-Aquitaine;64;1;96;024;Anglet;39604;1168;40772
75;Nouvelle-Aquitaine;64;2;09;025;Angous;100;5;105
75;Nouvelle-Aquitaine;64;1;12;026;Anhaux;380;10;390
75;Nouvelle-Aquitaine;64;3;23;027;Anos;190;3;193
75;Nouvelle-Aquitaine;64;3;25;028;Anoye;139;2;141
75;Nouvelle-Aquitaine;64;2;14;029;Aramits;666;15;681
75;Nouvelle-Aquitaine;64;1;22;031;Arancou;168;3;171
75;Nouvelle-Aquitaine;64;2;09;032;Araujuzon;189;8;197
75;Nouvelle-Aquitaine;64;2;09;033;Araux;138;1;139
75;Nouvelle-Aquitaine;64;1;22;034;Arbérats-Sillègue;277;5;282
75;Nouvelle-Aquitaine;64;1;26;035;Arbonne;2283;60;2343
75;Nouvelle-Aquitaine;64;1;22;036;Arbouet-Sussaute;319;7;326
75;Nouvelle-Aquitaine;64;3;11;037;Arbus;1213;22;1235
75;Nouvelle-Aquitaine;64;1;26;038;Arcangues;3188;81;3269
75;Nouvelle-Aquitaine;64;2;14;039;Aren;246;1;247
75;Nouvelle-Aquitaine;64;3;17;041;Aressy;737;11;748
75;Nouvelle-Aquitaine;64;2;14;040;Arette;1074;33;1107
75;Nouvelle-Aquitaine;64;3;02;042;Argagnon;705;23;728
75;Nouvelle-Aquitaine;64;3;25;043;Argelos;288;4;292
75;Nouvelle-Aquitaine;64;3;02;044;Arget;78;1;79
75;Nouvelle-Aquitaine;64;1;22;045;Arhansus;74;1;75
75;Nouvelle-Aquitaine;64;1;22;046;Armendarits;402;5;407
75;Nouvelle-Aquitaine;64;1;12;047;Arnéguy;237;3;240
75;Nouvelle-Aquitaine;64;3;02;048;Arnos;123;1;124
75;Nouvelle-Aquitaine;64;1;22;049;Aroue-Ithorots-Olhaïby;236;8;244
75;Nouvelle-Aquitaine;64;2;12;050;Arrast-Larrebieu;95;3;98
75;Nouvelle-Aquitaine;64;1;22;051;Arraute-Charritte;396;5;401
75;Nouvelle-Aquitaine;64;3;25;052;Arricau-Bordes;108;0;108
75;Nouvelle-Aquitaine;64;3;23;053;Arrien;187;3;190
75;Nouvelle-Aquitaine;64;3;17;054;Arros-de-Nay;772;21;793
75;Nouvelle-Aquitaine;64;3;25;056;Arrosès;139;2;141
75;Nouvelle-Aquitaine;64;3;17;058;Arthez-d'Asson;480;10;490
75;Nouvelle-Aquitaine;64;3;02;057;Arthez-de-Béarn;1849;42;1891
75;Nouvelle-Aquitaine;64;3;23;059;Artigueloutan;1090;28;1118
75;Nouvelle-Aquitaine;64;3;11;060;Artiguelouve;1664;46;1710
75;Nouvelle-Aquitaine;64;3;02;061;Artix;3435;64;3499
75;Nouvelle-Aquitaine;64;2;15;062;Arudy;2226;46;2272
75;Nouvelle-Aquitaine;64;3;02;063;Arzacq-Arraziguet;1073;21;1094
75;Nouvelle-Aquitaine;64;2;14;064;Asasp-Arros;455;9;464
75;Nouvelle-Aquitaine;64;1;26;065;Ascain;4209;109;4318
75;Nouvelle-Aquitaine;64;1;12;066;Ascarat;318;9;327
75;Nouvelle-Aquitaine;64;3;17;067;Assat;1850;43;1893
75;Nouvelle-Aquitaine;64;3;17;068;Asson;2018;51;2069
75;Nouvelle-Aquitaine;64;2;15;069;Aste-Béon;234;6;240
75;Nouvelle-Aquitaine;64;3;25;070;Astis;305;1;306
75;Nouvelle-Aquitaine;64;2;16;071;Athos-Aspis;210;5;215
75;Nouvelle-Aquitaine;64;3;08;072;Aubertin;653;14;667
75;Nouvelle-Aquitaine;64;3;25;073;Aubin;249;5;254
75;Nouvelle-Aquitaine;64;3;25;074;Aubous;45;0;45
75;Nouvelle-Aquitaine;64;2;09;075;Audaux;166;61;227
75;Nouvelle-Aquitaine;64;3;25;077;Auga;163;3;166
75;Nouvelle-Aquitaine;64;3;25;078;Auriac;237;6;243
75;Nouvelle-Aquitaine;64;3;25;079;Aurions-Idernes;103;3;106
75;Nouvelle-Aquitaine;64;3;02;080;Aussevielle;779;23;802
75;Nouvelle-Aquitaine;64;2;12;081;Aussurucq;242;2;244
75;Nouvelle-Aquitaine;64;2;16;082;Auterrive;135;1;136
75;Nouvelle-Aquitaine;64;2;16;083;Autevielle-Saint-Martin-Bideren;205;3;208
75;Nouvelle-Aquitaine;64;3;25;084;Aydie;141;2;143
75;Nouvelle-Aquitaine;64;2;14;085;Aydius;111;1;112
75;Nouvelle-Aquitaine;64;1;22;086;Ayherre;1068;33;1101
75;Nouvelle-Aquitaine;64;3;16;087;Baigts-de-Béarn;870;22;892
75;Nouvelle-Aquitaine;64;3;02;088;Balansun;293;9;302
75;Nouvelle-Aquitaine;64;3;23;089;Baleix;143;1;144
75;Nouvelle-Aquitaine;64;3;25;090;Baliracq-Maumusson;121;2;123
75;Nouvelle-Aquitaine;64;3;17;091;Baliros;484;7;491
75;Nouvelle-Aquitaine;64;1;12;092;Banca;347;7;354
75;Nouvelle-Aquitaine;64;2;12;093;Barcus;636;5;641
75;Nouvelle-Aquitaine;64;1;13;094;Bardos;1828;49;1877
75;Nouvelle-Aquitaine;64;3;23;095;Barinque;597;12;609
75;Nouvelle-Aquitaine;64;2;16;096;Barraute-Camu;173;1;174
75;Nouvelle-Aquitaine;64;3;27;097;Barzun;600;11;611
75;Nouvelle-Aquitaine;64;3;25;098;Bassillon-Vauzé;64;2;66
75;Nouvelle-Aquitaine;64;1;26;100;Bassussarry;3179;94;3273
75;Nouvelle-Aquitaine;64;2;09;099;Bastanès;98;4;102
75;Nouvelle-Aquitaine;64;1;22;289;La Bastide-Clairence;970;34;1004
75;Nouvelle-Aquitaine;64;3;27;101;Baudreix;594;120;714
75;Nouvelle-Aquitaine;64;1;97;102;Bayonne;51411;1158;52569
75;Nouvelle-Aquitaine;64;3;23;103;Bédeille;207;3;210
75;Nouvelle-Aquitaine;64;2;14;104;Bedous;600;15;615
75;Nouvelle-Aquitaine;64;1;22;105;Béguios;256;11;267
75;Nouvelle-Aquitaine;64;1;22;106;Béhasque-Lapiste;515;9;524
75;Nouvelle-Aquitaine;64;1;12;107;Béhorléguy;73;3;76
75;Nouvelle-Aquitaine;64;3;16;108;Bellocq;908;11;919
75;Nouvelle-Aquitaine;64;3;27;109;Bénéjacq;1947;44;1991
75;Nouvelle-Aquitaine;64;3;23;111;Bentayou-Sérée;110;1;111
75;Nouvelle-Aquitaine;64;2;15;110;Béost;222;2;224
75;Nouvelle-Aquitaine;64;2;16;112;Bérenx;435;4;439
75;Nouvelle-Aquitaine;64;1;22;113;Bergouey-Viellenave;116;5;121
75;Nouvelle-Aquitaine;64;3;23;114;Bernadets;580;9;589
75;Nouvelle-Aquitaine;64;2;12;115;Berrogain-Laruns;159;68;227
75;Nouvelle-Aquitaine;64;2;15;116;Bescat;250;5;255
75;Nouvelle-Aquitaine;64;3;09;117;Bésingrand;141;4;145
75;Nouvelle-Aquitaine;64;3;25;118;Bétracq;51;0;51
75;Nouvelle-Aquitaine;64;3;27;119;Beuste;649;20;669
75;Nouvelle-Aquitaine;64;3;02;121;Beyrie-en-Béarn;192;2;194
75;Nouvelle-Aquitaine;64;1;22;120;Beyrie-sur-Joyeuse;521;7;528
75;Nouvelle-Aquitaine;64;1;07;122;Biarritz;25532;716;26248
75;Nouvelle-Aquitaine;64;1;22;123;Bidache;1364;26;1390
75;Nouvelle-Aquitaine;64;1;12;124;Bidarray;667;15;682
75;Nouvelle-Aquitaine;64;1;24;125;Bidart;6892;136;7028
75;Nouvelle-Aquitaine;64;2;14;126;Bidos;1121;30;1151
75;Nouvelle-Aquitaine;64;2;15;127;Bielle;390;14;404
75;Nouvelle-Aquitaine;64;2;15;128;Bilhères;160;5;165
75;Nouvelle-Aquitaine;64;3;08;129;Billère;12628;224;12852
75;Nouvelle-Aquitaine;64;1;10;130;Biriatou;1224;20;1244
75;Nouvelle-Aquitaine;64;3;09;131;Biron;658;21;679
75;Nouvelle-Aquitaine;64;3;20;132;Bizanos;4590;126;4716
75;Nouvelle-Aquitaine;64;3;27;133;Boeil-Bezing;1314;26;1340
75;Nouvelle-Aquitaine;64;1;22;134;Bonloc;366;7;373
75;Nouvelle-Aquitaine;64;3;02;135;Bonnut;782;14;796
75;Nouvelle-Aquitaine;64;2;14;136;Borce;135;5;140
75;Nouvelle-Aquitaine;64;3;27;137;Bordères;661;19;680
75;Nouvelle-Aquitaine;64;3;27;138;Bordes;2885;52;2937
75;Nouvelle-Aquitaine;64;3;17;139;Bosdarros;1001;24;1025
75;Nouvelle-Aquitaine;64;1;05;140;Boucau;8489;168;8657
75;Nouvelle-Aquitaine;64;3;25;141;Boueilh-Boueilho-Lasque;362;9;371
75;Nouvelle-Aquitaine;64;3;02;142;Bougarber;834;26;860
75;Nouvelle-Aquitaine;64;3;02;143;Bouillon;157;0;157
75;Nouvelle-Aquitaine;64;3;02;144;Boumourt;160;2;162
75;Nouvelle-Aquitaine;64;3;17;145;Bourdettes;514;8;522
75;Nouvelle-Aquitaine;64;3;25;146;Bournos;332;4;336
75;Nouvelle-Aquitaine;64;1;13;147;Briscous;2879;45;2924
75;Nouvelle-Aquitaine;64;3;17;148;Bruges-Capbis-Mifaget;879;25;904
75;Nouvelle-Aquitaine;64;2;09;149;Bugnein;242;6;248
75;Nouvelle-Aquitaine;64;1;22;150;Bunus;129;2;131
75;Nouvelle-Aquitaine;64;2;16;151;Burgaronne;99;5;104
75;Nouvelle-Aquitaine;64;3;23;152;Buros;1895;53;1948
75;Nouvelle-Aquitaine;64;3;25;153;Burosse-Mendousse;67;1;68
75;Nouvelle-Aquitaine;64;1;12;154;Bussunarits-Sarrasquette;206;1;207
75;Nouvelle-Aquitaine;64;1;12;155;Bustince-Iriberry;103;1;104
75;Nouvelle-Aquitaine;64;2;15;156;Buziet;480;14;494
75;Nouvelle-Aquitaine;64;2;15;157;Buzy;981;22;1003
75;Nouvelle-Aquitaine;64;3;02;158;Cabidos;175;7;182
75;Nouvelle-Aquitaine;64;3;25;159;Cadillon;112;4;116
75;Nouvelle-Aquitaine;64;1;03;160;Cambo-les-Bains;6609;109;6718
75;Nouvelle-Aquitaine;64;1;22;161;Came;981;19;1000
75;Nouvelle-Aquitaine;64;2;12;162;Camou-Cihigue;101;3;104
75;Nouvelle-Aquitaine;64;3;09;165;Cardesse;299;1;300
75;Nouvelle-Aquitaine;64;1;12;166;Caro;198;10;208
75;Nouvelle-Aquitaine;64;3;25;167;Carrère;215;5;220
75;Nouvelle-Aquitaine;64;2;16;168;Carresse-Cassaber;669;15;684
75;Nouvelle-Aquitaine;64;2;16;170;Castagnède;204;2;206
75;Nouvelle-Aquitaine;64;3;02;171;Casteide-Cami;254;2;256
75;Nouvelle-Aquitaine;64;3;02;172;Casteide-Candau;301;3;304
75;Nouvelle-Aquitaine;64;3;23;173;Casteide-Doat;163;1;164
75;Nouvelle-Aquitaine;64;3;23;174;Castéra-Loubix;52;1;53
75;Nouvelle-Aquitaine;64;2;15;175;Castet;155;4;159
75;Nouvelle-Aquitaine;64;2;16;176;Castetbon;174;4;178
75;Nouvelle-Aquitaine;64;3;02;177;Castétis;619;25;644
75;Nouvelle-Aquitaine;64;2;09;178;Castetnau-Camblong;461;15;476
75;Nouvelle-Aquitaine;64;3;09;179;Castetner;134;6;140
75;Nouvelle-Aquitaine;64;3;25;180;Castetpugon;214;5;219
75;Nouvelle-Aquitaine;64;3;02;181;Castillon (Canton d'Arthez-de-Béarn);323;4;327
75;Nouvelle-Aquitaine;64;3;25;182;Castillon (Canton de Lembeye);69;1;70
75;Nouvelle-Aquitaine;64;3;25;183;Caubios-Loos;581;17;598
75;Nouvelle-Aquitaine;64;3;02;184;Cescau;605;27;632
75;Nouvelle-Aquitaine;64;2;14;185;Cette-Eygun;64;1;65
75;Nouvelle-Aquitaine;64;2;09;186;Charre;215;3;218
75;Nouvelle-Aquitaine;64;2;12;187;Charritte-de-Bas;261;9;270
75;Nouvelle-Aquitaine;64;2;12;188;Chéraute;1085;154;1239
75;Nouvelle-Aquitaine;64;1;24;189;Ciboure;6220;179;6399
75;Nouvelle-Aquitaine;64;3;25;190;Claracq;232;8;240
75;Nouvelle-Aquitaine;64;3;27;191;Coarraze;2165;141;2306
75;Nouvelle-Aquitaine;64;3;25;192;Conchez-de-Béarn;116;1;117
75;Nouvelle-Aquitaine;64;3;25;193;Corbère-Abères;103;2;105
75;Nouvelle-Aquitaine;64;3;25;194;Coslédaà-Lube-Boast;388;9;397
75;Nouvelle-Aquitaine;64;3;02;195;Coublucq;98;2;100
75;Nouvelle-Aquitaine;64;3;25;196;Crouseilles;123;0;123
75;Nouvelle-Aquitaine;64;3;09;197;Cuqueron;187;5;192
75;Nouvelle-Aquitaine;64;3;02;198;Denguin;1756;50;1806
75;Nouvelle-Aquitaine;64;3;25;199;Diusse;144;4;148
75;Nouvelle-Aquitaine;64;3;02;200;Doazon;186;3;189
75;Nouvelle-Aquitaine;64;2;09;201;Dognen;224;7;231
75;Nouvelle-Aquitaine;64;1;22;202;Domezain-Berraute;485;19;504
75;Nouvelle-Aquitaine;64;3;25;203;Doumy;311;7;318
75;Nouvelle-Aquitaine;64;2;15;204;Eaux-Bonnes;194;3;197
75;Nouvelle-Aquitaine;64;2;16;205;Escos;237;2;239
75;Nouvelle-Aquitaine;64;2;14;206;Escot;124;1;125
75;Nouvelle-Aquitaine;64;2;15;207;Escou;418;12;430
75;Nouvelle-Aquitaine;64;3;23;208;Escoubès;419;8;427
75;Nouvelle-Aquitaine;64;2;15;209;Escout;438;8;446
75;Nouvelle-Aquitaine;64;3;25;210;Escurès;147;1;148
75;Nouvelle-Aquitaine;64;3;23;211;Eslourenties-Daban;353;4;357
75;Nouvelle-Aquitaine;64;3;23;212;Espéchède;143;2;145
75;Nouvelle-Aquitaine;64;1;03;213;Espelette;1987;47;2034
75;Nouvelle-Aquitaine;64;2;12;214;Espès-Undurein;493;16;509
75;Nouvelle-Aquitaine;64;2;16;215;Espiute;107;3;110
75;Nouvelle-Aquitaine;64;3;27;216;Espoey;1179;46;1225
75;Nouvelle-Aquitaine;64;2;14;217;Esquiule;537;12;549
75;Nouvelle-Aquitaine;64;1;12;218;Estérençuby;337;1;338
75;Nouvelle-Aquitaine;64;2;15;219;Estialescq;264;6;270
75;Nouvelle-Aquitaine;64;2;15;220;Estos;516;12;528
75;Nouvelle-Aquitaine;64;1;22;221;Etcharry;135;29;164
75;Nouvelle-Aquitaine;64;2;12;222;Etchebar;74;0;74
75;Nouvelle-Aquitaine;64;2;14;223;Etsaut;62;2;64
75;Nouvelle-Aquitaine;64;2;14;224;Eysus;642;17;659
75;Nouvelle-Aquitaine;64;3;02;226;Fichous-Riumayou;179;1;180
75;Nouvelle-Aquitaine;64;3;23;227;Gabaston;664;13;677
75;Nouvelle-Aquitaine;64;1;22;228;Gabat;267;2;269
75;Nouvelle-Aquitaine;64;1;12;229;Gamarthe;127;5;132
75;Nouvelle-Aquitaine;64;3;17;230;Gan;5565;107;5672
75;Nouvelle-Aquitaine;64;2;12;231;Garindein;499;8;507
75;Nouvelle-Aquitaine;64;3;25;232;Garlède-Mondebat;221;2;223
75;Nouvelle-Aquitaine;64;3;25;233;Garlin;1371;23;1394
75;Nouvelle-Aquitaine;64;3;02;234;Garos;260;9;269
75;Nouvelle-Aquitaine;64;1;22;235;Garris;281;8;289
75;Nouvelle-Aquitaine;64;3;25;236;Gayon;55;1;56
75;Nouvelle-Aquitaine;64;3;21;237;Gelos;3598;150;3748
75;Nouvelle-Aquitaine;64;3;27;238;Ger;1934;52;1986
75;Nouvelle-Aquitaine;64;3;25;239;Gerderest;137;1;138
75;Nouvelle-Aquitaine;64;2;15;240;Gère-Bélesten;186;7;193
75;Nouvelle-Aquitaine;64;2;14;241;Géronce;466;6;472
75;Nouvelle-Aquitaine;64;2;09;242;Gestas;73;0;73
75;Nouvelle-Aquitaine;64;3;02;243;Géus-d'Arzacq;198;2;200
75;Nouvelle-Aquitaine;64;2;14;244;Geüs-d'Oloron;253;10;263
75;Nouvelle-Aquitaine;64;2;15;245;Goès;600;14;614
75;Nouvelle-Aquitaine;64;3;27;246;Gomer;308;7;315
75;Nouvelle-Aquitaine;64;2;12;247;Gotein-Libarrenx;475;13;488
75;Nouvelle-Aquitaine;64;1;24;249;Guéthary;1329;36;1365
75;Nouvelle-Aquitaine;64;1;13;250;Guiche;979;33;1012
75;Nouvelle-Aquitaine;64;2;16;251;Guinarthe-Parenties;223;8;231
75;Nouvelle-Aquitaine;64;2;14;252;Gurmençon;882;27;909
75;Nouvelle-Aquitaine;64;2;09;253;Gurs;421;10;431
75;Nouvelle-Aquitaine;64;3;02;254;Hagetaubin;571;18;589
75;Nouvelle-Aquitaine;64;1;03;255;Halsou;612;5;617
75;Nouvelle-Aquitaine;64;1;03;256;Hasparren;7173;276;7449
75;Nouvelle-Aquitaine;64;3;17;257;Haut-de-Bosdarros;346;1;347
75;Nouvelle-Aquitaine;64;2;12;258;Haux;84;1;85
75;Nouvelle-Aquitaine;64;1;22;259;Hélette;724;16;740
75;Nouvelle-Aquitaine;64;1;10;260;Hendaye;16805;435;17240
75;Nouvelle-Aquitaine;64;2;15;261;Herrère;388;2;390
75;Nouvelle-Aquitaine;64;3;23;262;Higuères-Souye;275;6;281
75;Nouvelle-Aquitaine;64;2;16;263;L' Hôpital-d'Orion;133;4;137
75;Nouvelle-Aquitaine;64;2;12;264;L' Hôpital-Saint-Blaise;65;2;67
75;Nouvelle-Aquitaine;64;1;22;265;Hosta;87;0;87
75;Nouvelle-Aquitaine;64;3;27;266;Hours;256;10;266
75;Nouvelle-Aquitaine;64;1;22;267;Ibarrolle;79;1;80
75;Nouvelle-Aquitaine;64;2;12;268;Idaux-Mendy;275;4;279
75;Nouvelle-Aquitaine;64;3;19;269;Idron;4928;160;5088
75;Nouvelle-Aquitaine;64;3;27;270;Igon;972;48;1020
75;Nouvelle-Aquitaine;64;1;22;271;Iholdy;545;8;553
75;Nouvelle-Aquitaine;64;1;22;272;Ilharre;149;1;150
75;Nouvelle-Aquitaine;64;1;22;273;Irissarry;897;13;910
75;Nouvelle-Aquitaine;64;1;12;274;Irouléguy;359;2;361
75;Nouvelle-Aquitaine;64;1;12;275;Ispoure;673;13;686
75;Nouvelle-Aquitaine;64;2;14;276;Issor;233;6;239
75;Nouvelle-Aquitaine;64;1;22;277;Isturits;518;13;531
75;Nouvelle-Aquitaine;64;1;03;279;Itxassou;2184;66;2250
75;Nouvelle-Aquitaine;64;2;15;280;Izeste;428;3;431
75;Nouvelle-Aquitaine;64;2;09;281;Jasses;142;3;145
75;Nouvelle-Aquitaine;64;1;03;282;Jatxou;1161;32;1193
75;Nouvelle-Aquitaine;64;1;12;283;Jaxu;198;1;199
75;Nouvelle-Aquitaine;64;3;08;284;Jurançon;7098;244;7342
75;Nouvelle-Aquitaine;64;1;22;285;Juxue;208;6;214
75;Nouvelle-Aquitaine;64;3;09;286;Laà-Mondrans;428;13;441
75;Nouvelle-Aquitaine;64;2;16;287;Laàs;137;3;140
75;Nouvelle-Aquitaine;64;3;02;288;Labastide-Cézéracq;556;13;569
75;Nouvelle-Aquitaine;64;3;02;290;Labastide-Monréjeau;598;17;615
75;Nouvelle-Aquitaine;64;2;16;291;Labastide-Villefranche;322;6;328
75;Nouvelle-Aquitaine;64;3;27;292;Labatmale;255;2;257
75;Nouvelle-Aquitaine;64;3;23;293;Labatut;172;2;174
75;Nouvelle-Aquitaine;64;1;22;294;Labets-Biscay;159;3;162
75;Nouvelle-Aquitaine;64;3;02;295;Labeyrie;119;3;122
75;Nouvelle-Aquitaine;64;3;02;296;Lacadée;152;4;156
75;Nouvelle-Aquitaine;64;1;12;297;Lacarre;172;4;176
75;Nouvelle-Aquitaine;64;2;12;298;Lacarry-Arhan-Charritte-de-Haut;130;0;130
75;Nouvelle-Aquitaine;64;3;09;299;Lacommande;204;7;211
75;Nouvelle-Aquitaine;64;3;02;300;Lacq;729;12;741
75;Nouvelle-Aquitaine;64;3;09;301;Lagor;1176;31;1207
75;Nouvelle-Aquitaine;64;3;27;302;Lagos;467;12;479
75;Nouvelle-Aquitaine;64;2;12;303;Laguinge-Restoue;157;8;165
75;Nouvelle-Aquitaine;64;1;13;304;Lahonce;2462;54;2516
75;Nouvelle-Aquitaine;64;2;16;305;Lahontan;515;12;527
75;Nouvelle-Aquitaine;64;3;09;306;Lahourcade;698;21;719
75;Nouvelle-Aquitaine;64;3;25;307;Lalongue;210;3;213
75;Nouvelle-Aquitaine;64;3;25;308;Lalonquette;269;5;274
75;Nouvelle-Aquitaine;64;3;23;309;Lamayou;204;5;209
75;Nouvelle-Aquitaine;64;2;14;310;Lanne-en-Barétous;494;8;502
75;Nouvelle-Aquitaine;64;3;25;311;Lannecaube;157;2;159
75;Nouvelle-Aquitaine;64;3;16;312;Lanneplaà;305;9;314
75;Nouvelle-Aquitaine;64;1;22;313;Lantabat;279;5;284
75;Nouvelle-Aquitaine;64;1;22;314;Larceveau-Arros-Cibits;425;3;428
75;Nouvelle-Aquitaine;64;3;08;315;Laroin;1084;26;1110
75;Nouvelle-Aquitaine;64;2;12;316;Larrau;197;2;199
75;Nouvelle-Aquitaine;64;1;03;317;Larressore;2098;31;2129
75;Nouvelle-Aquitaine;64;3;02;318;Larreule;181;5;186
75;Nouvelle-Aquitaine;64;1;22;319;Larribar-Sorhapuru;186;0;186
75;Nouvelle-Aquitaine;64;2;15;320;Laruns;1190;23;1213
75;Nouvelle-Aquitaine;64;3;25;321;Lasclaveries;240;5;245
75;Nouvelle-Aquitaine;64;1;12;322;Lasse;335;6;341
75;Nouvelle-Aquitaine;64;3;25;323;Lasserre;96;3;99
75;Nouvelle-Aquitaine;64;2;15;324;Lasseube;1743;39;1782
75;Nouvelle-Aquitaine;64;2;15;325;Lasseubetat;208;4;212
75;Nouvelle-Aquitaine;64;2;09;326;Lay-Lamidou;118;4;122
75;Nouvelle-Aquitaine;64;1;12;327;Lecumberry;173;4;177
75;Nouvelle-Aquitaine;64;2;15;328;Ledeuix;1029;29;1058
75;Nouvelle-Aquitaine;64;3;23;329;Lée;1260;58;1318
75;Nouvelle-Aquitaine;64;2;14;330;Lées-Athas;257;10;267
75;Nouvelle-Aquitaine;64;3;25;331;Lembeye;762;16;778
75;Nouvelle-Aquitaine;64;3;25;332;Lème;166;4;170
75;Nouvelle-Aquitaine;64;2;16;334;Léren;219;3;222
75;Nouvelle-Aquitaine;64;3;11;335;Lescar;9735;421;10156
75;Nouvelle-Aquitaine;64;2;14;336;Lescun;166;1;167
75;Nouvelle-Aquitaine;64;3;25;337;Lespielle;153;3;156
75;Nouvelle-Aquitaine;64;3;23;338;Lespourcy;190;6;196
75;Nouvelle-Aquitaine;64;3;27;339;Lestelle-Bétharram;828;81;909
75;Nouvelle-Aquitaine;64;2;12;340;Lichans-Sunhar;83;1;84
75;Nouvelle-Aquitaine;64;2;12;341;Lichos;134;1;135
75;Nouvelle-Aquitaine;64;2;12;342;Licq-Athérey;204;7;211
75;Nouvelle-Aquitaine;64;3;27;343;Limendous;725;8;733
75;Nouvelle-Aquitaine;64;3;27;344;Livron;393;16;409
75;Nouvelle-Aquitaine;64;1;22;345;Lohitzun-Oyhercq;202;1;203
75;Nouvelle-Aquitaine;64;3;23;346;Lombia;207;1;208
75;Nouvelle-Aquitaine;64;3;11;348;Lons;13720;256;13976
75;Nouvelle-Aquitaine;64;3;02;347;Lonçon;204;3;207
75;Nouvelle-Aquitaine;64;3;09;349;Loubieng;510;18;528
75;Nouvelle-Aquitaine;64;1;03;350;Louhossoa;869;18;887
75;Nouvelle-Aquitaine;64;2;14;351;Lourdios-Ichère;138;9;147
75;Nouvelle-Aquitaine;64;3;27;352;Lourenties;376;9;385
75;Nouvelle-Aquitaine;64;2;15;353;Louvie-Juzon;1049;29;1078
75;Nouvelle-Aquitaine;64;2;15;354;Louvie-Soubiron;121;1;122
75;Nouvelle-Aquitaine;64;3;02;355;Louvigny;139;2;141
75;Nouvelle-Aquitaine;64;3;25;356;Luc-Armau;112;0;112
75;Nouvelle-Aquitaine;64;3;25;357;Lucarré;61;0;61
75;Nouvelle-Aquitaine;64;3;27;358;Lucgarier;248;1;249
75;Nouvelle-Aquitaine;64;3;09;359;Lucq-de-Béarn;927;20;947
75;Nouvelle-Aquitaine;64;2;14;360;Lurbe-Saint-Christau;193;6;199
75;Nouvelle-Aquitaine;64;3;25;361;Lussagnet-Lusson;175;8;183
75;Nouvelle-Aquitaine;64;1;22;362;Luxe-Sumberraute;406;22;428
75;Nouvelle-Aquitaine;64;2;15;363;Lys;329;4;333
75;Nouvelle-Aquitaine;64;1;03;364;Macaye;585;10;595
75;Nouvelle-Aquitaine;64;3;02;365;Malaussanne;412;7;419
75;Nouvelle-Aquitaine;64;3;25;366;Mascaraàs-Haron;126;0;126
75;Nouvelle-Aquitaine;64;3;09;367;Maslacq;886;25;911
75;Nouvelle-Aquitaine;64;1;22;368;Masparraute;242;7;249
75;Nouvelle-Aquitaine;64;3;25;369;Maspie-Lalonquère-Juillacq;256;12;268
75;Nouvelle-Aquitaine;64;3;23;370;Maucor;547;15;562
75;Nouvelle-Aquitaine;64;2;12;371;Mauléon-Licharre;2950;232;3182
75;Nouvelle-Aquitaine;64;3;23;372;Maure;99;1;100
75;Nouvelle-Aquitaine;64;3;20;373;Mazères-Lezons;1820;43;1863
75;Nouvelle-Aquitaine;64;3;02;374;Mazerolles;1120;19;1139
75;Nouvelle-Aquitaine;64;1;22;375;Méharin;276;4;280
75;Nouvelle-Aquitaine;64;3;17;376;Meillon;922;26;948
75;Nouvelle-Aquitaine;64;1;22;377;Mendionde;845;23;868
75;Nouvelle-Aquitaine;64;2;12;378;Menditte;200;128;328
75;Nouvelle-Aquitaine;64;1;12;379;Mendive;163;5;168
75;Nouvelle-Aquitaine;64;3;02;380;Méracq;229;5;234
75;Nouvelle-Aquitaine;64;2;09;381;Méritein;285;9;294
75;Nouvelle-Aquitaine;64;3;02;382;Mesplède;355;10;365
75;Nouvelle-Aquitaine;64;3;02;383;Mialos;129;1;130
75;Nouvelle-Aquitaine;64;3;25;385;Miossens-Lanusse;273;2;275
75;Nouvelle-Aquitaine;64;3;27;386;Mirepeix;1267;26;1293
75;Nouvelle-Aquitaine;64;3;02;387;Momas;598;12;610
75;Nouvelle-Aquitaine;64;3;23;388;Momy;122;1;123
75;Nouvelle-Aquitaine;64;3;25;389;Monassut-Audiracq;362;6;368
75;Nouvelle-Aquitaine;64;3;25;390;Moncaup;157;12;169
75;Nouvelle-Aquitaine;64;2;12;391;Moncayolle-Larrory-Mendibieu;309;7;316
75;Nouvelle-Aquitaine;64;3;25;392;Moncla;84;2;86
75;Nouvelle-Aquitaine;64;3;09;393;Monein;4428;104;4532
75;Nouvelle-Aquitaine;64;3;25;394;Monpezat;85;1;86
75;Nouvelle-Aquitaine;64;3;23;395;Monségur;127;0;127
75;Nouvelle-Aquitaine;64;3;02;396;Mont;1131;95;1226
75;Nouvelle-Aquitaine;64;3;25;401;Mont-Disse;75;1;76
75;Nouvelle-Aquitaine;64;3;02;397;Montagut;117;6;123
75;Nouvelle-Aquitaine;64;3;23;398;Montaner;431;8;439
75;Nouvelle-Aquitaine;64;3;25;399;Montardon;2305;305;2610
75;Nouvelle-Aquitaine;64;3;27;400;Montaut;1113;46;1159
75;Nouvelle-Aquitaine;64;2;16;403;Montfort;179;3;182
75;Nouvelle-Aquitaine;64;2;12;404;Montory;310;8;318
75;Nouvelle-Aquitaine;64;3;23;405;Morlaàs;4294;258;4552
75;Nouvelle-Aquitaine;64;3;02;406;Morlanne;602;16;618
75;Nouvelle-Aquitaine;64;1;13;407;Mouguerre;5201;145;5346
75;Nouvelle-Aquitaine;64;3;25;408;Mouhous;57;0;57
75;Nouvelle-Aquitaine;64;2;14;409;Moumour;833;22;855
75;Nouvelle-Aquitaine;64;3;09;410;Mourenx;6341;185;6526
75;Nouvelle-Aquitaine;64;2;12;411;Musculdy;237;3;240
75;Nouvelle-Aquitaine;64;2;09;412;Nabas;101;1;102
75;Nouvelle-Aquitaine;64;3;17;413;Narcastet;758;12;770
75;Nouvelle-Aquitaine;64;2;16;414;Narp;114;2;116
75;Nouvelle-Aquitaine;64;3;25;415;Navailles-Angos;1522;33;1555
75;Nouvelle-Aquitaine;64;2;09;416;Navarrenx;1052;23;1075
75;Nouvelle-Aquitaine;64;3;17;417;Nay;3268;236;3504
75;Nouvelle-Aquitaine;64;3;09;418;Noguères;140;3;143
75;Nouvelle-Aquitaine;64;3;27;419;Nousty;1603;30;1633
75;Nouvelle-Aquitaine;64;2;09;420;Ogenne-Camptort;245;5;250
75;Nouvelle-Aquitaine;64;2;15;421;Ogeu-les-Bains;1282;29;1311
75;Nouvelle-Aquitaine;64;2;98;422;Oloron-Sainte-Marie;10629;649;11278
75;Nouvelle-Aquitaine;64;2;16;423;Oraàs;179;3;182
75;Nouvelle-Aquitaine;64;2;12;424;Ordiarp;534;4;538
75;Nouvelle-Aquitaine;64;1;22;425;Orègue;484;9;493
75;Nouvelle-Aquitaine;64;2;14;426;Orin;241;10;251
75;Nouvelle-Aquitaine;64;2;16;427;Orion;146;2;148
75;Nouvelle-Aquitaine;64;2;16;428;Orriule;135;1;136
75;Nouvelle-Aquitaine;64;1;22;429;Orsanco;113;4;117
75;Nouvelle-Aquitaine;64;3;16;430;Orthez;10515;708;11223
75;Nouvelle-Aquitaine;64;3;09;431;Os-Marsillon;534;9;543
75;Nouvelle-Aquitaine;64;2;12;432;Ossas-Suhare;85;1;86
75;Nouvelle-Aquitaine;64;2;14;433;Osse-en-Aspe;328;19;347
75;Nouvelle-Aquitaine;64;2;16;434;Ossenx;51;1;52
75;Nouvelle-Aquitaine;64;1;22;435;Osserain-Rivareyte;213;9;222
75;Nouvelle-Aquitaine;64;1;12;436;Ossès;826;23;849
75;Nouvelle-Aquitaine;64;1;22;437;Ostabat-Asme;194;2;196
75;Nouvelle-Aquitaine;64;3;23;438;Ouillon;545;13;558
75;Nouvelle-Aquitaine;64;3;23;439;Ousse;1659;50;1709
75;Nouvelle-Aquitaine;64;3;09;440;Ozenx-Montestrucq;386;17;403
75;Nouvelle-Aquitaine;64;1;22;441;Pagolle;260;5;265
75;Nouvelle-Aquitaine;64;3;09;442;Parbayse;331;11;342
75;Nouvelle-Aquitaine;64;3;09;443;Pardies;855;23;878
75;Nouvelle-Aquitaine;64;3;17;444;Pardies-Piétat;454;11;465
75;Nouvelle-Aquitaine;64;3;99;445;Pau;76275;1451;77726
75;Nouvelle-Aquitaine;64;3;25;446;Peyrelongue-Abos;152;1;153
75;Nouvelle-Aquitaine;64;3;02;447;Piets-Plasence-Moustrou;139;1;140
75;Nouvelle-Aquitaine;64;2;15;449;Poey-d'Oloron;165;3;168
75;Nouvelle-Aquitaine;64;3;11;448;Poey-de-Lescar;1713;48;1761
75;Nouvelle-Aquitaine;64;3;02;450;Pomps;291;6;297
75;Nouvelle-Aquitaine;64;3;23;451;Ponson-Debat-Pouts;96;3;99
75;Nouvelle-Aquitaine;64;3;27;452;Ponson-Dessus;259;7;266
75;Nouvelle-Aquitaine;64;3;27;453;Pontacq;2930;57;2987
75;Nouvelle-Aquitaine;64;3;23;454;Pontiacq-Viellepinte;185;2;187
75;Nouvelle-Aquitaine;64;3;25;455;Portet;168;3;171
75;Nouvelle-Aquitaine;64;3;25;456;Pouliacq;52;3;55
75;Nouvelle-Aquitaine;64;3;02;457;Poursiugues-Boucoue;188;4;192
75;Nouvelle-Aquitaine;64;2;14;458;Préchacq-Josbaig;295;8;303
75;Nouvelle-Aquitaine;64;2;09;459;Préchacq-Navarrenx;169;2;171
75;Nouvelle-Aquitaine;64;2;15;460;Précilhon;411;7;418
75;Nouvelle-Aquitaine;64;3;16;461;Puyoô;1132;16;1148
75;Nouvelle-Aquitaine;64;3;16;462;Ramous;495;6;501
75;Nouvelle-Aquitaine;64;2;15;463;Rébénacq;672;6;678
75;Nouvelle-Aquitaine;64;3;25;464;Ribarrouy;83;1;84
75;Nouvelle-Aquitaine;64;3;23;465;Riupeyrous;219;3;222
75;Nouvelle-Aquitaine;64;2;09;466;Rivehaute;264;7;271
75;Nouvelle-Aquitaine;64;3;17;467;Rontignon;841;16;857
75;Nouvelle-Aquitaine;64;2;12;468;Roquiague;124;2;126
75;Nouvelle-Aquitaine;64;3;17;469;Saint-Abit;314;8;322
75;Nouvelle-Aquitaine;64;3;23;470;Saint-Armou;640;20;660
75;Nouvelle-Aquitaine;64;3;16;471;Saint-Boès;364;12;376
75;Nouvelle-Aquitaine;64;3;23;472;Saint-Castin;877;11;888
75;Nouvelle-Aquitaine;64;2;16;474;Saint-Dos;158;2;160
75;Nouvelle-Aquitaine;64;1;22;476;Saint-Esteben;409;6;415
75;Nouvelle-Aquitaine;64;1;12;477;Saint-Étienne-de-Baïgorry;1480;39;1519
75;Nouvelle-Aquitaine;64;3;08;478;Saint-Faust;743;26;769
75;Nouvelle-Aquitaine;64;3;16;479;Saint-Girons-en-Béarn;159;4;163
75;Nouvelle-Aquitaine;64;2;16;480;Saint-Gladie-Arrive-Munein;199;5;204
75;Nouvelle-Aquitaine;64;2;14;481;Saint-Goin;237;4;241
75;Nouvelle-Aquitaine;64;3;23;482;Saint-Jammes;623;8;631
75;Nouvelle-Aquitaine;64;1;24;483;Saint-Jean-de-Luz;14198;424;14622
75;Nouvelle-Aquitaine;64;1;12;484;Saint-Jean-le-Vieux;847;17;864
75;Nouvelle-Aquitaine;64;1;12;485;Saint-Jean-Pied-de-Port;1553;290;1843
75;Nouvelle-Aquitaine;64;3;25;486;Saint-Jean-Poudge;70;0;70
75;Nouvelle-Aquitaine;64;1;22;487;Saint-Just-Ibarre;215;5;220
75;Nouvelle-Aquitaine;64;3;23;488;Saint-Laurent-Bretagne;444;12;456
75;Nouvelle-Aquitaine;64;1;22;489;Saint-Martin-d'Arberoue;324;10;334
75;Nouvelle-Aquitaine;64;1;12;490;Saint-Martin-d'Arrossa;538;15;553
75;Nouvelle-Aquitaine;64;3;02;491;Saint-Médard;206;5;211
75;Nouvelle-Aquitaine;64;1;12;492;Saint-Michel;294;6;300
75;Nouvelle-Aquitaine;64;1;22;493;Saint-Palais;1840;67;1907
75;Nouvelle-Aquitaine;64;2;16;494;Saint-Pé-de-Léren;258;6;264
75;Nouvelle-Aquitaine;64;1;26;495;Saint-Pée-sur-Nivelle;6888;149;7037
75;Nouvelle-Aquitaine;64;1;13;496;Saint-Pierre-d'Irube;5167;92;5259
75;Nouvelle-Aquitaine;64;3;27;498;Saint-Vincent;397;10;407
75;Nouvelle-Aquitaine;64;2;15;473;Sainte-Colome;356;4;360
75;Nouvelle-Aquitaine;64;2;12;475;Sainte-Engrâce;193;1;194
75;Nouvelle-Aquitaine;64;2;16;499;Salies-de-Béarn;4589;129;4718
75;Nouvelle-Aquitaine;64;3;16;500;Salles-Mongiscard;303;6;309
75;Nouvelle-Aquitaine;64;3;02;501;Sallespisse;574;8;582
75;Nouvelle-Aquitaine;64;1;13;502;Sames;703;6;709
75;Nouvelle-Aquitaine;64;3;25;503;Samsons-Lion;89;1;90
75;Nouvelle-Aquitaine;64;1;26;504;Sare;2670;37;2707
75;Nouvelle-Aquitaine;64;3;09;505;Sarpourenx;323;14;337
75;Nouvelle-Aquitaine;64;2;14;506;Sarrance;163;3;166
75;Nouvelle-Aquitaine;64;3;23;507;Saubole;142;3;145
75;Nouvelle-Aquitaine;64;2;15;508;Saucède;129;2;131
75;Nouvelle-Aquitaine;64;2;12;509;Sauguis-Saint-Étienne;170;4;174
75;Nouvelle-Aquitaine;64;3;02;510;Sault-de-Navailles;920;19;939
75;Nouvelle-Aquitaine;64;3;25;511;Sauvagnon;3362;85;3447
75;Nouvelle-Aquitaine;64;3;09;512;Sauvelade;268;4;272
75;Nouvelle-Aquitaine;64;2;16;513;Sauveterre-de-Béarn;1362;96;1458
75;Nouvelle-Aquitaine;64;3;02;514;Séby;194;7;201
75;Nouvelle-Aquitaine;64;3;23;515;Sedze-Maubecq;263;4;267
75;Nouvelle-Aquitaine;64;3;23;516;Sedzère;381;3;384
75;Nouvelle-Aquitaine;64;3;25;517;Séméacq-Blachon;163;8;171
75;Nouvelle-Aquitaine;64;3;23;518;Sendets;1020;20;1040
75;Nouvelle-Aquitaine;64;3;25;519;Serres-Castet;4302;125;4427
75;Nouvelle-Aquitaine;64;3;23;520;Serres-Morlaàs;782;31;813
75;Nouvelle-Aquitaine;64;3;02;521;Serres-Sainte-Marie;566;17;583
75;Nouvelle-Aquitaine;64;3;25;523;Sévignacq;752;14;766
75;Nouvelle-Aquitaine;64;2;15;522;Sévignacq-Meyracq;532;15;547
75;Nouvelle-Aquitaine;64;3;25;524;Simacourbe;411;2;413
75;Nouvelle-Aquitaine;64;3;11;525;Siros;765;14;779
75;Nouvelle-Aquitaine;64;3;27;526;Soumoulou;1581;20;1601
75;Nouvelle-Aquitaine;64;1;03;527;Souraïde;1407;27;1434
75;Nouvelle-Aquitaine;64;1;22;528;Suhescun;172;8;180
75;Nouvelle-Aquitaine;64;2;09;529;Sus;376;11;387
75;Nouvelle-Aquitaine;64;2;09;530;Susmiou;350;7;357
75;Nouvelle-Aquitaine;64;2;16;531;Tabaille-Usquain;46;2;48
75;Nouvelle-Aquitaine;64;3;25;532;Tadousse-Ussau;68;1;69
75;Nouvelle-Aquitaine;64;2;12;533;Tardets-Sorholus;551;9;560
75;Nouvelle-Aquitaine;64;3;25;534;Taron-Sadirac-Viellenave;192;0;192
75;Nouvelle-Aquitaine;64;3;09;535;Tarsacq;524;6;530
75;Nouvelle-Aquitaine;64;3;25;536;Thèze;849;16;865
75;Nouvelle-Aquitaine;64;2;12;537;Trois-Villes;129;4;133
75;Nouvelle-Aquitaine;64;1;12;538;Uhart-Cize;805;16;821
75;Nouvelle-Aquitaine;64;1;22;539;Uhart-Mixe;210;5;215
75;Nouvelle-Aquitaine;64;1;13;540;Urcuit;2606;73;2679
75;Nouvelle-Aquitaine;64;3;02;541;Urdès;303;3;306
75;Nouvelle-Aquitaine;64;2;14;542;Urdos;65;1;66
75;Nouvelle-Aquitaine;64;1;12;543;Urepel;280;7;287
75;Nouvelle-Aquitaine;64;3;23;544;Urost;76;2;78
75;Nouvelle-Aquitaine;64;1;10;545;Urrugne;10432;192;10624
75;Nouvelle-Aquitaine;64;1;13;546;Urt;2316;34;2350
75;Nouvelle-Aquitaine;64;1;26;547;Ustaritz;6818;257;7075
75;Nouvelle-Aquitaine;64;3;02;548;Uzan;168;4;172
75;Nouvelle-Aquitaine;64;3;11;549;Uzein;1229;24;1253
75;Nouvelle-Aquitaine;64;3;17;550;Uzos;759;30;789
75;Nouvelle-Aquitaine;64;2;15;551;Verdets;278;4;282
75;Nouvelle-Aquitaine;64;3;25;552;Vialer;185;3;188
75;Nouvelle-Aquitaine;64;3;02;554;Viellenave-d'Arthez;204;3;207
75;Nouvelle-Aquitaine;64;2;09;555;Viellenave-de-Navarrenx;164;2;166
75;Nouvelle-Aquitaine;64;3;09;556;Vielleségure;377;8;385
75;Nouvelle-Aquitaine;64;3;02;557;Vignes;454;22;476
75;Nouvelle-Aquitaine;64;1;13;558;Villefranque;2747;76;2823
75;Nouvelle-Aquitaine;64;2;12;559;Viodos-Abense-de-Bas;720;16;736
75;Nouvelle-Aquitaine;64;3;25;560;Viven;183;0;183
76;Occitanie;65;1;16;001;Adast;295;7;302
76;Occitanie;65;1;06;002;Adé;814;10;824
76;Occitanie;65;2;08;003;Adervielle-Pouchergues;136;1;137
76;Occitanie;65;1;16;004;Agos-Vidalos;407;10;417
76;Occitanie;65;3;07;005;Allier;422;11;433
76;Occitanie;65;2;08;006;Ancizan;272;8;280
76;Occitanie;65;3;17;007;Andrest;1388;26;1414
76;Occitanie;65;2;15;009;Anères;172;4;176
76;Occitanie;65;1;06;011;Les Angles;130;3;133
76;Occitanie;65;3;07;010;Angos;224;4;228
76;Occitanie;65;2;15;012;Anla;86;2;88
76;Occitanie;65;3;13;013;Ansost;57;2;59
76;Occitanie;65;2;15;014;Antichan;38;0;38
76;Occitanie;65;3;03;015;Antin;108;7;115
76;Occitanie;65;2;04;016;Antist;182;3;185
76;Occitanie;65;2;08;017;Aragnouet;249;2;251
76;Occitanie;65;1;16;018;Arbéost;84;1;85
76;Occitanie;65;3;07;019;Arcizac-Adour;547;11;558
76;Occitanie;65;1;06;020;Arcizac-ez-Angles;261;5;266
76;Occitanie;65;1;16;021;Arcizans-Avant;393;15;408
76;Occitanie;65;1;16;022;Arcizans-Dessus;121;7;128
76;Occitanie;65;2;08;023;Ardengost;13;0;13
76;Occitanie;65;2;14;024;Argelès-Bagnères;106;3;109
76;Occitanie;65;1;16;025;Argelès-Gazost;2901;169;3070
76;Occitanie;65;3;03;026;Aries-Espénan;73;0;73
76;Occitanie;65;2;15;028;Arné;210;5;215
76;Occitanie;65;1;16;029;Arras-en-Lavedan;485;11;496
76;Occitanie;65;1;06;247;Arrayou-Lahitte;105;1;106
76;Occitanie;65;2;08;031;Arreau;784;27;811
76;Occitanie;65;1;16;032;Arrens-Marsous;714;21;735
76;Occitanie;65;2;14;034;Arrodets;20;0;20
76;Occitanie;65;1;06;033;Arrodets-ez-Angles;112;3;115
76;Occitanie;65;3;17;035;Artagnan;513;12;525
76;Occitanie;65;1;16;036;Artalens-Souin;129;3;132
76;Occitanie;65;2;14;037;Artiguemy;90;1;91
76;Occitanie;65;1;06;038;Artigues;15;1;16
76;Occitanie;65;2;08;039;Aspin-Aure;41;0;41
76;Occitanie;65;1;05;040;Aspin-en-Lavedan;328;3;331
76;Occitanie;65;2;14;041;Asque;119;7;126
76;Occitanie;65;2;04;042;Asté;566;12;578
76;Occitanie;65;2;04;043;Astugue;262;7;269
76;Occitanie;65;3;03;044;Aubarède;295;6;301
76;Occitanie;65;1;16;045;Aucun;233;9;242
76;Occitanie;65;2;08;046;Aulon;89;3;92
76;Occitanie;65;3;01;047;Aureilhan;7849;222;8071
76;Occitanie;65;3;17;048;Aurensan;788;10;798
76;Occitanie;65;3;13;049;Auriébat;244;3;247
76;Occitanie;65;2;08;050;Avajan;79;2;81
76;Occitanie;65;2;15;051;Aventignan;208;7;215
76;Occitanie;65;3;09;052;Averan;66;0;66
76;Occitanie;65;2;15;053;Aveux;42;1;43
76;Occitanie;65;2;08;054;Avezac-Prat-Lahitte;606;8;614
76;Occitanie;65;1;16;055;Ayros-Arbouix;324;11;335
76;Occitanie;65;1;16;056;Ayzac-Ost;445;13;458
76;Occitanie;65;3;09;057;Azereix;983;16;999
76;Occitanie;65;2;08;058;Azet;143;2;145
76;Occitanie;65;2;04;059;Bagnères-de-Bigorre;7103;283;7386
76;Occitanie;65;2;14;060;Banios;56;3;59
76;Occitanie;65;3;13;061;Barbachen;52;0;52
76;Occitanie;65;3;07;062;Barbazan-Debat;3481;75;3556
76;Occitanie;65;3;14;063;Barbazan-Dessus;170;3;173
76;Occitanie;65;1;16;481;Barèges;161;5;166
76;Occitanie;65;2;08;064;Bareilles;48;1;49
76;Occitanie;65;1;05;065;Barlest;289;8;297
76;Occitanie;65;2;08;066;Barrancoueu;33;0;33
76;Occitanie;65;3;09;067;Barry;126;7;133
76;Occitanie;65;3;03;068;Barthe;21;1;22
76;Occitanie;65;2;08;069;La Barthe-de-Neste;1225;30;1255
76;Occitanie;65;1;05;070;Bartrès;527;17;544
76;Occitanie;65;2;14;071;Batsère;34;0;34
76;Occitanie;65;3;02;072;Bazet;1786;14;1800
76;Occitanie;65;3;13;073;Bazillac;351;7;358
76;Occitanie;65;3;03;074;Bazordan;111;2;113
76;Occitanie;65;2;08;075;Bazus-Aure;131;7;138
76;Occitanie;65;2;08;076;Bazus-Neste;60;2;62
76;Occitanie;65;1;16;077;Beaucens;414;23;437
76;Occitanie;65;2;04;078;Beaudéan;399;10;409
76;Occitanie;65;3;14;079;Bégole;200;4;204
76;Occitanie;65;3;09;080;Bénac;552;9;561
76;Occitanie;65;2;14;081;Benqué-Molère;130;3;133
76;Occitanie;65;1;06;082;Berbérust-Lias;51;0;51
76;Occitanie;65;3;07;083;Bernac-Debat;694;17;711
76;Occitanie;65;3;07;084;Bernac-Dessus;293;3;296
76;Occitanie;65;3;03;085;Bernadets-Debat;112;2;114
76;Occitanie;65;3;14;086;Bernadets-Dessus;153;6;159
76;Occitanie;65;2;15;087;Bertren;176;5;181
76;Occitanie;65;3;03;088;Betbèze;44;1;45
76;Occitanie;65;1;16;089;Betpouey;86;3;89
76;Occitanie;65;3;03;090;Betpouy;78;3;81
76;Occitanie;65;2;14;091;Bettes;53;1;54
76;Occitanie;65;2;08;092;Beyrède-Jumet-Camous ;221;2;223
76;Occitanie;65;2;15;093;Bize;212;8;220
76;Occitanie;65;2;15;094;Bizous;116;1;117
76;Occitanie;65;3;03;095;Bonnefont;331;11;342
76;Occitanie;65;2;14;096;Bonnemazon;64;3;67
76;Occitanie;65;2;14;097;Bonrepos;188;8;196
76;Occitanie;65;1;16;098;Boô-Silhen;315;7;322
76;Occitanie;65;2;08;099;Bordères-Louron;144;3;147
76;Occitanie;65;3;02;100;Bordères-sur-l'Échez;5340;113;5453
76;Occitanie;65;3;14;101;Bordes;762;12;774
76;Occitanie;65;3;13;102;Bouilh-Devant;20;2;22
76;Occitanie;65;3;03;103;Bouilh-Péreuilh;101;1;102
76;Occitanie;65;3;03;104;Boulin;292;9;301
76;Occitanie;65;2;14;105;Bourg-de-Bigorre;196;3;199
76;Occitanie;65;2;08;106;Bourisp;164;4;168
76;Occitanie;65;1;06;107;Bourréac;109;2;111
76;Occitanie;65;3;02;108;Bours;847;19;866
76;Occitanie;65;2;15;109;Bramevaque;32;1;33
76;Occitanie;65;3;03;110;Bugard;93;0;93
76;Occitanie;65;2;14;111;Bulan;63;0;63
76;Occitanie;65;1;16;112;Bun;151;5;156
76;Occitanie;65;3;14;113;Burg;279;11;290
76;Occitanie;65;3;13;114;Buzon;77;4;81
76;Occitanie;65;3;03;115;Cabanac;287;10;297
76;Occitanie;65;2;08;116;Cadéac;300;5;305
76;Occitanie;65;2;08;117;Cadeilhan-Trachère;41;1;42
76;Occitanie;65;3;14;118;Caharet;38;1;39
76;Occitanie;65;3;17;119;Caixon;379;12;391
76;Occitanie;65;3;14;120;Calavanté;336;14;350
76;Occitanie;65;3;17;121;Camalès;392;11;403
76;Occitanie;65;2;04;123;Campan;1327;54;1381
76;Occitanie;65;2;08;124;Camparan;56;2;58
76;Occitanie;65;2;15;125;Campistrous;314;7;321
76;Occitanie;65;3;03;126;Campuzan;151;5;156
76;Occitanie;65;2;15;482;Cantaous;442;11;453
76;Occitanie;65;2;08;127;Capvern;1267;26;1293
76;Occitanie;65;2;14;128;Castelbajac;137;3;140
76;Occitanie;65;3;03;129;Castelnau-Magnoac;799;22;821
76;Occitanie;65;3;13;130;Castelnau-Rivière-Basse;623;13;636
76;Occitanie;65;3;03;131;Castelvieilh;245;2;247
76;Occitanie;65;3;14;132;Castéra-Lanusse;45;0;45
76;Occitanie;65;3;03;133;Castéra-Lou;234;4;238
76;Occitanie;65;3;03;134;Casterets;13;0;13
76;Occitanie;65;2;14;135;Castillon;83;0;83
76;Occitanie;65;3;03;136;Caubous;37;0;37
76;Occitanie;65;3;13;137;Caussade-Rivière;97;3;100
76;Occitanie;65;1;16;138;Cauterets;893;19;912
76;Occitanie;65;2;15;139;Cazarilh;54;1;55
76;Occitanie;65;2;08;140;Cazaux-Debat;32;1;33
76;Occitanie;65;2;08;141;Cazaux-Fréchet-Anéran-Camors;52;3;55
76;Occitanie;65;3;03;142;Chelle-Debat;208;4;212
76;Occitanie;65;2;14;143;Chelle-Spou;116;2;118
76;Occitanie;65;1;06;144;Cheust;86;2;88
76;Occitanie;65;1;16;145;Chèze;47;0;47
76;Occitanie;65;3;02;146;Chis;313;1;314
76;Occitanie;65;2;14;147;Cieutat;603;12;615
76;Occitanie;65;3;03;148;Cizos;130;1;131
76;Occitanie;65;3;14;149;Clarac;174;4;178
76;Occitanie;65;2;15;150;Clarens;497;25;522
76;Occitanie;65;3;03;151;Collongues;147;4;151
76;Occitanie;65;3;03;153;Coussan;123;5;128
76;Occitanie;65;2;15;154;Créchets;58;0;58
76;Occitanie;65;3;03;155;Devèze;54;2;56
76;Occitanie;65;3;03;156;Dours;219;5;224
76;Occitanie;65;2;08;157;Ens;23;2;25
76;Occitanie;65;2;15;158;Esbareich;82;0;82
76;Occitanie;65;2;08;159;Escala;369;11;380
76;Occitanie;65;3;17;160;Escaunets;123;3;126
76;Occitanie;65;3;13;161;Escondeaux;281;4;285
76;Occitanie;65;2;14;162;Esconnets;34;1;35
76;Occitanie;65;2;14;163;Escots;37;1;38
76;Occitanie;65;1;06;164;Escoubès-Pouts;107;2;109
76;Occitanie;65;2;08;165;Esparros;185;1;186
76;Occitanie;65;2;14;166;Espèche;54;0;54
76;Occitanie;65;2;14;167;Espieilh;26;1;27
76;Occitanie;65;1;16;168;Esquièze-Sère;404;12;416
76;Occitanie;65;1;16;169;Estaing;88;2;90
76;Occitanie;65;3;03;170;Estampures;79;2;81
76;Occitanie;65;2;08;171;Estarvielle;38;0;38
76;Occitanie;65;2;08;172;Estensan;39;0;39
76;Occitanie;65;1;16;173;Esterre;192;7;199
76;Occitanie;65;3;13;174;Estirac;105;4;109
76;Occitanie;65;2;15;175;Ferrère;41;3;44
76;Occitanie;65;1;16;176;Ferrières;84;0;84
76;Occitanie;65;3;03;177;Fontrailles;158;3;161
76;Occitanie;65;3;03;178;Fréchède;51;0;51
76;Occitanie;65;2;14;179;Fréchendets;28;0;28
76;Occitanie;65;2;08;180;Fréchet-Aure;13;0;13
76;Occitanie;65;3;14;181;Fréchou-Fréchet;164;3;167
76;Occitanie;65;1;16;182;Gaillagos;128;1;129
76;Occitanie;65;2;14;183;Galan;704;13;717
76;Occitanie;65;2;14;184;Galez;174;2;176
76;Occitanie;65;3;09;185;Gardères;445;11;456
76;Occitanie;65;2;15;186;Gaudent;36;0;36
76;Occitanie;65;3;03;187;Gaussan;105;4;109
76;Occitanie;65;1;16;192;Gavarnie-Gèdre;343;9;352
76;Occitanie;65;3;17;189;Gayan;281;2;283
76;Occitanie;65;2;08;190;Gazave;69;0;69
76;Occitanie;65;1;06;191;Gazost;125;2;127
76;Occitanie;65;2;15;193;Gembrie;82;4;86
76;Occitanie;65;2;15;194;Générest;99;3;102
76;Occitanie;65;2;08;195;Génos;138;0;138
76;Occitanie;65;3;13;196;Gensac;92;2;94
76;Occitanie;65;1;06;197;Ger;155;9;164
76;Occitanie;65;2;04;198;Gerde;1129;34;1163
76;Occitanie;65;2;08;199;Germ;36;0;36
76;Occitanie;65;1;06;200;Germs-sur-l'Oussouet;109;1;110
76;Occitanie;65;1;06;201;Geu;178;4;182
76;Occitanie;65;1;16;202;Gez;329;13;342
76;Occitanie;65;1;06;203;Gez-ez-Angles;28;1;29
76;Occitanie;65;3;03;204;Gonez;28;0;28
76;Occitanie;65;2;08;205;Gouaux;54;1;55
76;Occitanie;65;3;14;206;Goudon;231;6;237
76;Occitanie;65;2;14;207;Gourgue;63;0;63
76;Occitanie;65;2;08;208;Grailhen;23;2;25
76;Occitanie;65;2;08;209;Grézian;77;0;77
76;Occitanie;65;1;16;210;Grust;36;1;37
76;Occitanie;65;2;08;211;Guchan;144;5;149
76;Occitanie;65;2;08;212;Guchen;330;11;341
76;Occitanie;65;3;03;213;Guizerix;122;3;125
76;Occitanie;65;3;03;214;Hachan;44;0;44
76;Occitanie;65;3;13;215;Hagedet;45;2;47
76;Occitanie;65;2;14;216;Hauban;108;0;108
76;Occitanie;65;2;15;217;Hautaget;55;2;57
76;Occitanie;65;2;08;218;Hèches;617;14;631
76;Occitanie;65;3;13;219;Hères;123;1;124
76;Occitanie;65;3;09;220;Hibarette;245;1;246
76;Occitanie;65;2;04;221;Hiis;254;5;259
76;Occitanie;65;3;14;222;Hitte;164;1;165
76;Occitanie;65;3;07;223;Horgues;1197;26;1223
76;Occitanie;65;2;14;224;Houeydets;276;6;282
76;Occitanie;65;3;03;225;Hourc;107;1;108
76;Occitanie;65;3;02;226;Ibos;2900;137;3037
76;Occitanie;65;2;08;228;Ilhet;121;0;121
76;Occitanie;65;2;15;229;Ilheu;41;0;41
76;Occitanie;65;2;15;230;Izaourt;254;6;260
76;Occitanie;65;2;08;231;Izaux;201;12;213
76;Occitanie;65;3;03;232;Jacque;71;2;73
76;Occitanie;65;1;06;233;Jarret;317;4;321
76;Occitanie;65;2;08;234;Jézeau;94;3;97
76;Occitanie;65;3;09;235;Juillan;4076;95;4171
76;Occitanie;65;1;06;236;Julos;426;12;438
76;Occitanie;65;1;06;237;Juncalas;161;5;166
76;Occitanie;65;2;04;238;Labassère;236;10;246
76;Occitanie;65;2;08;239;Labastide;152;5;157
76;Occitanie;65;3;13;240;Labatut-Rivière;387;6;393
76;Occitanie;65;2;08;241;Laborde;85;3;88
76;Occitanie;65;3;13;242;Lacassagne;236;3;239
76;Occitanie;65;3;13;243;Lafitole;467;19;486
76;Occitanie;65;3;17;244;Lagarde;525;7;532
76;Occitanie;65;2;15;245;Lagrange;230;7;237
76;Occitanie;65;3;13;248;Lahitte-Toupière;260;17;277
76;Occitanie;65;3;03;249;Lalanne;100;5;105
76;Occitanie;65;3;03;250;Lalanne-Trie;118;1;119
76;Occitanie;65;3;07;251;Laloubère;1880;65;1945
76;Occitanie;65;3;09;252;Lamarque-Pontacq;861;14;875
76;Occitanie;65;3;03;253;Lamarque-Rustaing;51;0;51
76;Occitanie;65;3;13;254;Laméac;145;4;149
76;Occitanie;65;3;14;256;Lanespède;148;2;150
76;Occitanie;65;3;09;257;Lanne;595;9;604
76;Occitanie;65;2;15;258;Lannemezan;5812;159;5971
76;Occitanie;65;3;03;259;Lansac;178;5;183
76;Occitanie;65;2;08;255;Lançon;31;0;31
76;Occitanie;65;3;03;260;Lapeyre;98;1;99
76;Occitanie;65;3;03;261;Laran;47;1;48
76;Occitanie;65;3;13;262;Larreule;411;10;421
76;Occitanie;65;3;03;263;Larroque;96;3;99
76;Occitanie;65;3;13;264;Lascazères;308;25;333
76;Occitanie;65;3;03;265;Laslades;328;10;338
76;Occitanie;65;3;03;266;Lassales;35;1;36
76;Occitanie;65;1;16;267;Lau-Balagnas;520;17;537
76;Occitanie;65;3;09;268;Layrisse;198;3;201
76;Occitanie;65;3;13;269;Lescurry;170;3;173
76;Occitanie;65;3;14;270;Lespouey;206;9;215
76;Occitanie;65;1;06;271;Lézignan;352;4;356
76;Occitanie;65;3;14;272;Lhez;77;0;77
76;Occitanie;65;3;13;273;Liac;197;0;197
76;Occitanie;65;2;14;274;Libaros;137;1;138
76;Occitanie;65;2;14;275;Lies;72;2;74
76;Occitanie;65;3;03;276;Lizos;117;1;118
76;Occitanie;65;2;15;277;Lombrès;96;3;99
76;Occitanie;65;2;14;278;Lomné;31;0;31
76;Occitanie;65;2;08;279;Lortet;213;8;221
76;Occitanie;65;1;05;280;Loubajac;413;2;415
76;Occitanie;65;3;09;281;Loucrup;234;4;238
76;Occitanie;65;2;08;282;Loudenvielle;299;6;305
76;Occitanie;65;2;08;283;Loudervielle;52;3;55
76;Occitanie;65;3;09;284;Louey;1004;27;1031
76;Occitanie;65;3;03;285;Louit;192;3;195
76;Occitanie;65;1;98;286;Lourdes;13210;319;13529
76;Occitanie;65;2;15;287;Loures-Barousse;632;13;645
76;Occitanie;65;3;03;288;Lubret-Saint-Luc;54;0;54
76;Occitanie;65;3;03;289;Luby-Betmont;110;1;111
76;Occitanie;65;3;14;290;Luc;203;1;204
76;Occitanie;65;1;06;291;Lugagnan;133;3;136
76;Occitanie;65;3;09;292;Luquet;398;3;401
76;Occitanie;65;3;03;293;Lustar;110;2;112
76;Occitanie;65;2;14;294;Lutilhous;221;3;224
76;Occitanie;65;1;16;295;Luz-Saint-Sauveur;952;15;967
76;Occitanie;65;3;13;296;Madiran;422;12;434
76;Occitanie;65;3;13;297;Mansan;42;5;47
76;Occitanie;65;3;03;298;Marquerie;83;0;83
76;Occitanie;65;3;17;299;Marsac;225;4;229
76;Occitanie;65;2;14;300;Marsas;68;5;73
76;Occitanie;65;3;03;301;Marseillan;257;4;261
76;Occitanie;65;3;14;303;Mascaras;360;4;364
76;Occitanie;65;3;13;304;Maubourguet;2322;28;2350
76;Occitanie;65;2;15;305;Mauléon-Barousse;93;0;93
76;Occitanie;65;2;14;306;Mauvezin;234;4;238
76;Occitanie;65;2;15;307;Mazères-de-Neste;333;6;339
76;Occitanie;65;3;03;308;Mazerolles;105;4;109
76;Occitanie;65;2;08;309;Mazouau;16;3;19
76;Occitanie;65;2;14;310;Mérilheu;251;5;256
76;Occitanie;65;3;13;311;Mingot;100;0;100
76;Occitanie;65;3;07;313;Momères;752;23;775
76;Occitanie;65;3;13;314;Monfaucon;209;6;215
76;Occitanie;65;3;03;315;Monléon-Magnoac;425;236;661
76;Occitanie;65;3;03;316;Monlong;103;4;107
76;Occitanie;65;2;08;317;Mont;38;2;40
76;Occitanie;65;2;14;318;Montastruc;230;6;236
76;Occitanie;65;2;15;319;Montégut;135;2;137
76;Occitanie;65;2;04;320;Montgaillard;849;18;867
76;Occitanie;65;3;07;321;Montignac;142;2;144
76;Occitanie;65;2;08;322;Montoussé;252;7;259
76;Occitanie;65;2;15;323;Montsérié;81;0;81
76;Occitanie;65;3;14;324;Moulédous;213;7;220
76;Occitanie;65;3;13;325;Moumoulous;43;0;43
76;Occitanie;65;3;03;326;Mun;95;3;98
76;Occitanie;65;2;15;327;Nestier;154;2;156
76;Occitanie;65;2;04;328;Neuilh;98;4;102
76;Occitanie;65;2;15;329;Nistos;213;8;221
76;Occitanie;65;3;17;330;Nouilhan;208;3;211
76;Occitanie;65;3;07;331;Odos;3253;98;3351
76;Occitanie;65;3;03;332;Oléac-Debat;170;1;171
76;Occitanie;65;3;14;333;Oléac-Dessus;114;1;115
76;Occitanie;65;1;05;334;Omex;223;3;226
76;Occitanie;65;2;04;335;Ordizan;534;18;552
76;Occitanie;65;3;03;336;Organ;40;0;40
76;Occitanie;65;3;14;337;Orieux;111;3;114
76;Occitanie;65;2;14;338;Orignac;247;3;250
76;Occitanie;65;3;09;339;Orincles;328;7;335
76;Occitanie;65;3;02;340;Orleix;2069;45;2114
76;Occitanie;65;3;17;341;Oroix;115;2;117
76;Occitanie;65;3;03;342;Osmets;92;2;94
76;Occitanie;65;1;05;343;Ossen;236;4;240
76;Occitanie;65;3;09;344;Ossun;2372;49;2421
76;Occitanie;65;1;06;345;Ossun-ez-Angles;53;0;53
76;Occitanie;65;3;14;346;Oueilloux;169;7;176
76;Occitanie;65;2;15;347;Ourde;42;0;42
76;Occitanie;65;1;06;348;Ourdis-Cotdoussan;47;2;49
76;Occitanie;65;1;06;349;Ourdon;9;0;9
76;Occitanie;65;3;02;350;Oursbelille;1192;40;1232
76;Occitanie;65;1;06;351;Ousté;29;0;29
76;Occitanie;65;1;16;352;Ouzous;212;8;220
76;Occitanie;65;3;14;353;Ozon;269;11;280
76;Occitanie;65;2;08;354;Pailhac;71;2;73
76;Occitanie;65;1;06;355;Paréac;67;0;67
76;Occitanie;65;2;14;356;Péré;57;2;59
76;Occitanie;65;3;14;357;Peyraube;162;3;165
76;Occitanie;65;3;03;358;Peyret-Saint-André;53;2;55
76;Occitanie;65;3;03;359;Peyriguère;29;0;29
76;Occitanie;65;1;05;360;Peyrouse;277;8;285
76;Occitanie;65;3;13;361;Peyrun;89;0;89
76;Occitanie;65;1;16;362;Pierrefitte-Nestalas;1128;25;1153
76;Occitanie;65;2;15;363;Pinas;445;9;454
76;Occitanie;65;3;17;364;Pintac;22;3;25
76;Occitanie;65;1;05;366;Poueyferré;843;17;860
76;Occitanie;65;3;14;367;Poumarous;158;3;161
76;Occitanie;65;3;03;368;Pouy;44;2;46
76;Occitanie;65;3;03;369;Pouyastruc;652;22;674
76;Occitanie;65;2;04;370;Pouzac;1114;38;1152
76;Occitanie;65;1;16;371;Préchac;232;10;242
76;Occitanie;65;3;17;372;Pujo;638;13;651
76;Occitanie;65;3;03;373;Puntous;173;4;177
76;Occitanie;65;3;03;374;Puydarrieux;227;1;228
76;Occitanie;65;3;13;375;Rabastens-de-Bigorre;1444;24;1468
76;Occitanie;65;2;14;376;Recurt;221;8;229
76;Occitanie;65;2;15;377;Réjaumont;161;8;169
76;Occitanie;65;3;14;378;Ricaud;66;2;68
76;Occitanie;65;2;08;379;Ris;16;0;16
76;Occitanie;65;3;03;380;Sabalos;146;1;147
76;Occitanie;65;2;14;381;Sabarros;34;0;34
76;Occitanie;65;2;15;382;Sacoué;68;3;71
76;Occitanie;65;3;03;383;Sadournin;188;2;190
76;Occitanie;65;2;08;384;Sailhan;167;1;168
76;Occitanie;65;2;08;385;Saint-Arroman;90;2;92
76;Occitanie;65;1;06;386;Saint-Créac;98;0;98
76;Occitanie;65;3;13;387;Saint-Lanne;134;2;136
76;Occitanie;65;2;08;388;Saint-Lary-Soulan;851;18;869
76;Occitanie;65;2;15;389;Saint-Laurent-de-Neste;932;41;973
76;Occitanie;65;3;17;390;Saint-Lézer;422;14;436
76;Occitanie;65;3;07;392;Saint-Martin;449;8;457
76;Occitanie;65;1;16;393;Saint-Pastous;138;5;143
76;Occitanie;65;2;15;394;Saint-Paul;316;3;319
76;Occitanie;65;1;05;395;Saint-Pé-de-Bigorre;1160;19;1179
76;Occitanie;65;1;16;396;Saint-Savin;366;7;373
76;Occitanie;65;3;13;397;Saint-Sever-de-Rustan;169;3;172
76;Occitanie;65;2;15;391;Sainte-Marie;62;0;62
76;Occitanie;65;2;15;398;Saléchan;263;2;265
76;Occitanie;65;1;16;399;Saligos ;104;3;107
76;Occitanie;65;1;16;400;Salles;232;7;239
76;Occitanie;65;3;07;401;Salles-Adour;588;25;613
76;Occitanie;65;2;15;402;Samuran;25;0;25
76;Occitanie;65;3;17;403;Sanous;99;2;101
76;Occitanie;65;3;03;404;Sariac-Magnoac;153;3;156
76;Occitanie;65;2;14;405;Sarlabous;71;3;74
76;Occitanie;65;3;17;406;Sarniguet;256;5;261
76;Occitanie;65;2;15;407;Sarp;107;2;109
76;Occitanie;65;2;08;408;Sarrancolin;566;20;586
76;Occitanie;65;3;13;409;Sarriac-Bigorre;303;5;308
76;Occitanie;65;3;07;410;Sarrouilles;524;17;541
76;Occitanie;65;1;16;411;Sassis;78;6;84
76;Occitanie;65;3;13;412;Sauveterre;169;4;173
76;Occitanie;65;1;16;413;Sazos;135;4;139
76;Occitanie;65;3;13;414;Ségalas;80;4;84
76;Occitanie;65;1;05;415;Ségus;234;1;235
76;Occitanie;65;2;15;416;Seich;87;3;90
76;Occitanie;65;3;01;417;Séméac;5005;104;5109
76;Occitanie;65;3;13;418;Sénac;293;7;300
76;Occitanie;65;2;14;419;Sentous;69;0;69
76;Occitanie;65;1;16;420;Sère-en-Lavedan;75;2;77
76;Occitanie;65;1;06;421;Sère-Lanso;51;2;53
76;Occitanie;65;3;03;423;Sère-Rustaing;129;1;130
76;Occitanie;65;3;09;422;Séron;333;3;336
76;Occitanie;65;1;16;424;Sers;115;2;117
76;Occitanie;65;3;17;425;Siarrouy;442;7;449
76;Occitanie;65;3;14;426;Sinzos;134;6;140
76;Occitanie;65;2;15;427;Siradan;282;5;287
76;Occitanie;65;1;16;428;Sireix;63;1;64
76;Occitanie;65;3;13;429;Sombrun;208;8;216
76;Occitanie;65;3;03;430;Soréac;43;1;44
76;Occitanie;65;2;15;431;Sost;94;4;98
76;Occitanie;65;3;13;432;Soublecause;184;5;189
76;Occitanie;65;3;01;433;Soues;3070;58;3128
76;Occitanie;65;1;16;435;Soulom;265;4;269
76;Occitanie;65;3;03;436;Souyeaux;307;7;314
76;Occitanie;65;2;15;437;Tajan;132;3;135
76;Occitanie;65;3;17;438;Talazac;76;1;77
76;Occitanie;65;3;17;439;Tarasteix;269;3;272
76;Occitanie;65;3;99;440;Tarbes;42426;1037;43463
76;Occitanie;65;2;15;441;Thèbe;77;3;80
76;Occitanie;65;3;03;442;Thermes-Magnoac;210;1;211
76;Occitanie;65;3;03;443;Thuy;18;0;18
76;Occitanie;65;2;15;444;Tibiran-Jaunac;317;4;321
76;Occitanie;65;2;14;445;Tilhouse;224;6;230
76;Occitanie;65;3;13;446;Tostat;542;8;550
76;Occitanie;65;3;14;447;Tournay;1189;21;1210
76;Occitanie;65;3;03;448;Tournous-Darré;89;4;93
76;Occitanie;65;2;14;449;Tournous-Devant;98;5;103
76;Occitanie;65;2;08;450;Tramezaïgues;35;1;36
76;Occitanie;65;2;04;451;Trébons;756;14;770
76;Occitanie;65;3;03;452;Trie-sur-Baïse;1025;26;1051
76;Occitanie;65;2;15;453;Troubat;74;0;74
76;Occitanie;65;3;13;454;Trouley-Labarthe;102;1;103
76;Occitanie;65;2;15;455;Tuzaguet;446;9;455
76;Occitanie;65;2;15;456;Uglas;284;11;295
76;Occitanie;65;3;13;457;Ugnouas;82;1;83
76;Occitanie;65;1;16;458;Uz;32;1;33
76;Occitanie;65;2;14;459;Uzer;103;4;107
76;Occitanie;65;3;17;460;Vic-en-Bigorre;4864;267;5131
76;Occitanie;65;3;03;461;Vidou;109;1;110
76;Occitanie;65;3;13;462;Vidouze;241;9;250
76;Occitanie;65;1;16;463;Viella;86;1;87
76;Occitanie;65;3;07;464;Vielle-Adour;510;10;520
76;Occitanie;65;2;08;465;Vielle-Aure;327;10;337
76;Occitanie;65;2;08;466;Vielle-Louron;90;1;91
76;Occitanie;65;1;16;467;Vier-Bordes;100;6;106
76;Occitanie;65;3;03;468;Vieuzos;42;1;43
76;Occitanie;65;1;16;469;Viey;28;1;29
76;Occitanie;65;1;05;470;Viger;142;4;146
76;Occitanie;65;2;08;471;Vignec;217;8;225
76;Occitanie;65;3;13;472;Villefranque;77;5;82
76;Occitanie;65;1;16;473;Villelongue;398;15;413
76;Occitanie;65;3;03;474;Villembits;114;2;116
76;Occitanie;65;3;03;475;Villemur;61;1;62
76;Occitanie;65;3;17;476;Villenave-près-Béarn;63;4;67
76;Occitanie;65;3;17;477;Villenave-près-Marsac;95;2;97
76;Occitanie;65;1;16;478;Viscos;34;2;36
76;Occitanie;65;3;09;479;Visker;345;10;355
76;Occitanie;66;1;17;001;L' Albère;76;1;77
76;Occitanie;66;1;12;002;Alénya;3669;61;3730
76;Occitanie;66;1;02;003;Amélie-les-Bains-Palalda;3503;46;3549
76;Occitanie;66;3;13;004;Les Angles;558;8;566
76;Occitanie;66;3;13;005;Angoustrine-Villeneuve-des-Escaldes;562;34;596
76;Occitanie;66;3;15;006;Ansignan;168;2;170
76;Occitanie;66;3;15;007;Arboussols;121;3;124
76;Occitanie;66;1;05;008;Argelès-sur-Mer;10366;257;10623
76;Occitanie;66;1;02;009;Arles-sur-Tech;2698;38;2736
76;Occitanie;66;3;13;010;Ayguatébia-Talau;37;0;37
76;Occitanie;66;1;12;011;Bages;4220;50;4270
76;Occitanie;66;2;14;012;Baho;3323;62;3385
76;Occitanie;66;3;02;013;Baillestavy;117;3;120
76;Occitanie;66;2;14;014;Baixas;2584;49;2633
76;Occitanie;66;1;01;015;Banyuls-dels-Aspres;1265;22;1287
76;Occitanie;66;1;05;016;Banyuls-sur-Mer;4752;77;4829
76;Occitanie;66;2;04;017;Le Barcarès;5885;40;5925
76;Occitanie;66;1;02;018;La Bastide;69;0;69
76;Occitanie;66;3;15;019;Bélesta;217;4;221
76;Occitanie;66;3;13;020;Bolquère;813;26;839
76;Occitanie;66;2;07;021;Bompas;7310;103;7413
76;Occitanie;66;3;02;022;Boule-d'Amont;55;0;55
76;Occitanie;66;3;02;023;Bouleternère;943;8;951
76;Occitanie;66;1;17;024;Le Boulou;5396;56;5452
76;Occitanie;66;3;13;025;Bourg-Madame;1215;79;1294
76;Occitanie;66;1;01;026;Brouilla;1485;31;1516
76;Occitanie;66;3;13;027;La Cabanasse;681;14;695
76;Occitanie;66;2;08;028;Cabestany;10235;204;10439
76;Occitanie;66;1;01;029;Caixas;138;1;139
76;Occitanie;66;2;14;030;Calce;208;2;210
76;Occitanie;66;1;01;032;Calmeilles;59;0;59
76;Occitanie;66;1;01;033;Camélas;462;13;475
76;Occitanie;66;3;13;034;Campôme;111;5;116
76;Occitanie;66;3;15;035;Campoussy;38;0;38
76;Occitanie;66;3;13;036;Canaveilles;25;0;25
76;Occitanie;66;2;03;037;Canet-en-Roussillon;12186;250;12436
76;Occitanie;66;2;10;038;Canohès;6199;112;6311
76;Occitanie;66;3;15;039;Caramany;144;1;145
76;Occitanie;66;3;02;040;Casefabre;40;1;41
76;Occitanie;66;2;15;041;Cases-de-Pène;933;20;953
76;Occitanie;66;2;15;042;Cassagnes;265;6;271
76;Occitanie;66;3;02;043;Casteil;137;2;139
76;Occitanie;66;1;01;044;Castelnou;304;6;310
76;Occitanie;66;3;13;045;Catllar;777;15;792
76;Occitanie;66;3;13;047;Caudiès-de-Conflent;17;2;19
76;Occitanie;66;3;15;046;Caudiès-de-Fenouillèdes;614;11;625
76;Occitanie;66;1;05;048;Cerbère;1351;16;1367
76;Occitanie;66;1;17;049;Céret;7821;232;8053
76;Occitanie;66;2;04;050;Claira;4250;52;4302
76;Occitanie;66;3;13;051;Clara-Villerach;260;8;268
76;Occitanie;66;1;17;063;Les Cluses;233;3;236
76;Occitanie;66;3;13;052;Codalet;377;11;388
76;Occitanie;66;1;05;053;Collioure;2418;28;2446
76;Occitanie;66;3;13;054;Conat;61;3;64
76;Occitanie;66;3;16;055;Corbère;748;14;762
76;Occitanie;66;3;16;056;Corbère-les-Cabanes;1056;15;1071
76;Occitanie;66;3;02;057;Corneilla-de-Conflent;510;4;514
76;Occitanie;66;1;12;059;Corneilla-del-Vercol;2320;28;2348
76;Occitanie;66;3;16;058;Corneilla-la-Rivière;1978;35;2013
76;Occitanie;66;1;02;060;Corsavy;222;20;242
76;Occitanie;66;1;02;061;Coustouges;93;0;93
76;Occitanie;66;3;13;062;Dorres;168;7;175
76;Occitanie;66;3;13;064;Égat;430;11;441
76;Occitanie;66;1;12;065;Elne;9103;114;9217
76;Occitanie;66;3;13;066;Enveitg;636;23;659
76;Occitanie;66;3;13;067;Err;671;22;693
76;Occitanie;66;3;13;068;Escaro;107;1;108
76;Occitanie;66;3;02;070;Espira-de-Conflent;168;4;172
76;Occitanie;66;2;15;069;Espira-de-l'Agly;3460;155;3615
76;Occitanie;66;2;15;071;Estagel;2046;18;2064
76;Occitanie;66;3;13;072;Estavar;475;9;484
76;Occitanie;66;3;02;073;Estoher;142;2;144
76;Occitanie;66;3;13;074;Eus;384;9;393
76;Occitanie;66;3;13;075;Eyne;135;9;144
76;Occitanie;66;3;15;076;Felluns;68;0;68
76;Occitanie;66;3;15;077;Fenouillet;89;1;90
76;Occitanie;66;3;02;078;Fillols;187;7;194
76;Occitanie;66;3;02;079;Finestret;184;5;189
76;Occitanie;66;3;13;124;Font-Romeu-Odeillo-Via;1889;193;2082
76;Occitanie;66;3;13;080;Fontpédrouse;120;2;122
76;Occitanie;66;3;13;081;Fontrabiouse;126;3;129
76;Occitanie;66;3;13;082;Formiguères;489;4;493
76;Occitanie;66;3;15;083;Fosse;41;0;41
76;Occitanie;66;1;01;084;Fourques;1296;19;1315
76;Occitanie;66;3;02;085;Fuilla;447;9;456
76;Occitanie;66;3;02;086;Glorianes;25;0;25
76;Occitanie;66;3;16;088;Ille-sur-Têt;5436;62;5498
76;Occitanie;66;3;02;089;Joch;294;5;299
76;Occitanie;66;3;13;090;Jujols;44;2;46
76;Occitanie;66;1;02;091;Lamanère;52;1;53
76;Occitanie;66;3;15;092;Lansac;90;0;90
76;Occitanie;66;1;17;093;Laroque-des-Albères;2128;41;2169
76;Occitanie;66;1;12;094;Latour-Bas-Elne;2978;43;3021
76;Occitanie;66;3;13;095;Latour-de-Carol;431;4;435
76;Occitanie;66;3;15;096;Latour-de-France;1033;12;1045
76;Occitanie;66;3;15;097;Lesquerde;136;4;140
76;Occitanie;66;3;13;098;La Llagonne;220;10;230
76;Occitanie;66;1;01;099;Llauro;317;2;319
76;Occitanie;66;3;13;100;Llo;169;3;172
76;Occitanie;66;2;01;101;Llupia;2006;41;2047
76;Occitanie;66;3;02;102;Mantet;30;1;31
76;Occitanie;66;3;02;103;Marquixanes;564;7;571
76;Occitanie;66;3;13;104;Los Masos;978;12;990
76;Occitanie;66;3;13;105;Matemale;272;5;277
76;Occitanie;66;1;17;106;Maureillas-las-Illas;2561;49;2610
76;Occitanie;66;3;15;107;Maury;792;6;798
76;Occitanie;66;3;16;108;Millas;4266;74;4340
76;Occitanie;66;3;13;109;Molitg-les-Bains;237;4;241
76;Occitanie;66;3;13;117;Mont-Louis;149;9;158
76;Occitanie;66;3;16;111;Montalba-le-Château;149;2;151
76;Occitanie;66;1;01;112;Montauriol;249;5;254
76;Occitanie;66;1;02;113;Montbolo;178;2;180
76;Occitanie;66;1;12;114;Montescot;1680;40;1720
76;Occitanie;66;1;17;115;Montesquieu-des-Albères;1229;23;1252
76;Occitanie;66;1;02;116;Montferrer;189;4;193
76;Occitanie;66;2;15;118;Montner;343;8;351
76;Occitanie;66;3;13;119;Mosset;313;7;320
76;Occitanie;66;3;13;120;Nahuja;76;1;77
76;Occitanie;66;3;16;121;Néfiach;1292;36;1328
76;Occitanie;66;3;13;122;Nohèdes;62;2;64
76;Occitanie;66;3;13;123;Nyer;150;0;150
76;Occitanie;66;3;13;125;Olette;357;5;362
76;Occitanie;66;1;01;126;Oms;335;4;339
76;Occitanie;66;2;15;127;Opoul-Périllos;1196;15;1211
76;Occitanie;66;3;13;128;Oreilla;24;0;24
76;Occitanie;66;1;12;129;Ortaffa;1537;19;1556
76;Occitanie;66;3;13;130;Osséja;1336;74;1410
76;Occitanie;66;3;13;132;Palau-de-Cerdagne;412;10;422
76;Occitanie;66;1;05;133;Palau-del-Vidre;3106;45;3151
76;Occitanie;66;1;01;134;Passa;880;9;889
76;Occitanie;66;2;99;136;Perpignan;119188;1418;120606
76;Occitanie;66;1;17;137;Le Perthus;561;3;564
76;Occitanie;66;2;14;138;Peyrestortes;1470;24;1494
76;Occitanie;66;3;15;139;Pézilla-de-Conflent;43;0;43
76;Occitanie;66;2;14;140;Pézilla-la-Rivière;3737;54;3791
76;Occitanie;66;2;04;141;Pia;9228;90;9318
76;Occitanie;66;3;13;142;Planès;53;2;55
76;Occitanie;66;3;15;143;Planèzes;96;2;98
76;Occitanie;66;2;01;144;Pollestres;4967;81;5048
76;Occitanie;66;2;01;145;Ponteilla;2841;44;2885
76;Occitanie;66;1;05;148;Port-Vendres;4073;77;4150
76;Occitanie;66;3;13;146;Porta;115;7;122
76;Occitanie;66;3;13;147;Porté-Puymorens;104;1;105
76;Occitanie;66;3;13;149;Prades;6063;339;6402
76;Occitanie;66;1;02;150;Prats-de-Mollo-la-Preste;1164;19;1183
76;Occitanie;66;3;15;151;Prats-de-Sournia;78;3;81
76;Occitanie;66;3;15;152;Prugnanes;102;0;102
76;Occitanie;66;3;02;153;Prunet-et-Belpuig;49;0;49
76;Occitanie;66;3;13;154;Puyvalador;67;1;68
76;Occitanie;66;3;02;155;Py;84;0;84
76;Occitanie;66;3;15;156;Rabouillet;94;1;95
76;Occitanie;66;3;13;157;Railleu;29;1;30
76;Occitanie;66;3;15;158;Rasiguères;151;2;153
76;Occitanie;66;3;13;159;Réal;64;0;64
76;Occitanie;66;1;02;160;Reynès;1291;21;1312
76;Occitanie;66;3;13;161;Ria-Sirach;1333;30;1363
76;Occitanie;66;3;02;162;Rigarda;634;2;636
76;Occitanie;66;2;15;164;Rivesaltes;8756;144;8900
76;Occitanie;66;3;02;165;Rodès;624;6;630
76;Occitanie;66;3;02;166;Sahorre;385;7;392
76;Occitanie;66;3;13;167;Saillagouse;1118;27;1145
76;Occitanie;66;1;05;168;Saint-André;3433;52;3485
76;Occitanie;66;3;15;169;Saint-Arnac;112;1;113
76;Occitanie;66;1;03;171;Saint-Cyprien;10844;145;10989
76;Occitanie;66;2;14;172;Saint-Estève;11697;161;11858
76;Occitanie;66;3;16;173;Saint-Féliu-d'Amont;1170;20;1190
76;Occitanie;66;2;16;174;Saint-Féliu-d'Avall;2830;44;2874
76;Occitanie;66;1;17;175;Saint-Génis-des-Fontaines;2836;26;2862
76;Occitanie;66;2;04;176;Saint-Hippolyte;3131;30;3161
76;Occitanie;66;1;01;177;Saint-Jean-Lasseille;1541;17;1558
76;Occitanie;66;1;17;178;Saint-Jean-Pla-de-Corts;2248;44;2292
76;Occitanie;66;1;02;179;Saint-Laurent-de-Cerdans;1071;13;1084
76;Occitanie;66;2;04;180;Saint-Laurent-de-la-Salanque;10158;103;10261
76;Occitanie;66;1;02;183;Saint-Marsal;69;0;69
76;Occitanie;66;3;15;184;Saint-Martin-de-Fenouillet;53;3;56
76;Occitanie;66;3;02;185;Saint-Michel-de-Llotes;350;12;362
76;Occitanie;66;2;03;186;Saint-Nazaire;2716;42;2758
76;Occitanie;66;3;15;187;Saint-Paul-de-Fenouillet;1800;18;1818
76;Occitanie;66;3;13;188;Saint-Pierre-dels-Forcats;264;10;274
76;Occitanie;66;1;01;170;Sainte-Colombe-de-la-Commanderie;155;2;157
76;Occitanie;66;3;13;181;Sainte-Léocadie;122;1;123
76;Occitanie;66;2;07;182;Sainte-Marie-la-Mer;4797;62;4859
76;Occitanie;66;2;03;189;Saleilles;5391;102;5493
76;Occitanie;66;2;15;190;Salses-le-Château;3511;12;3523
76;Occitanie;66;3;13;191;Sansa;20;0;20
76;Occitanie;66;3;13;192;Sauto;91;1;92
76;Occitanie;66;3;13;193;Serdinya;239;5;244
76;Occitanie;66;1;02;194;Serralongue;223;2;225
76;Occitanie;66;2;16;195;Le Soler;7753;115;7868
76;Occitanie;66;1;17;196;Sorède;3315;50;3365
76;Occitanie;66;3;13;197;Souanyas;37;0;37
76;Occitanie;66;3;15;198;Sournia;497;5;502
76;Occitanie;66;1;02;199;Taillet;104;1;105
76;Occitanie;66;3;15;201;Tarerach;45;1;46
76;Occitanie;66;3;13;202;Targassonne;190;5;195
76;Occitanie;66;1;02;203;Taulis;55;0;55
76;Occitanie;66;3;02;204;Taurinya;334;11;345
76;Occitanie;66;2;15;205;Tautavel;860;21;881
76;Occitanie;66;1;02;206;Le Tech;91;0;91
76;Occitanie;66;1;01;207;Terrats;680;10;690
76;Occitanie;66;1;12;208;Théza;2084;99;2183
76;Occitanie;66;3;13;209;Thuès-Entre-Valls;39;2;41
76;Occitanie;66;1;01;210;Thuir;7792;133;7925
76;Occitanie;66;1;01;211;Tordères;172;7;179
76;Occitanie;66;2;04;212;Torreilles;3825;68;3893
76;Occitanie;66;2;11;213;Toulouges;7036;121;7157
76;Occitanie;66;1;01;214;Tresserre;1075;13;1088
76;Occitanie;66;3;15;215;Trévillach;159;0;159
76;Occitanie;66;3;15;216;Trilla;75;2;77
76;Occitanie;66;1;01;217;Trouillas;2123;24;2147
76;Occitanie;66;3;13;218;Ur;365;11;376
76;Occitanie;66;3;13;219;Urbanya;52;1;53
76;Occitanie;66;3;13;220;Valcebollère;40;1;41
76;Occitanie;66;3;02;221;Valmanya;34;0;34
76;Occitanie;66;3;02;222;Vernet-les-Bains;1418;42;1460
76;Occitanie;66;3;13;223;Villefranche-de-Conflent;211;5;216
76;Occitanie;66;2;07;224;Villelongue-de-la-Salanque;3251;35;3286
76;Occitanie;66;1;17;225;Villelongue-dels-Monts;1743;64;1807
76;Occitanie;66;1;01;226;Villemolaque;1380;23;1403
76;Occitanie;66;2;12;227;Villeneuve-de-la-Raho;3914;66;3980
76;Occitanie;66;2;14;228;Villeneuve-la-Rivière;1359;25;1384
76;Occitanie;66;2;15;231;Vingrau;589;4;593
76;Occitanie;66;3;02;230;Vinça;2111;26;2137
76;Occitanie;66;3;15;232;Vira;26;0;26
76;Occitanie;66;1;17;233;Vivès;177;4;181
76;Occitanie;66;3;15;234;Le Vivier;72;0;72
44;Grand Est;67;8;09;001;Achenheim;2145;30;2175
44;Grand Est;67;4;08;002;Adamswiller;383;3;386
44;Grand Est;67;5;11;003;Albé;447;16;463
44;Grand Est;67;4;02;005;Alteckendorf;852;18;870
44;Grand Est;67;4;14;006;Altenheim;214;1;215
44;Grand Est;67;3;10;008;Altorf;1328;22;1350
44;Grand Est;67;4;08;009;Altwiller;384;13;397
44;Grand Est;67;5;12;010;Andlau;1738;74;1812
44;Grand Est;67;5;16;011;Artolsheim;995;12;1007
44;Grand Est;67;2;23;012;Aschbach;665;18;683
44;Grand Est;67;4;08;013;Asswiller;270;3;273
44;Grand Est;67;3;10;016;Avolsheim;738;10;748
44;Grand Est;67;4;08;017;Baerendorf;300;5;305
44;Grand Est;67;3;14;018;Balbronn;663;9;672
44;Grand Est;67;5;16;019;Baldenheim;1178;18;1196
44;Grand Est;67;3;11;020;Barembach;856;7;863
44;Grand Est;67;5;12;021;Barr;7219;195;7414
44;Grand Est;67;5;11;022;Bassemberg;241;5;246
44;Grand Est;67;2;05;023;Batzendorf;983;21;1004
44;Grand Est;67;2;23;025;Beinheim;1928;25;1953
44;Grand Est;67;3;11;026;Bellefosse;157;3;160
44;Grand Est;67;3;11;027;Belmont;172;0;172
44;Grand Est;67;5;04;028;Benfeld;5756;94;5850
44;Grand Est;67;4;08;029;Berg;362;4;366
44;Grand Est;67;3;10;030;Bergbieten;710;7;717
44;Grand Est;67;5;12;031;Bernardswiller;1446;44;1490
44;Grand Est;67;5;12;032;Bernardvillé;222;8;230
44;Grand Est;67;2;03;033;Bernolsheim;602;7;609
44;Grand Est;67;4;02;034;Berstett;2448;41;2489
44;Grand Est;67;2;05;035;Berstheim;445;14;459
44;Grand Est;67;2;23;339;Betschdorf;4185;47;4232
44;Grand Est;67;4;08;036;Bettwiller;307;7;314
44;Grand Est;67;2;13;037;Biblisheim;365;5;370
44;Grand Est;67;2;03;038;Bietlenheim;287;2;289
44;Grand Est;67;2;03;039;Bilwisheim;491;10;501
44;Grand Est;67;5;16;040;Bindernheim;1040;10;1050
44;Grand Est;67;8;15;043;Bischheim;17137;210;17347
44;Grand Est;67;4;08;044;Bischholtz;266;0;266
44;Grand Est;67;3;10;045;Bischoffsheim;3329;58;3387
44;Grand Est;67;2;01;046;Bischwiller;12615;135;12750
44;Grand Est;67;4;08;047;Bissert;156;3;159
44;Grand Est;67;2;13;048;Bitschhoffen;462;15;477
44;Grand Est;67;8;09;049;Blaesheim;1307;20;1327
44;Grand Est;67;3;11;050;Blancherupt;36;0;36
44;Grand Est;67;5;12;051;Blienschwiller;317;11;328
44;Grand Est;67;5;04;054;Bolsenheim;538;6;544
44;Grand Est;67;5;04;055;Boofzheim;1381;19;1400
44;Grand Est;67;5;16;056;Bootzheim;745;12;757
44;Grand Est;67;4;02;057;Bosselshausen;170;6;176
44;Grand Est;67;4;02;058;Bossendorf;395;4;399
44;Grand Est;67;3;11;059;Bourg-Bruche;439;7;446
44;Grand Est;67;5;12;060;Bourgheim;644;10;654
44;Grand Est;67;4;02;061;Bouxwiller;3860;83;3943
44;Grand Est;67;5;11;062;Breitenau;320;6;326
44;Grand Est;67;5;11;063;Breitenbach;660;16;676
44;Grand Est;67;8;09;065;Breuschwickersheim;1283;14;1297
44;Grand Est;67;3;11;066;La Broque;2646;89;2735
44;Grand Est;67;2;03;067;Brumath;9970;102;10072
44;Grand Est;67;2;23;069;Buhl;518;7;525
44;Grand Est;67;4;08;070;Burbach;276;3;279
44;Grand Est;67;4;08;071;Bust;467;11;478
44;Grand Est;67;4;02;068;Buswiller;277;2;279
44;Grand Est;67;4;08;072;Butten;663;22;685
44;Grand Est;67;3;10;052;Bœrsch;2442;64;2506
44;Grand Est;67;5;16;053;Bœsenbiesen;323;10;333
44;Grand Est;67;5;16;073;Châtenois;4191;87;4278
44;Grand Est;67;2;23;074;Cleebourg;693;19;712
44;Grand Est;67;2;23;075;Climbach;435;7;442
44;Grand Est;67;3;11;076;Colroy-la-Roche;485;9;494
44;Grand Est;67;3;14;077;Cosswiller;579;14;593
44;Grand Est;67;3;14;078;Crastatt;270;3;273
44;Grand Est;67;2;23;079;Crœttwiller;178;3;181
44;Grand Est;67;3;10;080;Dachstein;1802;20;1822
44;Grand Est;67;3;10;081;Dahlenheim;775;12;787
44;Grand Est;67;2;01;082;Dalhunden;1199;11;1210
44;Grand Est;67;2;13;083;Dambach;745;12;757
44;Grand Est;67;5;12;084;Dambach-la-Ville;2216;41;2257
44;Grand Est;67;3;10;085;Dangolsheim;724;11;735
44;Grand Est;67;5;04;086;Daubensand;430;10;440
44;Grand Est;67;2;05;087;Dauendorf;1436;15;1451
44;Grand Est;67;4;08;088;Dehlingen;360;7;367
44;Grand Est;67;4;14;089;Dettwiller;2610;26;2636
44;Grand Est;67;5;04;090;Diebolsheim;684;44;728
44;Grand Est;67;4;08;091;Diedendorf;337;13;350
44;Grand Est;67;5;11;092;Dieffenbach-au-Val;629;27;656
44;Grand Est;67;2;13;093;Dieffenbach-lès-Wœrth;348;6;354
44;Grand Est;67;5;16;094;Dieffenthal;254;2;256
44;Grand Est;67;4;08;095;Diemeringen;1601;36;1637
44;Grand Est;67;4;14;096;Dimbsthal;314;11;325
44;Grand Est;67;4;02;097;Dingsheim;1256;17;1273
44;Grand Est;67;3;11;098;Dinsheim-sur-Bruche;1485;19;1504
44;Grand Est;67;4;08;099;Domfessel;285;4;289
44;Grand Est;67;2;03;100;Donnenheim;350;1;351
44;Grand Est;67;3;10;101;Dorlisheim;2633;32;2665
44;Grand Est;67;4;02;102;Dossenheim-Kochersberg;293;5;298
44;Grand Est;67;4;08;103;Dossenheim-sur-Zinsel;1043;25;1068
44;Grand Est;67;2;23;104;Drachenbronn-Birlenbach;685;16;701
44;Grand Est;67;4;08;105;Drulingen;1444;27;1471
44;Grand Est;67;2;01;106;Drusenheim;5211;47;5258
44;Grand Est;67;4;02;107;Duntzenheim;645;5;650
44;Grand Est;67;3;10;108;Duppigheim;1608;18;1626
44;Grand Est;67;4;02;109;Durningen;644;17;661
44;Grand Est;67;2;13;110;Durrenbach;1078;17;1095
44;Grand Est;67;4;08;111;Durstel;418;11;429
44;Grand Est;67;3;10;112;Duttlenheim;2880;30;2910
44;Grand Est;67;2;23;113;Eberbach-Seltz;424;7;431
44;Grand Est;67;5;16;115;Ebersheim;2261;23;2284
44;Grand Est;67;5;16;116;Ebersmunster;525;25;550
44;Grand Est;67;4;14;117;Eckartswiller;432;11;443
44;Grand Est;67;8;06;118;Eckbolsheim;6986;63;7049
44;Grand Est;67;8;03;119;Eckwersheim;1339;19;1358
44;Grand Est;67;5;12;120;Eichhoffen;528;11;539
44;Grand Est;67;5;16;121;Elsenheim;816;10;826
44;Grand Est;67;2;13;123;Engwiller;499;1;500
44;Grand Est;67;8;09;124;Entzheim;2422;24;2446
44;Grand Est;67;5;12;125;Epfig;2257;76;2333
44;Grand Est;67;4;08;126;Erckartswiller;299;6;305
44;Grand Est;67;3;10;127;Ergersheim;1408;14;1422
44;Grand Est;67;3;10;128;Ernolsheim-Bruche;1880;18;1898
44;Grand Est;67;4;14;129;Ernolsheim-lès-Saverne;594;6;600
44;Grand Est;67;5;04;130;Erstein;10621;124;10745
44;Grand Est;67;8;07;131;Eschau;5372;52;5424
44;Grand Est;67;2;13;132;Eschbach;943;11;954
44;Grand Est;67;4;08;133;Eschbourg;478;6;484
44;Grand Est;67;4;08;134;Eschwiller;183;0;183
44;Grand Est;67;4;02;135;Ettendorf;768;5;773
44;Grand Est;67;4;08;136;Eywiller;278;5;283
44;Grand Est;67;8;09;137;Fegersheim;5736;66;5802
44;Grand Est;67;4;02;138;Fessenheim-le-Bas;567;9;576
44;Grand Est;67;3;10;139;Flexbourg;466;9;475
44;Grand Est;67;2;01;140;Forstfeld;745;4;749
44;Grand Est;67;2;13;141;Forstheim;591;4;595
44;Grand Est;67;2;01;142;Fort-Louis;293;2;295
44;Grand Est;67;5;11;143;Fouchy;649;19;668
44;Grand Est;67;3;11;144;Fouday;335;2;337
44;Grand Est;67;4;14;145;Friedolsheim;247;5;252
44;Grand Est;67;5;04;146;Friesenheim;622;8;630
44;Grand Est;67;4;08;148;Frohmuhl;175;4;179
44;Grand Est;67;2;13;147;Frœschwiller;500;4;504
44;Grand Est;67;4;14;149;Furchhausen;422;7;429
44;Grand Est;67;4;02;150;Furdenheim;1313;22;1335
44;Grand Est;67;2;03;151;Gambsheim;4956;49;5005
44;Grand Est;67;8;09;152;Geispolsheim;7605;79;7684
44;Grand Est;67;4;02;153;Geiswiller-Zœbersdorf;403;3;406
44;Grand Est;67;5;04;154;Gerstheim;3447;55;3502
44;Grand Est;67;5;12;155;Gertwiller;1252;17;1269
44;Grand Est;67;2;03;156;Geudertheim;2564;31;2595
44;Grand Est;67;4;14;161;Gottenhouse;382;11;393
44;Grand Est;67;4;14;162;Gottesheim;352;8;360
44;Grand Est;67;4;02;163;Gougenheim;546;13;559
44;Grand Est;67;5;12;164;Goxwiller;841;20;861
44;Grand Est;67;3;11;165;Grandfontaine;393;7;400
44;Grand Est;67;4;02;166;Grassendorf;249;4;253
44;Grand Est;67;3;10;167;Grendelbruch;1209;16;1225
44;Grand Est;67;3;11;168;Gresswiller;1681;25;1706
44;Grand Est;67;2;03;169;Gries;2869;34;2903
44;Grand Est;67;3;10;172;Griesheim-près-Molsheim;2203;39;2242
44;Grand Est;67;4;02;173;Griesheim-sur-Souffel;1163;16;1179
44;Grand Est;67;2;13;174;Gumbrechtshoffen;1172;8;1180
44;Grand Est;67;2;13;176;Gundershoffen;3702;62;3764
44;Grand Est;67;4;08;178;Gungwiller;278;5;283
44;Grand Est;67;2;13;177;Gunstett;648;10;658
44;Grand Est;67;4;08;159;Gœrlingen;215;6;221
44;Grand Est;67;2;13;160;Gœrsdorf;1064;26;1090
44;Grand Est;67;4;14;179;Haegen;664;8;672
44;Grand Est;67;2;05;180;Haguenau;34789;568;35357
44;Grand Est;67;4;02;181;Handschuheim;270;6;276
44;Grand Est;67;8;09;182;Hangenbieten;1601;23;1624
44;Grand Est;67;4;08;183;Harskirchen;873;20;893
44;Grand Est;67;2;23;184;Hatten;1919;25;1944
44;Grand Est;67;4;14;185;Hattmatt;697;4;701
44;Grand Est;67;2;13;186;Hegeney;429;7;436
44;Grand Est;67;5;16;187;Heidolsheim;531;8;539
44;Grand Est;67;3;11;188;Heiligenberg;693;11;704
44;Grand Est;67;5;12;189;Heiligenstein;961;22;983
44;Grand Est;67;4;14;190;Hengwiller;192;2;194
44;Grand Est;67;4;08;191;Herbitzheim;1839;26;1865
44;Grand Est;67;5;04;192;Herbsheim;930;10;940
44;Grand Est;67;2;01;194;Herrlisheim;4796;74;4870
44;Grand Est;67;5;16;195;Hessenheim;620;10;630
44;Grand Est;67;5;16;196;Hilsenheim;2638;30;2668
44;Grand Est;67;5;04;197;Hindisheim;1498;21;1519
44;Grand Est;67;4;08;198;Hinsbourg;111;3;114
44;Grand Est;67;4;08;199;Hinsingen;84;1;85
44;Grand Est;67;5;04;200;Hipsheim;1006;8;1014
44;Grand Est;67;4;08;201;Hirschland;315;7;322
44;Grand Est;67;4;02;202;Hochfelden ;4009;37;4046
44;Grand Est;67;2;05;203;Hochstett;373;5;378
44;Grand Est;67;2;23;206;Hoffen;1122;18;1140
44;Grand Est;67;3;14;208;Hohengœft;544;7;551
44;Grand Est;67;4;02;209;Hohfrankenheim;270;2;272
44;Grand Est;67;5;12;210;Le Hohwald;508;13;521
44;Grand Est;67;8;09;212;Holtzheim;3696;30;3726
44;Grand Est;67;2;23;213;Hunspach;637;16;653
44;Grand Est;67;4;02;214;Hurtigheim;923;7;930
44;Grand Est;67;2;05;215;Huttendorf;501;3;504
44;Grand Est;67;5;04;216;Huttenheim;2686;37;2723
44;Grand Est;67;8;06;204;Hœnheim;11145;80;11225
44;Grand Est;67;2;03;205;Hœrdt;4442;50;4492
44;Grand Est;67;5;04;217;Ichtratzheim;345;4;349
44;Grand Est;67;8;07;218;Illkirch-Graffenstaden;26830;695;27525
44;Grand Est;67;4;02;220;Ingenheim;330;2;332
44;Grand Est;67;2;23;221;Ingolsheim;333;5;338
44;Grand Est;67;4;08;222;Ingwiller;4057;37;4094
44;Grand Est;67;5;10;223;Innenheim;1188;7;1195
44;Grand Est;67;4;02;225;Issenhausen;111;2;113
44;Grand Est;67;4;02;226;Ittenheim;2112;24;2136
44;Grand Est;67;5;12;227;Itterswiller;237;4;241
44;Grand Est;67;3;14;229;Jetterswiller;196;2;198
44;Grand Est;67;2;01;230;Kaltenhouse;2435;19;2454
44;Grand Est;67;2;01;231;Kauffenheim;212;2;214
44;Grand Est;67;2;23;232;Keffenach;198;6;204
44;Grand Est;67;5;04;233;Kertzfeld;1207;20;1227
44;Grand Est;67;4;08;234;Keskastel;1518;30;1548
44;Grand Est;67;2;23;235;Kesseldorf;415;2;417
44;Grand Est;67;4;02;236;Kienheim;551;10;561
44;Grand Est;67;2;03;237;Kilstett;2482;34;2516
44;Grand Est;67;2;13;238;Kindwiller;641;7;648
44;Grand Est;67;5;16;239;Kintzheim;1644;32;1676
44;Grand Est;67;3;10;240;Kirchheim;712;3;715
44;Grand Est;67;4;08;241;Kirrberg;146;4;150
44;Grand Est;67;4;02;242;Kirrwiller;528;5;533
44;Grand Est;67;4;14;244;Kleingœft;155;3;158
44;Grand Est;67;3;14;245;Knœrsheim;215;3;218
44;Grand Est;67;5;04;246;Kogenheim;1258;18;1276
44;Grand Est;67;8;09;247;Kolbsheim;961;20;981
44;Grand Est;67;5;12;248;Krautergersheim;1697;26;1723
44;Grand Est;67;2;03;249;Krautwiller;247;7;254
44;Grand Est;67;2;03;250;Kriegsheim;787;18;805
44;Grand Est;67;2;03;252;Kurtzenhouse;1052;12;1064
44;Grand Est;67;4;02;253;Kuttolsheim;629;10;639
44;Grand Est;67;2;13;254;Kutzenhausen;912;16;928
44;Grand Est;67;5;11;255;Lalaye;476;8;484
44;Grand Est;67;8;06;256;Lampertheim;3351;52;3403
44;Grand Est;67;2;13;257;Lampertsloch;714;15;729
44;Grand Est;67;4;14;258;Landersheim;194;3;197
44;Grand Est;67;2;13;259;Langensoultzbach;928;11;939
44;Grand Est;67;2;13;260;Laubach;322;5;327
44;Grand Est;67;2;23;261;Lauterbourg;2318;26;2344
44;Grand Est;67;2;13;263;Lembach;1549;43;1592
44;Grand Est;67;2;01;264;Leutenheim;833;12;845
44;Grand Est;67;4;08;265;Lichtenberg;553;7;560
44;Grand Est;67;5;04;266;Limersheim;651;8;659
44;Grand Est;67;8;09;267;Lingolsheim;18930;146;19076
44;Grand Est;67;8;09;268;Lipsheim;2632;30;2662
44;Grand Est;67;4;14;269;Littenheim;291;3;294
44;Grand Est;67;4;02;270;Lixhausen;387;1;388
44;Grand Est;67;2;13;271;Lobsann;644;7;651
44;Grand Est;67;4;14;272;Lochwiller;406;6;412
44;Grand Est;67;4;08;273;Lohr;498;6;504
44;Grand Est;67;4;08;274;Lorentzen;246;2;248
44;Grand Est;67;4;14;275;Lupstein;800;13;813
44;Grand Est;67;3;11;276;Lutzelhouse;1900;28;1928
44;Grand Est;67;5;16;277;Mackenheim;762;11;773
44;Grand Est;67;4;08;278;Mackwiller;561;13;574
44;Grand Est;67;4;14;279;Maennolsheim;232;5;237
44;Grand Est;67;5;11;280;Maisonsgoutte;801;18;819
44;Grand Est;67;5;16;281;Marckolsheim;4161;65;4226
44;Grand Est;67;3;10;282;Marlenheim;4267;64;4331
44;Grand Est;67;4;14;283;Marmoutier;2723;43;2766
44;Grand Est;67;5;04;285;Matzenheim;1459;108;1567
44;Grand Est;67;5;12;286;Meistratzheim;1500;19;1519
44;Grand Est;67;4;02;287;Melsheim;590;6;596
44;Grand Est;67;2;23;288;Memmelshoffen;328;4;332
44;Grand Est;67;4;08;289;Menchhoffen;625;10;635
44;Grand Est;67;2;13;290;Merkwiller-Pechelbronn;918;17;935
44;Grand Est;67;2;13;291;Mertzwiller;3350;39;3389
44;Grand Est;67;2;13;292;Mietesheim;670;12;682
44;Grand Est;67;4;02;293;Minversheim;653;11;664
44;Grand Est;67;5;12;295;Mittelbergheim;635;24;659
44;Grand Est;67;8;06;296;Mittelhausbergen;2035;23;2058
44;Grand Est;67;2;03;298;Mittelschaeffolsheim;573;8;581
44;Grand Est;67;3;10;299;Mollkirch;914;26;940
44;Grand Est;67;3;10;300;Molsheim;9334;138;9472
44;Grand Est;67;2;03;301;Mommenheim;2012;19;2031
44;Grand Est;67;4;14;302;Monswiller;2045;37;2082
44;Grand Est;67;2;13;303;Morsbronn-les-Bains;689;12;701
44;Grand Est;67;2;05;304;Morschwiller;583;13;596
44;Grand Est;67;2;23;305;Mothern;1978;21;1999
44;Grand Est;67;3;11;306;Muhlbach-sur-Bruche;639;54;693
44;Grand Est;67;4;08;307;Mulhausen;475;5;480
44;Grand Est;67;2;23;308;Munchhausen;793;9;802
44;Grand Est;67;8;06;309;Mundolsheim;4767;62;4829
44;Grand Est;67;5;16;310;Mussig;1168;34;1202
44;Grand Est;67;5;16;311;Muttersholtz;2075;28;2103
44;Grand Est;67;4;02;312;Mutzenhouse;465;8;473
44;Grand Est;67;3;11;313;Mutzig;6042;53;6095
44;Grand Est;67;3;11;314;Natzwiller;537;8;545
44;Grand Est;67;2;23;315;Neewiller-près-Lauterbourg;662;14;676
44;Grand Est;67;5;11;317;Neubois;685;18;703
44;Grand Est;67;4;02;228;Neugartheim-Ittlenheim;791;17;808
44;Grand Est;67;2;01;319;Neuhaeusel;358;3;361
44;Grand Est;67;5;11;320;Neuve-Église;626;10;636
44;Grand Est;67;3;11;321;Neuviller-la-Roche;335;8;343
44;Grand Est;67;4;08;322;Neuwiller-lès-Saverne;1108;13;1121
44;Grand Est;67;2;13;324;Niederbronn-les-Bains;4393;68;4461
44;Grand Est;67;3;11;325;Niederhaslach;1402;17;1419
44;Grand Est;67;8;06;326;Niederhausbergen;1657;13;1670
44;Grand Est;67;2;23;327;Niederlauterbach;963;22;985
44;Grand Est;67;2;13;328;Niedermodern;895;7;902
44;Grand Est;67;5;12;329;Niedernai;1271;22;1293
44;Grand Est;67;2;23;330;Niederrœdern;928;9;937
44;Grand Est;67;2;05;331;Niederschaeffolsheim;1382;13;1395
44;Grand Est;67;4;08;333;Niedersoultzbach;288;5;293
44;Grand Est;67;2;13;334;Niedersteinbach;118;1;119
44;Grand Est;67;3;10;335;Nordheim;909;16;925
44;Grand Est;67;5;04;336;Nordhouse;1737;30;1767
44;Grand Est;67;5;12;337;Nothalten;456;16;472
44;Grand Est;67;5;04;338;Obenheim;1338;22;1360
44;Grand Est;67;2;13;340;Oberbronn;1563;28;1591
44;Grand Est;67;2;13;341;Oberdorf-Spachbach;377;2;379
44;Grand Est;67;3;11;342;Oberhaslach;1769;29;1798
44;Grand Est;67;8;06;343;Oberhausbergen;5398;55;5453
44;Grand Est;67;2;23;344;Oberhoffen-lès-Wissembourg;317;4;321
44;Grand Est;67;2;01;345;Oberhoffen-sur-Moder;3495;27;3522
44;Grand Est;67;2;23;346;Oberlauterbach;539;11;550
44;Grand Est;67;4;02;347;Obermodern-Zutzendorf;1683;22;1705
44;Grand Est;67;5;12;348;Obernai;11350;449;11799
44;Grand Est;67;2;23;349;Oberrœdern;519;9;528
44;Grand Est;67;8;09;350;Oberschaeffolsheim;2290;24;2314
44;Grand Est;67;4;02;352;Obersoultzbach;421;8;429
44;Grand Est;67;2;13;353;Obersteinbach;231;2;233
44;Grand Est;67;3;10;354;Odratzheim;507;9;516
44;Grand Est;67;4;08;355;Oermingen;1208;29;1237
44;Grand Est;67;2;01;356;Offendorf;2486;23;2509
44;Grand Est;67;2;13;358;Offwiller;799;13;812
44;Grand Est;67;2;05;359;Ohlungen;1309;23;1332
44;Grand Est;67;5;16;360;Ohnenheim;1050;14;1064
44;Grand Est;67;2;03;361;Olwisheim;498;6;504
44;Grand Est;67;5;16;362;Orschwiller;590;5;595
44;Grand Est;67;8;09;363;Osthoffen;820;17;837
44;Grand Est;67;5;04;364;Osthouse;925;17;942
44;Grand Est;67;8;07;365;Ostwald;12586;127;12713
44;Grand Est;67;4;14;366;Ottersthal;747;17;764
44;Grand Est;67;4;14;367;Otterswiller;1333;32;1365
44;Grand Est;67;3;10;368;Ottrott;1543;31;1574
44;Grand Est;67;4;08;369;Ottwiller;260;5;265
44;Grand Est;67;4;08;370;Petersbach;653;12;665
44;Grand Est;67;4;08;371;La Petite-Pierre;621;4;625
44;Grand Est;67;4;08;373;Pfalzweyer;320;4;324
44;Grand Est;67;4;02;375;Pfulgriesheim;1310;17;1327
44;Grand Est;67;3;11;377;Plaine;998;11;1009
44;Grand Est;67;8;07;378;Plobsheim;4493;42;4535
44;Grand Est;67;2;13;379;Preuschdorf;893;15;908
44;Grand Est;67;4;14;380;Printzheim;203;4;207
44;Grand Est;67;4;08;381;Puberg;355;5;360
44;Grand Est;67;4;02;382;Quatzenheim;782;18;800
44;Grand Est;67;3;14;383;Rangen;191;5;196
44;Grand Est;67;3;11;384;Ranrupt;318;5;323
44;Grand Est;67;4;08;385;Ratzwiller;250;2;252
44;Grand Est;67;4;08;386;Rauwiller;208;2;210
44;Grand Est;67;5;12;387;Reichsfeld;298;9;307
44;Grand Est;67;2;13;388;Reichshoffen;5399;84;5483
44;Grand Est;67;8;06;389;Reichstett;4406;41;4447
44;Grand Est;67;4;14;391;Reinhardsmunster;447;6;453
44;Grand Est;67;4;08;392;Reipertswiller;854;12;866
44;Grand Est;67;2;23;394;Retschwiller;282;6;288
44;Grand Est;67;4;14;395;Reutenbourg;406;10;416
44;Grand Est;67;4;08;396;Rexingen;202;1;203
44;Grand Est;67;5;04;397;Rhinau;2681;31;2712
44;Grand Est;67;5;16;398;Richtolsheim;352;2;354
44;Grand Est;67;2;23;400;Riedseltz;1098;20;1118
44;Grand Est;67;4;08;401;Rimsdorf;307;10;317
44;Grand Est;67;4;02;403;Ringendorf;435;12;447
44;Grand Est;67;2;23;404;Rittershoffen;910;16;926
44;Grand Est;67;4;02;406;Rohr;331;3;334
44;Grand Est;67;2;01;407;Rohrwiller;1627;13;1640
44;Grand Est;67;3;14;408;Romanswiller;1223;17;1240
44;Grand Est;67;2;01;409;Roppenheim;1007;8;1015
44;Grand Est;67;3;10;410;Rosenwiller;673;14;687
44;Grand Est;67;3;10;411;Rosheim;5224;112;5336
44;Grand Est;67;5;04;412;Rossfeld;1013;9;1022
44;Grand Est;67;4;08;413;Rosteig;530;11;541
44;Grand Est;67;3;11;414;Rothau;1570;19;1589
44;Grand Est;67;2;13;415;Rothbach;469;1;470
44;Grand Est;67;2;23;416;Rott;470;10;480
44;Grand Est;67;2;03;417;Rottelsheim;302;9;311
44;Grand Est;67;2;01;418;Rountzenheim-Auenheim ;1930;35;1965
44;Grand Est;67;3;11;420;Russ;1244;16;1260
44;Grand Est;67;2;01;405;Rœschwoog;2275;50;2325
44;Grand Est;67;3;11;421;Saales;833;13;846
44;Grand Est;67;5;16;422;Saasenheim;595;10;605
44;Grand Est;67;4;14;423;Saessolsheim;574;7;581
44;Grand Est;67;3;11;424;Saint-Blaise-la-Roche;229;0;229
44;Grand Est;67;4;14;425;Saint-Jean-Saverne;547;13;560
44;Grand Est;67;5;11;426;Saint-Martin;359;1;360
44;Grand Est;67;5;11;427;Saint-Maurice;345;14;359
44;Grand Est;67;3;10;428;Saint-Nabor;491;12;503
44;Grand Est;67;5;12;429;Saint-Pierre;638;12;650
44;Grand Est;67;5;11;430;Saint-Pierre-Bois;769;25;794
44;Grand Est;67;2;23;432;Salmbach;579;11;590
44;Grand Est;67;5;04;433;Sand;1330;10;1340
44;Grand Est;67;4;08;434;Sarre-Union;2811;43;2854
44;Grand Est;67;4;08;435;Sarrewerden;842;21;863
44;Grand Est;67;3;11;436;Saulxures;508;12;520
44;Grand Est;67;4;14;437;Saverne;11289;305;11594
44;Grand Est;67;5;04;438;Schaeffersheim;824;13;837
44;Grand Est;67;2;23;440;Schaffhouse-près-Seltz;556;12;568
44;Grand Est;67;4;02;441;Schalkendorf;330;5;335
44;Grand Est;67;3;10;442;Scharrachbergheim-Irmstett;1223;60;1283
44;Grand Est;67;2;23;443;Scheibenhard;833;20;853
44;Grand Est;67;4;02;444;Scherlenheim;124;3;127
44;Grand Est;67;5;16;445;Scherwiller;3206;53;3259
44;Grand Est;67;4;08;446;Schillersdorf;431;11;442
44;Grand Est;67;8;15;447;Schiltigheim;33069;199;33268
44;Grand Est;67;3;11;448;Schirmeck;2167;49;2216
44;Grand Est;67;2;01;449;Schirrhein;2242;21;2263
44;Grand Est;67;2;01;450;Schirrhoffen;687;16;703
44;Grand Est;67;2;23;451;Schleithal;1411;32;1443
44;Grand Est;67;4;02;452;Schnersheim;1673;31;1704
44;Grand Est;67;4;08;456;Schopperten;448;10;458
44;Grand Est;67;2;05;458;Schweighouse-sur-Moder;4957;61;5018
44;Grand Est;67;4;14;459;Schwenheim;753;17;770
44;Grand Est;67;4;02;460;Schwindratzheim;1721;22;1743
44;Grand Est;67;5;16;461;Schwobsheim;325;14;339
44;Grand Est;67;5;16;453;Schœnau;607;8;615
44;Grand Est;67;4;08;454;Schœnbourg;414;8;422
44;Grand Est;67;2;23;455;Schœnenbourg;691;11;702
44;Grand Est;67;2;23;351;Seebach;1689;37;1726
44;Grand Est;67;5;16;462;Sélestat;19360;269;19629
44;Grand Est;67;2;23;463;Seltz;3163;34;3197
44;Grand Est;67;5;04;464;Sermersheim;940;13;953
44;Grand Est;67;2;01;465;Sessenheim;2323;33;2356
44;Grand Est;67;2;23;466;Siegen;509;9;518
44;Grand Est;67;4;08;467;Siewiller;384;7;391
44;Grand Est;67;4;08;468;Siltzheim;626;16;642
44;Grand Est;67;3;11;470;Solbach;101;1;102
44;Grand Est;67;4;14;004;Sommerau;1534;28;1562
44;Grand Est;67;8;06;471;Souffelweyersheim;8005;62;8067
44;Grand Est;67;2;01;472;Soufflenheim;4858;56;4914
44;Grand Est;67;3;10;473;Soultz-les-Bains;954;18;972
44;Grand Est;67;2;23;474;Soultz-sous-Forêts;3186;35;3221
44;Grand Est;67;4;08;475;Sparsbach;234;3;237
44;Grand Est;67;2;01;476;Stattmatten;724;6;730
44;Grand Est;67;5;11;477;Steige;604;17;621
44;Grand Est;67;4;14;478;Steinbourg;1965;28;1993
44;Grand Est;67;2;23;479;Steinseltz;601;22;623
44;Grand Est;67;3;11;480;Still;1813;26;1839
44;Grand Est;67;5;12;481;Stotzheim;1096;14;1110
44;Grand Est;67;8;99;482;Strasbourg;284677;2855;287532
44;Grand Est;67;4;08;483;Struth;243;4;247
44;Grand Est;67;2;23;484;Stundwiller;489;10;499
44;Grand Est;67;4;02;485;Stutzheim-Offenheim;1524;25;1549
44;Grand Est;67;5;16;486;Sundhouse;1818;23;1841
44;Grand Est;67;2;23;487;Surbourg;1720;25;1745
44;Grand Est;67;4;08;488;Thal-Drulingen;185;4;189
44;Grand Est;67;4;14;489;Thal-Marmoutier;794;19;813
44;Grand Est;67;5;11;490;Thanvillé;589;19;608
44;Grand Est;67;4;08;491;Tieffenbach;255;0;255
44;Grand Est;67;3;14;492;Traenheim;649;16;665
44;Grand Est;67;5;11;493;Triembach-au-Val;451;10;461
44;Grand Est;67;2;23;494;Trimbach;579;11;590
44;Grand Est;67;4;02;495;Truchtersheim;4148;96;4244
44;Grand Est;67;2;05;497;Uhlwiller;679;14;693
44;Grand Est;67;2;13;498;Uhrwiller;702;6;708
44;Grand Est;67;5;11;499;Urbeis;320;14;334
44;Grand Est;67;3;11;500;Urmatt;1469;35;1504
44;Grand Est;67;5;04;501;Uttenheim;560;4;564
44;Grand Est;67;2;13;502;Uttenhoffen;206;2;208
44;Grand Est;67;4;02;503;Uttwiller;161;2;163
44;Grand Est;67;2;89;372;Val-de-Moder;5068;60;5128
44;Grand Est;67;5;12;504;Valff;1381;15;1396
44;Grand Est;67;5;16;505;La Vancelle;402;13;415
44;Grand Est;67;8;03;506;Vendenheim;5817;67;5884
44;Grand Est;67;5;11;507;Villé;1818;33;1851
44;Grand Est;67;4;08;509;Volksberg;353;3;356
44;Grand Est;67;4;08;508;Vœllerdingen;415;19;434
44;Grand Est;67;2;05;510;Wahlenheim;553;1;554
44;Grand Est;67;2;13;511;Walbourg;931;274;1205
44;Grand Est;67;3;11;513;Waldersbach;129;1;130
44;Grand Est;67;4;08;514;Waldhambach;629;9;638
44;Grand Est;67;4;14;515;Waldolwisheim;573;9;582
44;Grand Est;67;4;02;516;Waltenheim-sur-Zorn;667;8;675
44;Grand Est;67;3;10;517;Wangen;684;11;695
44;Grand Est;67;3;14;122;Wangenbourg-Engenthal;1341;15;1356
44;Grand Est;67;8;03;519;La Wantzenau;5838;110;5948
44;Grand Est;67;3;14;520;Wasselonne;5661;64;5725
44;Grand Est;67;4;08;521;Weinbourg;441;3;444
44;Grand Est;67;4;08;522;Weislingen;540;7;547
44;Grand Est;67;2;03;523;Weitbruch;2802;37;2839
44;Grand Est;67;4;08;524;Weiterswiller;521;8;529
44;Grand Est;67;3;14;525;Westhoffen;1644;26;1670
44;Grand Est;67;5;04;526;Westhouse;1543;18;1561
44;Grand Est;67;4;14;527;Westhouse-Marmoutier;320;7;327
44;Grand Est;67;4;08;528;Weyer;573;9;582
44;Grand Est;67;2;03;529;Weyersheim;3377;35;3412
44;Grand Est;67;4;02;530;Wickersheim-Wilshausen;386;6;392
44;Grand Est;67;3;11;531;Wildersbach;287;6;293
44;Grand Est;67;4;02;532;Willgottheim;1095;18;1113
44;Grand Est;67;4;02;534;Wilwisheim;728;3;731
44;Grand Est;67;4;08;535;Wimmenau;1059;21;1080
44;Grand Est;67;2;13;536;Windstein;161;1;162
44;Grand Est;67;2;13;537;Wingen;450;6;456
44;Grand Est;67;4;08;538;Wingen-sur-Moder;1606;21;1627
44;Grand Est;67;4;02;539;Wingersheim les Quatre Bans;2311;42;2353
44;Grand Est;67;2;05;540;Wintershouse;880;12;892
44;Grand Est;67;2;23;541;Wintzenbach;539;2;541
44;Grand Est;67;4;02;542;Wintzenheim-Kochersberg;453;3;456
44;Grand Est;67;3;11;543;Wisches;2100;29;2129
44;Grand Est;67;2;23;544;Wissembourg;7519;213;7732
44;Grand Est;67;5;04;545;Witternheim;505;7;512
44;Grand Est;67;2;05;546;Wittersheim;666;5;671
44;Grand Est;67;5;16;547;Wittisheim;2058;25;2083
44;Grand Est;67;4;02;548;Wiwersheim;887;13;900
44;Grand Est;67;8;06;551;Wolfisheim;4174;56;4230
44;Grand Est;67;4;08;552;Wolfskirchen;345;10;355
44;Grand Est;67;4;14;553;Wolschheim;321;4;325
44;Grand Est;67;3;10;554;Wolxheim;972;13;985
44;Grand Est;67;2;13;550;Wœrth;1746;23;1769
44;Grand Est;67;3;14;555;Zehnacker;248;3;251
44;Grand Est;67;3;14;556;Zeinheim;205;3;208
44;Grand Est;67;5;12;557;Zellwiller;810;11;821
44;Grand Est;67;2;13;558;Zinswiller;758;13;771
44;Grand Est;67;4;08;559;Zittersheim;249;2;251
44;Grand Est;68;2;06;001;Algolsheim;1132;13;1145
44;Grand Est;68;1;09;002;Altenach;392;4;396
44;Grand Est;68;1;01;004;Altkirch;5698;132;5830
44;Grand Est;68;2;15;005;Ammerschwihr;1768;47;1815
44;Grand Est;68;2;05;007;Andolsheim;2172;72;2244
44;Grand Est;68;2;06;008;Appenwihr;585;12;597
44;Grand Est;68;2;06;009;Artzenheim;862;11;873
44;Grand Est;68;1;01;010;Aspach;1124;20;1144
44;Grand Est;68;6;03;011;Aspach-le-Bas;1319;26;1345
44;Grand Est;68;6;03;012;Aspach-Michelbach;1777;44;1821
44;Grand Est;68;4;14;013;Attenschwiller;988;22;1010
44;Grand Est;68;2;15;014;Aubure;370;9;379
44;Grand Est;68;4;13;015;Baldersheim;2662;48;2710
44;Grand Est;68;2;06;016;Balgau;970;18;988
44;Grand Est;68;1;09;017;Ballersdorf;820;17;837
44;Grand Est;68;1;09;018;Balschwiller;743;16;759
44;Grand Est;68;2;06;019;Baltzenheim;570;8;578
44;Grand Est;68;4;13;020;Bantzenheim;1594;33;1627
44;Grand Est;68;4;02;021;Bartenheim;3912;83;3995
44;Grand Est;68;4;13;022;Battenheim;1592;14;1606
44;Grand Est;68;2;15;023;Beblenheim;940;24;964
44;Grand Est;68;1;09;024;Bellemagny;176;6;182
44;Grand Est;68;1;01;025;Bendorf;226;3;229
44;Grand Est;68;2;15;026;Bennwihr;1376;27;1403
44;Grand Est;68;1;01;027;Berentzwiller;334;9;343
44;Grand Est;68;2;15;028;Bergheim;2096;49;2145
44;Grand Est;68;6;07;029;Bergholtz;1092;32;1124
44;Grand Est;68;6;07;030;Bergholtzzell;427;15;442
44;Grand Est;68;1;09;006;Bernwiller;1189;28;1217
44;Grand Est;68;4;17;032;Berrwiller;1196;36;1232
44;Grand Est;68;1;01;033;Bettendorf;443;8;451
44;Grand Est;68;1;01;034;Bettlach;313;16;329
44;Grand Est;68;1;01;035;Biederthal;318;14;332
44;Grand Est;68;2;06;036;Biesheim;2549;56;2605
44;Grand Est;68;6;06;037;Biltzheim;455;7;462
44;Grand Est;68;2;05;038;Bischwihr;1079;25;1104
44;Grand Est;68;1;01;039;Bisel;545;15;560
44;Grand Est;68;6;03;040;Bitschwiller-lès-Thann;1974;37;2011
44;Grand Est;68;2;06;041;Blodelsheim;1974;26;2000
44;Grand Est;68;4;14;042;Blotzheim;4593;116;4709
44;Grand Est;68;4;17;043;Bollwiller;4075;56;4131
44;Grand Est;68;2;15;044;Le Bonhomme;743;31;774
44;Grand Est;68;6;03;045;Bourbach-le-Bas;557;16;573
44;Grand Est;68;6;03;046;Bourbach-le-Haut;418;10;428
44;Grand Est;68;1;01;049;Bouxwiller;449;16;465
44;Grand Est;68;1;09;050;Bréchaumont;409;13;422
44;Grand Est;68;2;16;051;Breitenbach-Haut-Rhin;826;16;842
44;Grand Est;68;1;09;052;Bretten;183;3;186
44;Grand Est;68;4;02;054;Brinckheim;416;8;424
44;Grand Est;68;4;02;055;Bruebach;1057;33;1090
44;Grand Est;68;4;02;056;Brunstatt-Didenheim ;8107;212;8319
44;Grand Est;68;1;09;057;Buethwiller;281;4;285
44;Grand Est;68;6;07;058;Buhl;3331;37;3368
44;Grand Est;68;6;09;059;Burnhaupt-le-Bas;1900;45;1945
44;Grand Est;68;6;09;060;Burnhaupt-le-Haut;1775;46;1821
44;Grand Est;68;4;14;061;Buschwiller;1049;17;1066
44;Grand Est;68;1;01;062;Carspach;2035;104;2139
44;Grand Est;68;6;03;063;Cernay;11326;221;11547
44;Grand Est;68;4;13;064;Chalampé;951;19;970
44;Grand Est;68;1;09;065;Chavannes-sur-l'Étang;695;10;705
44;Grand Est;68;2;98;066;Colmar;68703;1071;69774
44;Grand Est;68;1;01;067;Courtavon;361;2;363
44;Grand Est;68;1;09;068;Dannemarie;2259;35;2294
44;Grand Est;68;2;06;069;Dessenheim;1457;32;1489
44;Grand Est;68;1;09;071;Diefmatten;298;6;304
44;Grand Est;68;4;02;072;Dietwiller;1439;54;1493
44;Grand Est;68;6;09;073;Dolleren;480;11;491
44;Grand Est;68;1;01;074;Durlinsdorf;565;7;572
44;Grand Est;68;1;01;075;Durmenach;832;17;849
44;Grand Est;68;2;06;076;Durrenentzen;936;11;947
44;Grand Est;68;1;09;077;Eglingen;368;10;378
44;Grand Est;68;2;16;078;Eguisheim;1723;41;1764
44;Grand Est;68;1;09;079;Elbach;259;0;259
44;Grand Est;68;1;01;080;Emlingen;295;3;298
44;Grand Est;68;6;06;082;Ensisheim;7522;70;7592
44;Grand Est;68;2;16;083;Eschbach-au-Val;364;13;377
44;Grand Est;68;4;02;084;Eschentzwiller;1473;48;1521
44;Grand Est;68;1;09;085;Eteimbes;378;5;383
44;Grand Est;68;1;09;086;Falkwiller;194;9;203
44;Grand Est;68;1;01;087;Feldbach;452;11;463
44;Grand Est;68;4;17;088;Feldkirch;995;20;1015
44;Grand Est;68;6;03;089;Fellering;1604;26;1630
44;Grand Est;68;1;01;090;Ferrette;770;12;782
44;Grand Est;68;2;06;091;Fessenheim;2310;49;2359
44;Grand Est;68;1;01;092;Fislis;405;7;412
44;Grand Est;68;4;02;093;Flaxlanden;1443;47;1490
44;Grand Est;68;4;14;094;Folgensbourg;926;14;940
44;Grand Est;68;2;05;095;Fortschwihr;1165;39;1204
44;Grand Est;68;1;01;096;Franken;362;4;366
44;Grand Est;68;2;15;097;Fréland;1331;32;1363
44;Grand Est;68;1;09;098;Friesen;647;7;654
44;Grand Est;68;1;01;099;Frœningen;761;18;779
44;Grand Est;68;1;09;100;Fulleren;341;14;355
44;Grand Est;68;4;08;101;Galfingue;802;17;819
44;Grand Est;68;6;03;102;Geishouse;440;10;450
44;Grand Est;68;4;02;103;Geispitzen;461;8;469
44;Grand Est;68;2;06;104;Geiswasser;297;5;302
44;Grand Est;68;1;09;105;Gildwiller;265;15;280
44;Grand Est;68;6;03;106;Goldbach-Altenbach;282;6;288
44;Grand Est;68;1;09;107;Gommersdorf;366;8;374
44;Grand Est;68;2;16;109;Griesbach-au-Val;703;14;717
44;Grand Est;68;2;05;110;Grussenheim;818;19;837
44;Grand Est;68;6;16;111;Gueberschwihr;848;25;873
44;Grand Est;68;6;07;112;Guebwiller;11022;305;11327
44;Grand Est;68;2;15;113;Guémar;1411;28;1439
44;Grand Est;68;1;09;114;Guevenatten;141;1;142
44;Grand Est;68;6;09;115;Guewenheim;1294;21;1315
44;Grand Est;68;6;16;116;Gundolsheim;708;22;730
44;Grand Est;68;2;16;117;Gunsbach;892;17;909
44;Grand Est;68;4;13;118;Habsheim;4947;86;5033
44;Grand Est;68;1;09;119;Hagenbach;728;15;743
44;Grand Est;68;4;14;120;Hagenthal-le-Bas;1215;27;1242
44;Grand Est;68;4;14;121;Hagenthal-le-Haut;673;18;691
44;Grand Est;68;6;07;122;Hartmannswiller;637;10;647
44;Grand Est;68;6;16;123;Hattstatt;789;28;817
44;Grand Est;68;1;01;124;Hausgauen;381;10;391
44;Grand Est;68;6;09;219;Le Haut Soultzbach;897;24;921
44;Grand Est;68;1;09;125;Hecken;508;9;517
44;Grand Est;68;4;14;126;Hégenheim;3395;74;3469
44;Grand Est;68;1;01;127;Heidwiller;641;14;655
44;Grand Est;68;1;01;128;Heimersdorf;660;15;675
44;Grand Est;68;4;08;129;Heimsbrunn;1337;50;1387
44;Grand Est;68;2;06;130;Heiteren;1038;21;1059
44;Grand Est;68;1;01;131;Heiwiller;166;1;167
44;Grand Est;68;4;02;132;Helfrantzkirch;704;17;721
44;Grand Est;68;2;16;134;Herrlisheim-près-Colmar;1838;27;1865
44;Grand Est;68;4;14;135;Hésingue;2745;54;2799
44;Grand Est;68;2;06;136;Hettenschlag;328;11;339
44;Grand Est;68;1;09;137;Hindlingen;630;9;639
44;Grand Est;68;1;01;138;Hirsingue;2121;52;2173
44;Grand Est;68;1;01;139;Hirtzbach;1452;22;1474
44;Grand Est;68;2;06;140;Hirtzfelden;1283;15;1298
44;Grand Est;68;1;01;141;Hochstatt;2169;57;2226
44;Grand Est;68;2;16;142;Hohrod;372;12;384
44;Grand Est;68;4;13;144;Hombourg;1340;26;1366
44;Grand Est;68;2;05;145;Horbourg-Wihr;6101;116;6217
44;Grand Est;68;2;05;146;Houssen;2282;22;2304
44;Grand Est;68;2;15;147;Hunawihr;603;8;611
44;Grand Est;68;1;01;148;Hundsbach;354;8;362
44;Grand Est;68;4;14;149;Huningue;7240;97;7337
44;Grand Est;68;2;16;150;Husseren-les-Châteaux;514;13;527
44;Grand Est;68;6;03;151;Husseren-Wesserling;1048;11;1059
44;Grand Est;68;1;01;152;Illfurth;2484;39;2523
44;Grand Est;68;2;15;153;Illhaeusern;711;13;724
44;Grand Est;68;1;01;240;Illtal;1370;19;1389
44;Grand Est;68;4;12;154;Illzach;14680;202;14882
44;Grand Est;68;2;04;155;Ingersheim;4679;76;4755
44;Grand Est;68;6;07;156;Issenheim;3412;47;3459
44;Grand Est;68;2;05;157;Jebsheim;1385;40;1425
44;Grand Est;68;1;01;158;Jettingen;497;15;512
44;Grand Est;68;6;07;159;Jungholtz;904;25;929
44;Grand Est;68;4;02;160;Kappelen;586;24;610
44;Grand Est;68;2;15;161;Katzenthal;539;23;562
44;Grand Est;68;2;15;162;Kaysersberg Vignoble;4444;93;4537
44;Grand Est;68;4;02;163;Kembs;5376;99;5475
44;Grand Est;68;1;01;165;Kiffis;245;10;255
44;Grand Est;68;4;08;166;Kingersheim;13267;149;13416
44;Grand Est;68;6;09;167;Kirchberg;743;22;765
44;Grand Est;68;4;14;168;Knœringue;378;7;385
44;Grand Est;68;6;03;171;Kruth;944;12;956
44;Grand Est;68;2;06;172;Kunheim;1779;30;1809
44;Grand Est;68;1;01;169;Kœstlach;504;10;514
44;Grand Est;68;4;02;170;Kœtzingue;594;24;618
44;Grand Est;68;2;15;173;Labaroche;2138;77;2215
44;Grand Est;68;4;02;174;Landser;1642;25;1667
44;Grand Est;68;2;15;175;Lapoutroie;1885;40;1925
44;Grand Est;68;1;09;176;Largitzen;322;4;326
44;Grand Est;68;6;07;177;Lautenbach;1497;39;1536
44;Grand Est;68;6;07;178;Lautenbachzell;952;14;966
44;Grand Est;68;6;09;179;Lauw;915;15;930
44;Grand Est;68;6;03;180;Leimbach;898;29;927
44;Grand Est;68;1;01;181;Levoncourt;241;3;244
44;Grand Est;68;4;14;182;Leymen;1208;27;1235
44;Grand Est;68;4;14;183;Liebenswiller;187;4;191
44;Grand Est;68;1;01;184;Liebsdorf;307;10;317
44;Grand Est;68;2;15;185;Lièpvre;1704;33;1737
44;Grand Est;68;1;01;186;Ligsdorf;307;10;317
44;Grand Est;68;1;01;187;Linsdorf;325;10;335
44;Grand Est;68;6;07;188;Linthal;590;19;609
44;Grand Est;68;2;06;189;Logelheim;837;26;863
44;Grand Est;68;1;01;190;Lucelle;34;0;34
44;Grand Est;68;1;01;191;Luemschwiller;768;23;791
44;Grand Est;68;2;16;193;Luttenbach-près-Munster;746;9;755
44;Grand Est;68;1;01;194;Lutter;281;5;286
44;Grand Est;68;4;08;195;Lutterbach;6279;99;6378
44;Grand Est;68;1;09;196;Magny;304;5;309
44;Grand Est;68;4;02;197;Magstatt-le-Bas;481;9;490
44;Grand Est;68;4;02;198;Magstatt-le-Haut;286;8;294
44;Grand Est;68;6;03;199;Malmerspach;503;2;505
44;Grand Est;68;1;09;200;Manspach;546;12;558
44;Grand Est;68;6;09;201;Masevaux-Niederbruck;3759;81;3840
44;Grand Est;68;1;09;202;Mertzen;202;4;206
44;Grand Est;68;6;07;203;Merxheim;1251;26;1277
44;Grand Est;68;2;16;204;Metzeral;1049;15;1064
44;Grand Est;68;6;06;205;Meyenheim;1655;18;1673
44;Grand Est;68;4;14;207;Michelbach-le-Bas;696;10;706
44;Grand Est;68;4;14;208;Michelbach-le-Haut;598;11;609
44;Grand Est;68;2;15;209;Mittelwihr;840;16;856
44;Grand Est;68;2;16;210;Mittlach;333;1;334
44;Grand Est;68;6;03;211;Mitzach;389;8;397
44;Grand Est;68;6;03;213;Mollau;343;11;354
44;Grand Est;68;1;09;214;Montreux-Jeune;374;8;382
44;Grand Est;68;1;09;215;Montreux-Vieux;903;7;910
44;Grand Est;68;6;03;217;Moosch;1659;20;1679
44;Grand Est;68;1;09;216;Mooslargue;420;6;426
44;Grand Est;68;4;08;218;Morschwiller-le-Bas;3737;77;3814
44;Grand Est;68;1;01;221;Muespach;908;13;921
44;Grand Est;68;1;01;222;Muespach-le-Haut;1064;19;1083
44;Grand Est;68;2;16;223;Muhlbach-sur-Munster;772;14;786
44;Grand Est;68;4;99;224;Mulhouse;108942;1232;110174
44;Grand Est;68;2;06;225;Munchhouse;1510;27;1537
44;Grand Est;68;2;16;226;Munster;4653;84;4737
44;Grand Est;68;2;05;227;Muntzenheim;1267;33;1300
44;Grand Est;68;6;06;228;Munwiller;470;12;482
44;Grand Est;68;6;07;229;Murbach;161;3;164
44;Grand Est;68;1;01;212;Mœrnach;524;12;536
44;Grand Est;68;2;06;230;Nambsheim;583;7;590
44;Grand Est;68;2;06;231;Neuf-Brisach;1947;18;1965
44;Grand Est;68;4;14;232;Neuwiller;474;7;481
44;Grand Est;68;6;06;234;Niederentzen;718;11;729
44;Grand Est;68;6;06;235;Niederhergheim;1138;16;1154
44;Grand Est;68;2;16;237;Niedermorschwihr;549;14;563
44;Grand Est;68;4;13;238;Niffer;940;25;965
44;Grand Est;68;6;09;239;Oberbruck;391;15;406
44;Grand Est;68;6;06;241;Oberentzen;644;9;653
44;Grand Est;68;6;06;242;Oberhergheim;1223;25;1248
44;Grand Est;68;1;01;243;Oberlarg;139;1;140
44;Grand Est;68;2;16;244;Obermorschwihr;358;6;364
44;Grand Est;68;1;01;245;Obermorschwiller;411;15;426
44;Grand Est;68;2;06;246;Obersaasheim;1021;13;1034
44;Grand Est;68;6;03;247;Oderen;1262;15;1277
44;Grand Est;68;1;01;248;Oltingue;669;20;689
44;Grand Est;68;2;15;249;Orbey;3529;67;3596
44;Grand Est;68;6;07;250;Orschwihr;1039;18;1057
44;Grand Est;68;6;16;251;Osenbach;875;23;898
44;Grand Est;68;2;15;252;Ostheim;1633;29;1662
44;Grand Est;68;4;13;253;Ottmarsheim;1950;30;1980
44;Grand Est;68;4;13;254;Petit-Landau;827;18;845
44;Grand Est;68;6;16;255;Pfaffenheim;1421;44;1465
44;Grand Est;68;4;08;256;Pfastatt;9656;131;9787
44;Grand Est;68;1;09;257;Pfetterhouse;961;23;984
44;Grand Est;68;2;05;143;Porte du Ried;1802;58;1860
44;Grand Est;68;4;17;258;Pulversheim;3000;78;3078
44;Grand Est;68;1;01;259;Raedersdorf;514;7;521
44;Grand Est;68;6;07;260;Raedersheim;1111;27;1138
44;Grand Est;68;6;03;261;Rammersmatt;229;6;235
44;Grand Est;68;6;03;262;Ranspach;806;17;823
44;Grand Est;68;4;14;263;Ranspach-le-Bas;641;13;654
44;Grand Est;68;4;14;264;Ranspach-le-Haut;628;11;639
44;Grand Est;68;4;02;265;Rantzwiller;796;23;819
44;Grand Est;68;6;06;266;Réguisheim;1942;30;1972
44;Grand Est;68;4;08;267;Reiningue;1981;25;2006
44;Grand Est;68;1;09;268;Retzwiller;706;10;716
44;Grand Est;68;2;15;269;Ribeauvillé;4697;170;4867
44;Grand Est;68;4;08;270;Richwiller;3690;58;3748
44;Grand Est;68;4;13;271;Riedisheim;12660;328;12988
44;Grand Est;68;1;01;273;Riespach;635;40;675
44;Grand Est;68;6;07;274;Rimbach-près-Guebwiller;188;0;188
44;Grand Est;68;6;09;275;Rimbach-près-Masevaux;455;11;466
44;Grand Est;68;6;07;276;Rimbachzell;193;2;195
44;Grand Est;68;2;15;277;Riquewihr;1081;19;1100
44;Grand Est;68;4;13;278;Rixheim;14071;199;14270
44;Grand Est;68;6;03;279;Roderen;895;30;925
44;Grand Est;68;2;15;280;Rodern;371;6;377
44;Grand Est;68;2;06;281;Roggenhouse;468;13;481
44;Grand Est;68;1;09;282;Romagny;269;5;274
44;Grand Est;68;2;15;283;Rombach-le-Franc;773;22;795
44;Grand Est;68;1;01;284;Roppentzwiller;695;10;705
44;Grand Est;68;2;15;285;Rorschwihr;367;8;375
44;Grand Est;68;4;14;286;Rosenau;2368;49;2417
44;Grand Est;68;6;16;287;Rouffach;4417;244;4661
44;Grand Est;68;1;01;288;Ruederbach;400;4;404
44;Grand Est;68;4;17;289;Ruelisheim;2307;37;2344
44;Grand Est;68;2;06;291;Rumersheim-le-Haut;1069;28;1097
44;Grand Est;68;2;06;290;Rustenhart;873;16;889
44;Grand Est;68;6;03;292;Saint-Amarin;2241;43;2284
44;Grand Est;68;1;01;081;Saint-Bernard;572;9;581
44;Grand Est;68;1;09;293;Saint-Cosme;87;1;88
44;Grand Est;68;2;15;296;Saint-Hippolyte;1004;15;1019
44;Grand Est;68;4;14;297;Saint-Louis;21646;281;21927
44;Grand Est;68;1;09;299;Saint-Ulrich;308;0;308
44;Grand Est;68;2;15;294;Sainte-Croix-aux-Mines;1909;31;1940
44;Grand Est;68;2;05;295;Sainte-Croix-en-Plaine;3003;65;3068
44;Grand Est;68;2;15;298;Sainte-Marie-aux-Mines;5072;128;5200
44;Grand Est;68;4;13;300;Sausheim;5489;125;5614
44;Grand Est;68;4;02;301;Schlierbach;1260;25;1285
44;Grand Est;68;6;03;302;Schweighouse-Thann;759;31;790
44;Grand Est;68;1;01;303;Schwoben;229;7;236
44;Grand Est;68;6;09;304;Sentheim;1558;39;1597
44;Grand Est;68;1;09;305;Seppois-le-Bas;1384;27;1411
44;Grand Est;68;1;09;306;Seppois-le-Haut;512;8;520
44;Grand Est;68;6;09;307;Sewen;499;10;509
44;Grand Est;68;6;09;308;Sickert;327;12;339
44;Grand Est;68;4;02;309;Sierentz;3750;74;3824
44;Grand Est;68;2;16;311;Sondernach;608;12;620
44;Grand Est;68;1;01;312;Sondersdorf;326;6;332
44;Grand Est;68;6;09;313;Soppe-le-Bas;769;11;780
44;Grand Est;68;6;07;315;Soultz-Haut-Rhin;7058;134;7192
44;Grand Est;68;2;16;316;Soultzbach-les-Bains;730;22;752
44;Grand Est;68;2;16;317;Soultzeren;1113;19;1132
44;Grand Est;68;6;16;318;Soultzmatt;2402;52;2454
44;Grand Est;68;1;01;320;Spechbach;1352;46;1398
44;Grand Est;68;4;17;321;Staffelfelden;3945;60;4005
44;Grand Est;68;6;03;322;Steinbach;1355;30;1385
44;Grand Est;68;4;02;323;Steinbrunn-le-Bas;791;24;815
44;Grand Est;68;4;02;324;Steinbrunn-le-Haut;604;17;621
44;Grand Est;68;1;01;325;Steinsoultz;760;9;769
44;Grand Est;68;1;09;326;Sternenberg;154;5;159
44;Grand Est;68;4;02;327;Stetten;353;7;360
44;Grand Est;68;6;03;328;Storckensohn;204;1;205
44;Grand Est;68;2;16;329;Stosswihr;1356;34;1390
44;Grand Est;68;1;09;330;Strueth;337;8;345
44;Grand Est;68;2;05;331;Sundhoffen;1930;57;1987
44;Grand Est;68;1;01;332;Tagolsheim;939;13;952
44;Grand Est;68;1;01;333;Tagsdorf;294;6;300
44;Grand Est;68;6;03;334;Thann;7721;148;7869
44;Grand Est;68;2;15;335;Thannenkirch;465;6;471
44;Grand Est;68;1;09;336;Traubach-le-Bas;465;8;473
44;Grand Est;68;1;09;337;Traubach-le-Haut;601;11;612
44;Grand Est;68;2;16;338;Turckheim;3814;80;3894
44;Grand Est;68;1;09;340;Ueberstrass;373;15;388
44;Grand Est;68;4;02;341;Uffheim;904;29;933
44;Grand Est;68;6;03;342;Uffholtz;1747;44;1791
44;Grand Est;68;4;17;343;Ungersheim;2379;34;2413
44;Grand Est;68;6;03;344;Urbès;437;10;447
44;Grand Est;68;2;06;345;Urschenheim;748;27;775
44;Grand Est;68;1;09;192;Valdieu-Lutran;424;7;431
44;Grand Est;68;1;01;347;Vieux-Ferrette;689;22;711
44;Grand Est;68;6;03;348;Vieux-Thann;2825;51;2876
44;Grand Est;68;4;14;349;Village-Neuf;4356;93;4449
44;Grand Est;68;2;06;351;Vogelgrun;639;13;652
44;Grand Est;68;2;06;352;Volgelsheim;2689;24;2713
44;Grand Est;68;2;16;350;Vœgtlinshoffen;482;15;497
44;Grand Est;68;4;02;353;Wahlbach;494;17;511
44;Grand Est;68;2;16;354;Walbach;910;37;947
44;Grand Est;68;1;01;355;Waldighofen;1538;28;1566
44;Grand Est;68;1;01;356;Walheim;884;21;905
44;Grand Est;68;4;02;357;Waltenheim;524;17;541
44;Grand Est;68;2;16;358;Wasserbourg;467;11;478
44;Grand Est;68;6;03;359;Wattwiller;1649;59;1708
44;Grand Est;68;2;06;360;Weckolsheim;658;4;662
44;Grand Est;68;6;09;361;Wegscheid;321;5;326
44;Grand Est;68;4;14;362;Wentzwiller;768;15;783
44;Grand Est;68;1;01;363;Werentzhouse;566;11;577
44;Grand Est;68;6;16;364;Westhalten;986;19;1005
44;Grand Est;68;2;16;365;Wettolsheim;1739;64;1803
44;Grand Est;68;2;05;366;Wickerschwihr;721;30;751
44;Grand Est;68;2;06;367;Widensolen;1179;21;1200
44;Grand Est;68;2;16;368;Wihr-au-Val;1253;36;1289
44;Grand Est;68;6;03;370;Wildenstein;174;2;176
44;Grand Est;68;1;01;371;Willer;313;9;322
44;Grand Est;68;6;03;372;Willer-sur-Thur;1802;39;1841
44;Grand Est;68;1;01;373;Winkel;302;12;314
44;Grand Est;68;2;16;374;Wintzenheim;7642;404;8046
44;Grand Est;68;4;17;375;Wittelsheim;10341;138;10479
44;Grand Est;68;4;17;376;Wittenheim;14541;111;14652
44;Grand Est;68;1;01;377;Wittersdorf;799;19;818
44;Grand Est;68;1;09;378;Wolfersdorf;375;4;379
44;Grand Est;68;2;06;379;Wolfgantzen;1045;20;1065
44;Grand Est;68;1;01;380;Wolschwiller;445;11;456
44;Grand Est;68;6;07;381;Wuenheim;800;16;816
44;Grand Est;68;4;02;382;Zaessingue;383;4;387
44;Grand Est;68;2;15;383;Zellenberg;321;8;329
44;Grand Est;68;4;02;384;Zillisheim;2555;62;2617
44;Grand Est;68;2;16;385;Zimmerbach;840;25;865
44;Grand Est;68;4;02;386;Zimmersheim;1028;22;1050
84;Auvergne-Rhône-Alpes;69;2;10;001;Affoux;379;3;382
84;Auvergne-Rhône-Alpes;69;2;11;002;Aigueperse;246;1;247
84;Auvergne-Rhône-Alpes;69;1;00;003;Albigny-sur-Saône;2911;41;2952
84;Auvergne-Rhône-Alpes;69;2;04;004;Alix;768;24;792
84;Auvergne-Rhône-Alpes;69;2;01;005;Ambérieux;586;9;595
84;Auvergne-Rhône-Alpes;69;2;11;006;Amplepuis;4929;119;5048
84;Auvergne-Rhône-Alpes;69;1;08;007;Ampuis;2715;44;2759
84;Auvergne-Rhône-Alpes;69;2;10;008;Ancy;653;15;668
84;Auvergne-Rhône-Alpes;69;2;01;009;Anse;7443;162;7605
84;Auvergne-Rhône-Alpes;69;2;02;010;L' Arbresle;6418;196;6614
84;Auvergne-Rhône-Alpes;69;2;03;012;Les Ardillats;616;15;631
84;Auvergne-Rhône-Alpes;69;2;07;013;Arnas;3847;81;3928
84;Auvergne-Rhône-Alpes;69;1;12;014;Aveize;1126;22;1148
84;Auvergne-Rhône-Alpes;69;2;11;016;Azolette;121;0;121
84;Auvergne-Rhône-Alpes;69;2;04;017;Bagnols;739;21;760
84;Auvergne-Rhône-Alpes;69;2;03;018;Beaujeu;2155;32;2187
84;Auvergne-Rhône-Alpes;69;1;  ;179;Beauvallon ;4061;74;4135
84;Auvergne-Rhône-Alpes;69;2;03;019;Belleville-en-Beaujolais ;13057;273;13330
84;Auvergne-Rhône-Alpes;69;2;04;020;Belmont-d'Azergues;661;18;679
84;Auvergne-Rhône-Alpes;69;2;02;021;Bessenay;2317;80;2397
84;Auvergne-Rhône-Alpes;69;2;02;022;Bibost;566;16;582
84;Auvergne-Rhône-Alpes;69;2;07;023;Blacé;1630;25;1655
84;Auvergne-Rhône-Alpes;69;2;04;026;Le Breuil;537;10;547
84;Auvergne-Rhône-Alpes;69;1;05;027;Brignais;11697;170;11867
84;Auvergne-Rhône-Alpes;69;1;05;028;Brindas;6315;108;6423
84;Auvergne-Rhône-Alpes;69;1;00;029;Bron;42216;409;42625
84;Auvergne-Rhône-Alpes;69;1;02;030;Brullioles;813;15;828
84;Auvergne-Rhône-Alpes;69;1;02;031;Brussieu;1377;98;1475
84;Auvergne-Rhône-Alpes;69;2;04;032;Bully;1990;36;2026
84;Auvergne-Rhône-Alpes;69;1;00;033;Cailloux-sur-Fontaines;2803;72;2875
84;Auvergne-Rhône-Alpes;69;1;00;034;Caluire-et-Cuire;42847;622;43469
84;Auvergne-Rhône-Alpes;69;2;03;035;Cenves;383;7;390
84;Auvergne-Rhône-Alpes;69;2;03;036;Cercié;1133;22;1155
84;Auvergne-Rhône-Alpes;69;1;08;228;Chabanière ;4212;93;4305
84;Auvergne-Rhône-Alpes;69;2;10;037;Chambost-Allières;836;12;848
84;Auvergne-Rhône-Alpes;69;1;02;038;Chambost-Longessaigne;938;25;963
84;Auvergne-Rhône-Alpes;69;2;04;039;Chamelet;688;10;698
84;Auvergne-Rhône-Alpes;69;1;00;040;Champagne-au-Mont-d'Or;5570;47;5617
84;Auvergne-Rhône-Alpes;69;1;12;042;La Chapelle-sur-Coise;568;15;583
84;Auvergne-Rhône-Alpes;69;1;09;270;Chaponnay;4336;66;4402
84;Auvergne-Rhône-Alpes;69;1;05;043;Chaponost;8790;172;8962
84;Auvergne-Rhône-Alpes;69;1;00;044;Charbonnières-les-Bains;5119;145;5264
84;Auvergne-Rhône-Alpes;69;2;03;045;Charentay;1243;67;1310
84;Auvergne-Rhône-Alpes;69;1;00;046;Charly;4552;139;4691
84;Auvergne-Rhône-Alpes;69;2;04;047;Charnay;1054;21;1075
84;Auvergne-Rhône-Alpes;69;2;01;049;Chasselay;2793;65;2858
84;Auvergne-Rhône-Alpes;69;1;00;271;Chassieu;10498;151;10649
84;Auvergne-Rhône-Alpes;69;2;04;050;Châtillon;2117;42;2159
84;Auvergne-Rhône-Alpes;69;1;08;051;Chaussan;1139;32;1171
84;Auvergne-Rhône-Alpes;69;2;01;052;Chazay-d'Azergues;4131;114;4245
84;Auvergne-Rhône-Alpes;69;2;03;053;Chénas;544;13;557
84;Auvergne-Rhône-Alpes;69;2;11;054;Chénelette;332;2;334
84;Auvergne-Rhône-Alpes;69;2;01;055;Les Chères;1448;27;1475
84;Auvergne-Rhône-Alpes;69;2;04;056;Chessy;2085;51;2136
84;Auvergne-Rhône-Alpes;69;2;02;057;Chevinay;570;13;583
84;Auvergne-Rhône-Alpes;69;2;03;058;Chiroubles;387;9;396
84;Auvergne-Rhône-Alpes;69;2;01;059;Civrieux-d'Azergues;1533;27;1560
84;Auvergne-Rhône-Alpes;69;2;11;060;Claveisolles;605;89;694
84;Auvergne-Rhône-Alpes;69;2;04;061;Cogny;1178;33;1211
84;Auvergne-Rhône-Alpes;69;1;12;062;Coise;774;23;797
84;Auvergne-Rhône-Alpes;69;1;00;063;Collonges-au-Mont-d'Or;4181;83;4264
84;Auvergne-Rhône-Alpes;69;1;06;299;Colombier-Saugnieu;2657;42;2699
84;Auvergne-Rhône-Alpes;69;1;09;272;Communay;4219;84;4303
84;Auvergne-Rhône-Alpes;69;1;08;064;Condrieu;3927;82;4009
84;Auvergne-Rhône-Alpes;69;1;00;273;Corbas;11108;72;11180
84;Auvergne-Rhône-Alpes;69;2;03;065;Corcelles-en-Beaujolais;954;15;969
84;Auvergne-Rhône-Alpes;69;2;11;066;Cours;4379;80;4459
84;Auvergne-Rhône-Alpes;69;2;02;067;Courzieu;1142;21;1163
84;Auvergne-Rhône-Alpes;69;1;00;068;Couzon-au-Mont-d'Or;2472;48;2520
84;Auvergne-Rhône-Alpes;69;1;00;069;Craponne;11125;178;11303
84;Auvergne-Rhône-Alpes;69;2;11;070;Cublize;1258;28;1286
84;Auvergne-Rhône-Alpes;69;1;00;071;Curis-au-Mont-d'Or;1175;27;1202
84;Auvergne-Rhône-Alpes;69;1;00;072;Dardilly;8675;590;9265
84;Auvergne-Rhône-Alpes;69;1;00;275;Décines-Charpieu;28604;136;28740
84;Auvergne-Rhône-Alpes;69;2;07;074;Denicé;1531;39;1570
84;Auvergne-Rhône-Alpes;69;2;88;135;Deux-Grosnes;1909;53;1962
84;Auvergne-Rhône-Alpes;69;2;10;075;Dième;189;2;191
84;Auvergne-Rhône-Alpes;69;2;01;076;Dommartin;2573;100;2673
84;Auvergne-Rhône-Alpes;69;2;03;077;Dracé;954;12;966
84;Auvergne-Rhône-Alpes;69;1;12;078;Duerne;830;16;846
84;Auvergne-Rhône-Alpes;69;1;08;080;Échalas;1841;16;1857
84;Auvergne-Rhône-Alpes;69;1;00;081;Écully;18587;390;18977
84;Auvergne-Rhône-Alpes;69;2;03;082;Émeringes;268;7;275
84;Auvergne-Rhône-Alpes;69;2;02;083;Éveux;1169;40;1209
84;Auvergne-Rhône-Alpes;69;1;00;276;Feyzin;9879;52;9931
84;Auvergne-Rhône-Alpes;69;2;03;084;Fleurie;1275;22;1297
84;Auvergne-Rhône-Alpes;69;1;00;085;Fleurieu-sur-Saône;1464;41;1505
84;Auvergne-Rhône-Alpes;69;2;02;086;Fleurieux-sur-l'Arbresle;2312;64;2376
84;Auvergne-Rhône-Alpes;69;1;00;087;Fontaines-Saint-Martin;3053;73;3126
84;Auvergne-Rhône-Alpes;69;1;00;088;Fontaines-sur-Saône;7068;97;7165
84;Auvergne-Rhône-Alpes;69;1;00;089;Francheville;14656;262;14918
84;Auvergne-Rhône-Alpes;69;2;04;090;Frontenas;814;24;838
84;Auvergne-Rhône-Alpes;69;1;06;277;Genas;13022;213;13235
84;Auvergne-Rhône-Alpes;69;1;00;278;Genay;5490;105;5595
84;Auvergne-Rhône-Alpes;69;1;00;091;Givors;20121;104;20225
84;Auvergne-Rhône-Alpes;69;2;07;092;Gleizé;7470;345;7815
84;Auvergne-Rhône-Alpes;69;2;10;093;Grandris;1184;19;1203
84;Auvergne-Rhône-Alpes;69;1;05;094;Grézieu-la-Varenne;5838;111;5949
84;Auvergne-Rhône-Alpes;69;1;12;095;Grézieu-le-Marché;821;17;838
84;Auvergne-Rhône-Alpes;69;1;00;096;Grigny;9675;75;9750
84;Auvergne-Rhône-Alpes;69;1;08;097;Les Haies;777;20;797
84;Auvergne-Rhône-Alpes;69;1;02;098;Les Halles;505;7;512
84;Auvergne-Rhône-Alpes;69;1;02;099;Haute-Rivoire;1442;28;1470
84;Auvergne-Rhône-Alpes;69;1;00;100;Irigny;8695;121;8816
84;Auvergne-Rhône-Alpes;69;1;00;279;Jonage;5989;75;6064
84;Auvergne-Rhône-Alpes;69;1;06;280;Jons;1508;13;1521
84;Auvergne-Rhône-Alpes;69;2;10;102;Joux;713;11;724
84;Auvergne-Rhône-Alpes;69;2;03;103;Juliénas;906;23;929
84;Auvergne-Rhône-Alpes;69;2;03;104;Jullié;433;9;442
84;Auvergne-Rhône-Alpes;69;2;07;105;Lacenas;997;36;1033
84;Auvergne-Rhône-Alpes;69;2;01;106;Lachassagne;1149;23;1172
84;Auvergne-Rhône-Alpes;69;2;10;107;Lamure-sur-Azergues;1049;66;1115
84;Auvergne-Rhône-Alpes;69;2;03;108;Lancié;1041;21;1062
84;Auvergne-Rhône-Alpes;69;2;03;109;Lantignié;870;28;898
84;Auvergne-Rhône-Alpes;69;1;12;110;Larajasse;1848;30;1878
84;Auvergne-Rhône-Alpes;69;2;04;111;Légny;670;17;687
84;Auvergne-Rhône-Alpes;69;2;01;112;Lentilly;6137;147;6284
84;Auvergne-Rhône-Alpes;69;2;04;113;Létra;911;27;938
84;Auvergne-Rhône-Alpes;69;2;07;115;Limas;4843;98;4941
84;Auvergne-Rhône-Alpes;69;1;00;116;Limonest;3648;102;3750
84;Auvergne-Rhône-Alpes;69;1;00;117;Lissieu;3128;75;3203
84;Auvergne-Rhône-Alpes;69;1;08;118;Loire-sur-Rhône;2605;32;2637
84;Auvergne-Rhône-Alpes;69;1;08;119;Longes;975;8;983
84;Auvergne-Rhône-Alpes;69;1;02;120;Longessaigne;594;16;610
84;Auvergne-Rhône-Alpes;69;2;01;121;Lozanne;2737;45;2782
84;Auvergne-Rhône-Alpes;69;2;01;122;Lucenay;1864;51;1915
84;Auvergne-Rhône-Alpes;69;1;00;381;Lyon 1er Arrondissement;29523;783;30306
84;Auvergne-Rhône-Alpes;69;1;00;382;Lyon 2e Arrondissement;30733;390;31123
84;Auvergne-Rhône-Alpes;69;1;00;383;Lyon 3e Arrondissement;102238;1008;103246
84;Auvergne-Rhône-Alpes;69;1;00;384;Lyon 4e Arrondissement;35878;403;36281
84;Auvergne-Rhône-Alpes;69;1;00;385;Lyon 5e Arrondissement;49755;1089;50844
84;Auvergne-Rhône-Alpes;69;1;00;386;Lyon 6e Arrondissement;52411;871;53282
84;Auvergne-Rhône-Alpes;69;1;00;387;Lyon 7e Arrondissement;81825;505;82330
84;Auvergne-Rhône-Alpes;69;1;00;388;Lyon 8e Arrondissement;85170;1021;86191
84;Auvergne-Rhône-Alpes;69;1;00;389;Lyon 9e Arrondissement;51102;531;51633
84;Auvergne-Rhône-Alpes;69;2;03;124;Marchampt;463;9;472
84;Auvergne-Rhône-Alpes;69;2;01;125;Marcilly-d'Azergues;890;15;905
84;Auvergne-Rhône-Alpes;69;2;01;126;Marcy;755;28;783
84;Auvergne-Rhône-Alpes;69;1;00;127;Marcy-l'Étoile;3603;64;3667
84;Auvergne-Rhône-Alpes;69;1;09;281;Marennes;1831;22;1853
84;Auvergne-Rhône-Alpes;69;2;11;130;Meaux-la-Montagne;234;3;237
84;Auvergne-Rhône-Alpes;69;1;05;131;Messimy;3392;85;3477
84;Auvergne-Rhône-Alpes;69;1;12;132;Meys;849;15;864
84;Auvergne-Rhône-Alpes;69;1;00;282;Meyzieu;34151;297;34448
84;Auvergne-Rhône-Alpes;69;1;09;133;Millery;4324;80;4404
84;Auvergne-Rhône-Alpes;69;1;00;283;Mions;13665;145;13810
84;Auvergne-Rhône-Alpes;69;2;04;134;Moiré;218;10;228
84;Auvergne-Rhône-Alpes;69;1;09;136;Montagny;3056;54;3110
84;Auvergne-Rhône-Alpes;69;1;00;284;Montanay;3186;115;3301
84;Auvergne-Rhône-Alpes;69;2;07;137;Montmelas-Saint-Sorlin;507;7;514
84;Auvergne-Rhône-Alpes;69;1;02;138;Montromant;452;9;461
84;Auvergne-Rhône-Alpes;69;1;02;139;Montrottier;1379;77;1456
84;Auvergne-Rhône-Alpes;69;2;01;140;Morancé;2005;46;2051
84;Auvergne-Rhône-Alpes;69;1;08;141;Mornant;6050;169;6219
84;Auvergne-Rhône-Alpes;69;1;00;142;La Mulatière;6431;73;6504
84;Auvergne-Rhône-Alpes;69;1;00;143;Neuville-sur-Saône;7560;88;7648
84;Auvergne-Rhône-Alpes;69;2;03;145;Odenas;924;25;949
84;Auvergne-Rhône-Alpes;69;1;09;148;Orliénas;2448;68;2516
84;Auvergne-Rhône-Alpes;69;1;00;149;Oullins;26583;293;26876
84;Auvergne-Rhône-Alpes;69;2;07;151;Le Perréon;1555;32;1587
84;Auvergne-Rhône-Alpes;69;1;00;152;Pierre-Bénite;10461;61;10522
84;Auvergne-Rhône-Alpes;69;1;00;153;Poleymieux-au-Mont-d'Or;1355;28;1383
84;Auvergne-Rhône-Alpes;69;1;12;154;Pollionnay;2761;51;2812
84;Auvergne-Rhône-Alpes;69;1;12;155;Pomeys;1141;31;1172
84;Auvergne-Rhône-Alpes;69;2;01;156;Pommiers;2664;81;2745
84;Auvergne-Rhône-Alpes;69;2;04;159;Porte des Pierres Dorées ;3841;91;3932
84;Auvergne-Rhône-Alpes;69;2;11;160;Poule-les-Écharmeaux;1084;19;1103
84;Auvergne-Rhône-Alpes;69;2;11;161;Propières;477;21;498
84;Auvergne-Rhône-Alpes;69;1;06;285;Pusignan;4110;37;4147
84;Auvergne-Rhône-Alpes;69;2;03;162;Quincié-en-Beaujolais;1329;34;1363
84;Auvergne-Rhône-Alpes;69;1;00;163;Quincieux;3480;50;3530
84;Auvergne-Rhône-Alpes;69;2;11;164;Ranchal;321;10;331
84;Auvergne-Rhône-Alpes;69;2;03;165;Régnié-Durette;1124;25;1149
84;Auvergne-Rhône-Alpes;69;1;00;286;Rillieux-la-Pape;30410;373;30783
84;Auvergne-Rhône-Alpes;69;1;08;166;Riverie;324;2;326
84;Auvergne-Rhône-Alpes;69;2;07;167;Rivolet;585;11;596
84;Auvergne-Rhône-Alpes;69;1;00;168;Rochetaillée-sur-Saône;1532;41;1573
84;Auvergne-Rhône-Alpes;69;2;11;169;Ronno;641;23;664
84;Auvergne-Rhône-Alpes;69;1;12;170;Rontalon;1153;18;1171
84;Auvergne-Rhône-Alpes;69;2;02;171;Sain-Bel;2362;26;2388
84;Auvergne-Rhône-Alpes;69;1;12;180;Saint-André-la-Côte;286;9;295
84;Auvergne-Rhône-Alpes;69;2;10;181;Saint-Appolinaire;219;1;220
84;Auvergne-Rhône-Alpes;69;1;06;287;Saint-Bonnet-de-Mure;6875;107;6982
84;Auvergne-Rhône-Alpes;69;2;11;182;Saint-Bonnet-des-Bruyères;357;2;359
84;Auvergne-Rhône-Alpes;69;2;11;183;Saint-Bonnet-le-Troncy;317;2;319
84;Auvergne-Rhône-Alpes;69;2;11;186;Saint-Clément-de-Vers;220;4;224
84;Auvergne-Rhône-Alpes;69;1;02;187;Saint-Clément-les-Places;643;21;664
84;Auvergne-Rhône-Alpes;69;2;10;188;Saint-Clément-sur-Valsonne;909;9;918
84;Auvergne-Rhône-Alpes;69;1;00;191;Saint-Cyr-au-Mont-d'Or;5721;141;5862
84;Auvergne-Rhône-Alpes;69;2;07;192;Saint-Cyr-le-Chatoux;149;7;156
84;Auvergne-Rhône-Alpes;69;1;08;193;Saint-Cyr-sur-le-Rhône;1287;32;1319
84;Auvergne-Rhône-Alpes;69;1;00;194;Saint-Didier-au-Mont-d'Or;6951;158;7109
84;Auvergne-Rhône-Alpes;69;2;03;196;Saint-Didier-sur-Beaujeu;617;11;628
84;Auvergne-Rhône-Alpes;69;2;07;197;Saint-Étienne-des-Oullières;2209;48;2257
84;Auvergne-Rhône-Alpes;69;2;03;198;Saint-Étienne-la-Varenne;749;11;760
84;Auvergne-Rhône-Alpes;69;1;00;199;Saint-Fons;19254;61;19315
84;Auvergne-Rhône-Alpes;69;2;10;200;Saint-Forgeux;1473;31;1504
84;Auvergne-Rhône-Alpes;69;1;02;203;Saint-Genis-l'Argentière;1030;17;1047
84;Auvergne-Rhône-Alpes;69;1;00;204;Saint-Genis-Laval;21019;479;21498
84;Auvergne-Rhône-Alpes;69;1;00;205;Saint-Genis-les-Ollières;5036;90;5126
84;Auvergne-Rhône-Alpes;69;2;07;206;Saint-Georges-de-Reneins;4394;92;4486
84;Auvergne-Rhône-Alpes;69;1;00;207;Saint-Germain-au-Mont-d'Or;3043;48;3091
84;Auvergne-Rhône-Alpes;69;2;04;208;Saint-Germain-Nuelles;2264;60;2324
84;Auvergne-Rhône-Alpes;69;2;11;209;Saint-Igny-de-Vers;577;16;593
84;Auvergne-Rhône-Alpes;69;2;04;212;Saint-Jean-des-Vignes;455;10;465
84;Auvergne-Rhône-Alpes;69;2;11;214;Saint-Jean-la-Bussière;1209;26;1235
84;Auvergne-Rhône-Alpes;69;2;07;215;Saint-Julien;867;20;887
84;Auvergne-Rhône-Alpes;69;2;02;216;Saint-Julien-sur-Bibost;565;11;576
84;Auvergne-Rhône-Alpes;69;2;10;217;Saint-Just-d'Avray;747;22;769
84;Auvergne-Rhône-Alpes;69;2;03;218;Saint-Lager;1049;17;1066
84;Auvergne-Rhône-Alpes;69;1;08;219;Saint-Laurent-d'Agny;2137;63;2200
84;Auvergne-Rhône-Alpes;69;1;02;220;Saint-Laurent-de-Chamousset;1817;113;1930
84;Auvergne-Rhône-Alpes;69;1;06;288;Saint-Laurent-de-Mure;5417;66;5483
84;Auvergne-Rhône-Alpes;69;2;10;225;Saint-Marcel-l'Éclairé;538;14;552
84;Auvergne-Rhône-Alpes;69;1;12;227;Saint-Martin-en-Haut;3885;189;4074
84;Auvergne-Rhône-Alpes;69;2;11;229;Saint-Nizier-d'Azergues;797;14;811
84;Auvergne-Rhône-Alpes;69;1;06;289;Saint-Pierre-de-Chandieu;4541;82;4623
84;Auvergne-Rhône-Alpes;69;2;02;231;Saint-Pierre-la-Palud;2615;61;2676
84;Auvergne-Rhône-Alpes;69;1;00;290;Saint-Priest;46510;274;46784
84;Auvergne-Rhône-Alpes;69;1;00;233;Saint-Romain-au-Mont-d'Or;1221;51;1272
84;Auvergne-Rhône-Alpes;69;2;10;234;Saint-Romain-de-Popey;1567;72;1639
84;Auvergne-Rhône-Alpes;69;1;08;235;Saint-Romain-en-Gal;1934;106;2040
84;Auvergne-Rhône-Alpes;69;1;08;236;Saint-Romain-en-Gier;583;7;590
84;Auvergne-Rhône-Alpes;69;1;09;291;Saint-Symphorien-d'Ozon;5780;56;5836
84;Auvergne-Rhône-Alpes;69;1;12;238;Saint-Symphorien-sur-Coise;3687;95;3782
84;Auvergne-Rhône-Alpes;69;2;04;239;Saint-Vérand;1201;24;1225
84;Auvergne-Rhône-Alpes;69;2;11;240;Saint-Vincent-de-Reins;623;6;629
84;Auvergne-Rhône-Alpes;69;1;12;184;Sainte-Catherine;986;21;1007
84;Auvergne-Rhône-Alpes;69;1;08;189;Sainte-Colombe;1886;29;1915
84;Auvergne-Rhône-Alpes;69;1;12;190;Sainte-Consorce;1956;85;2041
84;Auvergne-Rhône-Alpes;69;1;02;201;Sainte-Foy-l'Argentière;1284;25;1309
84;Auvergne-Rhône-Alpes;69;1;00;202;Sainte-Foy-lès-Lyon;22141;394;22535
84;Auvergne-Rhône-Alpes;69;2;04;230;Sainte-Paule;320;6;326
84;Auvergne-Rhône-Alpes;69;2;07;172;Salles-Arbuissonnas-en-Beaujolais;773;27;800
84;Auvergne-Rhône-Alpes;69;2;10;173;Sarcey;1009;25;1034
84;Auvergne-Rhône-Alpes;69;1;00;292;Sathonay-Camp;6267;61;6328
84;Auvergne-Rhône-Alpes;69;1;00;293;Sathonay-Village;2374;48;2422
84;Auvergne-Rhône-Alpes;69;2;10;174;Les Sauvages;613;11;624
84;Auvergne-Rhône-Alpes;69;2;02;175;Savigny;2003;56;2059
84;Auvergne-Rhône-Alpes;69;1;09;294;Sérézin-du-Rhône;2703;36;2739
84;Auvergne-Rhône-Alpes;69;1;09;295;Simandres;1799;9;1808
84;Auvergne-Rhône-Alpes;69;1;00;296;Solaize;2939;32;2971
84;Auvergne-Rhône-Alpes;69;1;08;176;Soucieu-en-Jarrest;4557;84;4641
84;Auvergne-Rhône-Alpes;69;2;02;177;Sourcieux-les-Mines;2045;46;2091
84;Auvergne-Rhône-Alpes;69;1;02;178;Souzy;816;20;836
84;Auvergne-Rhône-Alpes;69;1;09;241;Taluyers;2548;60;2608
84;Auvergne-Rhône-Alpes;69;2;03;242;Taponas;952;14;966
84;Auvergne-Rhône-Alpes;69;2;10;243;Tarare;10587;274;10861
84;Auvergne-Rhône-Alpes;69;1;00;244;Tassin-la-Demi-Lune;22403;356;22759
84;Auvergne-Rhône-Alpes;69;2;04;245;Ternand;697;25;722
84;Auvergne-Rhône-Alpes;69;1;09;297;Ternay;5514;73;5587
84;Auvergne-Rhône-Alpes;69;2;04;246;Theizé;1274;35;1309
84;Auvergne-Rhône-Alpes;69;2;11;248;Thizy-les-Bourgs;6027;126;6153
84;Auvergne-Rhône-Alpes;69;1;12;249;Thurins;3068;63;3131
84;Auvergne-Rhône-Alpes;69;1;00;250;La Tour-de-Salvagny;4040;97;4137
84;Auvergne-Rhône-Alpes;69;1;06;298;Toussieu;3129;27;3156
84;Auvergne-Rhône-Alpes;69;1;08;252;Trèves;740;9;749
84;Auvergne-Rhône-Alpes;69;1;08;253;Tupin-et-Semons;617;10;627
84;Auvergne-Rhône-Alpes;69;2;04;024;Val d'Oingt;4088;103;4191
84;Auvergne-Rhône-Alpes;69;2;10;254;Valsonne;970;10;980
84;Auvergne-Rhône-Alpes;69;1;12;255;Vaugneray;5896;108;6004
84;Auvergne-Rhône-Alpes;69;1;00;256;Vaulx-en-Velin;50823;222;51045
84;Auvergne-Rhône-Alpes;69;2;07;257;Vaux-en-Beaujolais;1088;19;1107
84;Auvergne-Rhône-Alpes;69;2;03;258;Vauxrenard;322;7;329
84;Auvergne-Rhône-Alpes;69;1;00;259;Vénissieux;67129;268;67397
84;Auvergne-Rhône-Alpes;69;1;00;260;Vernaison;5001;56;5057
84;Auvergne-Rhône-Alpes;69;2;03;261;Vernay;104;1;105
84;Auvergne-Rhône-Alpes;69;2;04;265;Ville-sur-Jarnioux;804;33;837
84;Auvergne-Rhône-Alpes;69;1;02;263;Villechenève;879;19;898
84;Auvergne-Rhône-Alpes;69;2;13;264;Villefranche-sur-Saône;36288;423;36711
84;Auvergne-Rhône-Alpes;69;1;00;266;Villeurbanne;150659;1068;151727
84;Auvergne-Rhône-Alpes;69;2;03;267;Villié-Morgon;2124;117;2241
84;Auvergne-Rhône-Alpes;69;2;10;157;Vindry-sur-Turdine ;5234;87;5321
84;Auvergne-Rhône-Alpes;69;1;05;268;Vourles;3400;92;3492
84;Auvergne-Rhône-Alpes;69;1;12;269;Yzeron;1005;24;1029
27;Bourgogne-Franche-Comté;70;1;13;001;Abelcourt;355;4;359
27;Bourgogne-Franche-Comté;70;2;05;002;Aboncourt-Gesincourt;210;7;217
27;Bourgogne-Franche-Comté;70;2;01;003;Achey;70;2;72
27;Bourgogne-Franche-Comté;70;1;06;004;Adelans-et-le-Val-de-Bithaine;304;2;306
27;Bourgogne-Franche-Comté;70;1;17;005;Aillevans;141;2;143
27;Bourgogne-Franche-Comté;70;1;13;006;Aillevillers-et-Lyaumont;1520;104;1624
27;Bourgogne-Franche-Comté;70;1;08;007;Ailloncourt;303;6;309
27;Bourgogne-Franche-Comté;70;1;13;008;Ainvelle;148;2;150
27;Bourgogne-Franche-Comté;70;2;05;009;Aisey-et-Richecourt;104;1;105
27;Bourgogne-Franche-Comté;70;1;05;010;Alaincourt;108;1;109
27;Bourgogne-Franche-Comté;70;1;10;011;Amage;328;4;332
27;Bourgogne-Franche-Comté;70;2;11;012;Amance;663;11;674
27;Bourgogne-Franche-Comté;70;1;05;013;Ambiévillers;70;0;70
27;Bourgogne-Franche-Comté;70;1;07;014;Amblans-et-Velotte;400;6;406
27;Bourgogne-Franche-Comté;70;2;11;015;Amoncourt;279;6;285
27;Bourgogne-Franche-Comté;70;1;10;016;Amont-et-Effreney;162;2;164
27;Bourgogne-Franche-Comté;70;1;11;017;Anchenoncourt-et-Chazel;241;2;243
27;Bourgogne-Franche-Comté;70;2;02;018;Ancier;506;4;510
27;Bourgogne-Franche-Comté;70;2;15;019;Andelarre;133;4;137
27;Bourgogne-Franche-Comté;70;2;15;020;Andelarrot;240;2;242
27;Bourgogne-Franche-Comté;70;1;07;021;Andornay;195;5;200
27;Bourgogne-Franche-Comté;70;2;02;022;Angirey;144;3;147
27;Bourgogne-Franche-Comté;70;1;11;023;Anjeux;145;3;148
27;Bourgogne-Franche-Comté;70;2;02;024;Apremont;453;14;467
27;Bourgogne-Franche-Comté;70;2;05;025;Arbecey;251;4;255
27;Bourgogne-Franche-Comté;70;2;02;026;Arc-lès-Gray;2535;26;2561
27;Bourgogne-Franche-Comté;70;2;01;027;Argillières;73;1;74
27;Bourgogne-Franche-Comté;70;2;14;028;Aroz;145;3;148
27;Bourgogne-Franche-Comté;70;1;07;029;Arpenans;242;2;244
27;Bourgogne-Franche-Comté;70;2;09;030;Arsans;48;1;49
27;Bourgogne-Franche-Comté;70;1;17;031;Athesans-Étroitefontaine;649;17;666
27;Bourgogne-Franche-Comté;70;2;01;032;Attricourt;44;0;44
27;Bourgogne-Franche-Comté;70;2;05;035;Augicourt;178;4;182
27;Bourgogne-Franche-Comté;70;2;12;036;Aulx-lès-Cromary;163;2;165
27;Bourgogne-Franche-Comté;70;2;01;037;Autet;260;23;283
27;Bourgogne-Franche-Comté;70;2;12;038;Authoison;317;9;326
27;Bourgogne-Franche-Comté;70;2;09;039;Autoreille;345;4;349
27;Bourgogne-Franche-Comté;70;1;17;042;Autrey-le-Vay;97;1;98
27;Bourgogne-Franche-Comté;70;2;17;040;Autrey-lès-Cerre;236;3;239
27;Bourgogne-Franche-Comté;70;2;01;041;Autrey-lès-Gray;375;9;384
27;Bourgogne-Franche-Comté;70;2;01;043;Auvet-et-la-Chapelotte;237;3;240
27;Bourgogne-Franche-Comté;70;2;11;044;Auxon;414;13;427
27;Bourgogne-Franche-Comté;70;2;09;045;Avrigney-Virey;415;7;422
27;Bourgogne-Franche-Comté;70;1;07;046;Les Aynans;358;6;364
27;Bourgogne-Franche-Comté;70;2;14;047;Baignes;106;2;108
27;Bourgogne-Franche-Comté;70;2;09;048;Bard-lès-Pesmes;142;3;145
27;Bourgogne-Franche-Comté;70;2;05;049;Barges;95;2;97
27;Bourgogne-Franche-Comté;70;2;12;050;La Barre;99;0;99
27;Bourgogne-Franche-Comté;70;1;05;051;La Basse-Vaivre;36;0;36
27;Bourgogne-Franche-Comté;70;1;11;052;Bassigney;122;3;125
27;Bourgogne-Franche-Comté;70;2;14;053;Les Bâties;78;1;79
27;Bourgogne-Franche-Comté;70;2;02;054;Battrans;240;4;244
27;Bourgogne-Franche-Comté;70;1;08;055;Baudoncourt;516;7;523
27;Bourgogne-Franche-Comté;70;2;11;056;Baulay;304;1;305
27;Bourgogne-Franche-Comté;70;2;09;057;Bay;145;2;147
27;Bourgogne-Franche-Comté;70;2;14;058;Beaujeu-Saint-Vallier-Pierrejux-et-Quitteur;937;14;951
27;Bourgogne-Franche-Comté;70;2;12;059;Beaumotte-Aubertans;471;8;479
27;Bourgogne-Franche-Comté;70;2;09;060;Beaumotte-lès-Pin;301;3;304
27;Bourgogne-Franche-Comté;70;1;10;061;Belfahy;83;0;83
27;Bourgogne-Franche-Comté;70;1;10;062;Belmont;139;5;144
27;Bourgogne-Franche-Comté;70;1;10;063;Belonchamp;207;3;210
27;Bourgogne-Franche-Comté;70;1;04;064;Belverne;147;3;150
27;Bourgogne-Franche-Comté;70;2;12;065;Besnans;78;1;79
27;Bourgogne-Franche-Comté;70;2;05;066;Betaucourt;175;1;176
27;Bourgogne-Franche-Comté;70;1;06;067;Betoncourt-lès-Brotte;126;0;126
27;Bourgogne-Franche-Comté;70;1;11;069;Betoncourt-Saint-Pancras;48;0;48
27;Bourgogne-Franche-Comté;70;2;05;070;Betoncourt-sur-Mance;29;2;31
27;Bourgogne-Franche-Comté;70;1;10;071;Beulotte-Saint-Laurent;57;0;57
27;Bourgogne-Franche-Comté;70;1;17;072;Beveuge;83;2;85
27;Bourgogne-Franche-Comté;70;2;05;074;Blondefontaine;257;3;260
27;Bourgogne-Franche-Comté;70;2;09;075;Bonboillon;199;2;201
27;Bourgogne-Franche-Comté;70;2;09;076;Bonnevent-Velloreille;376;8;384
27;Bourgogne-Franche-Comté;70;2;17;077;Borey;226;4;230
27;Bourgogne-Franche-Comté;70;2;05;078;Bougey;92;2;94
27;Bourgogne-Franche-Comté;70;2;11;079;Bougnon;535;12;547
27;Bourgogne-Franche-Comté;70;2;01;080;Bouhans-et-Feurg;238;4;242
27;Bourgogne-Franche-Comté;70;1;06;081;Bouhans-lès-Lure;321;4;325
27;Bourgogne-Franche-Comté;70;2;12;082;Bouhans-lès-Montbozon;136;2;138
27;Bourgogne-Franche-Comté;70;1;11;083;Bouligney;406;10;416
27;Bourgogne-Franche-Comté;70;2;12;084;Boulot;676;10;686
27;Bourgogne-Franche-Comté;70;2;12;085;Boult;652;12;664
27;Bourgogne-Franche-Comté;70;2;05;086;Bourbévelle;75;0;75
27;Bourgogne-Franche-Comté;70;2;11;087;Bourguignon-lès-Conflans;144;3;147
27;Bourgogne-Franche-Comté;70;2;14;088;Bourguignon-lès-la-Charité;115;2;117
27;Bourgogne-Franche-Comté;70;2;05;089;Bourguignon-lès-Morey;46;0;46
27;Bourgogne-Franche-Comté;70;2;14;090;Boursières;59;2;61
27;Bourgogne-Franche-Comté;70;2;05;091;Bousseraucourt;48;1;49
27;Bourgogne-Franche-Comté;70;2;09;092;Bresilley;182;3;185
27;Bourgogne-Franche-Comté;70;1;08;093;Breuches;671;8;679
27;Bourgogne-Franche-Comté;70;1;10;094;Breuchotte;298;5;303
27;Bourgogne-Franche-Comté;70;2;11;095;Breurey-lès-Faverney;647;10;657
27;Bourgogne-Franche-Comté;70;1;03;096;Brevilliers;638;17;655
27;Bourgogne-Franche-Comté;70;1;13;097;Briaucourt;235;8;243
27;Bourgogne-Franche-Comté;70;1;08;098;Brotte-lès-Luxeuil;211;4;215
27;Bourgogne-Franche-Comté;70;2;01;099;Brotte-lès-Ray;76;1;77
27;Bourgogne-Franche-Comté;70;2;09;101;Broye-Aubigney-Montseugny;492;5;497
27;Bourgogne-Franche-Comté;70;2;01;100;Broye-les-Loups-et-Verfontaine;130;0;130
27;Bourgogne-Franche-Comté;70;2;09;102;Brussey;276;10;286
27;Bourgogne-Franche-Comté;70;1;10;103;La Bruyère;221;3;224
27;Bourgogne-Franche-Comté;70;2;09;104;Bucey-lès-Gy;597;13;610
27;Bourgogne-Franche-Comté;70;2;14;105;Bucey-lès-Traves;130;1;131
27;Bourgogne-Franche-Comté;70;2;11;106;Buffignécourt;115;2;117
27;Bourgogne-Franche-Comté;70;2;12;107;Bussières;431;4;435
27;Bourgogne-Franche-Comté;70;2;12;109;Buthiers;308;2;310
27;Bourgogne-Franche-Comté;70;2;17;111;Calmoutier;271;3;274
27;Bourgogne-Franche-Comté;70;2;05;112;Cemboing;177;5;182
27;Bourgogne-Franche-Comté;70;2;12;113;Cenans;128;3;131
27;Bourgogne-Franche-Comté;70;2;05;114;Cendrecourt;206;2;208
27;Bourgogne-Franche-Comté;70;2;17;115;Cerre-lès-Noroy;232;5;237
27;Bourgogne-Franche-Comté;70;1;03;116;Chagey;626;12;638
27;Bourgogne-Franche-Comté;70;1;03;117;Châlonvillars;1243;33;1276
27;Bourgogne-Franche-Comté;70;2;12;118;Chambornay-lès-Bellevaux;189;2;191
27;Bourgogne-Franche-Comté;70;2;09;119;Chambornay-lès-Pin;359;12;371
27;Bourgogne-Franche-Comté;70;1;03;120;Champagney;3766;73;3839
27;Bourgogne-Franche-Comté;70;1;04;121;Champey;876;16;892
27;Bourgogne-Franche-Comté;70;2;01;122;Champlitte;1638;33;1671
27;Bourgogne-Franche-Comté;70;2;02;124;Champtonnay;96;1;97
27;Bourgogne-Franche-Comté;70;2;02;125;Champvans;179;2;181
27;Bourgogne-Franche-Comté;70;2;09;126;Chancey;199;6;205
27;Bourgogne-Franche-Comté;70;2;14;127;Chantes;114;6;120
27;Bourgogne-Franche-Comté;70;1;08;128;La Chapelle-lès-Luxeuil;385;3;388
27;Bourgogne-Franche-Comté;70;2;14;129;La Chapelle-Saint-Quillain;158;3;161
27;Bourgogne-Franche-Comté;70;2;09;130;Charcenne;327;8;335
27;Bourgogne-Franche-Comté;70;2;01;132;Chargey-lès-Gray;699;67;766
27;Bourgogne-Franche-Comté;70;2;05;133;Chargey-lès-Port;236;7;243
27;Bourgogne-Franche-Comté;70;2;15;134;Chariez;207;2;209
27;Bourgogne-Franche-Comté;70;2;05;135;Charmes-Saint-Valbert;36;1;37
27;Bourgogne-Franche-Comté;70;2;15;136;Charmoille;487;9;496
27;Bourgogne-Franche-Comté;70;2;12;137;Chassey-lès-Montbozon;215;8;223
27;Bourgogne-Franche-Comté;70;2;14;138;Chassey-lès-Scey;128;3;131
27;Bourgogne-Franche-Comté;70;1;06;140;Châteney;66;1;67
27;Bourgogne-Franche-Comté;70;1;06;141;Châtenois;120;2;122
27;Bourgogne-Franche-Comté;70;2;09;142;Chaumercenne;188;2;190
27;Bourgogne-Franche-Comté;70;2;05;143;Chauvirey-le-Châtel;124;6;130
27;Bourgogne-Franche-Comté;70;2;05;144;Chauvirey-le-Vieil;34;1;35
27;Bourgogne-Franche-Comté;70;2;12;145;Chaux-la-Lotière;457;10;467
27;Bourgogne-Franche-Comté;70;2;11;146;Chaux-lès-Port;162;4;166
27;Bourgogne-Franche-Comté;70;1;04;147;Chavanne;233;4;237
27;Bourgogne-Franche-Comté;70;2;14;148;Chemilly;87;1;88
27;Bourgogne-Franche-Comté;70;1;04;149;Chenebier;691;17;708
27;Bourgogne-Franche-Comté;70;2;09;150;Chenevrey-et-Morogne;312;2;314
27;Bourgogne-Franche-Comté;70;2;09;151;Chevigney;36;0;36
27;Bourgogne-Franche-Comté;70;2;09;152;Choye;467;37;504
27;Bourgogne-Franche-Comté;70;2;05;153;Cintrey;95;1;96
27;Bourgogne-Franche-Comté;70;2;12;154;Cirey;373;6;379
27;Bourgogne-Franche-Comté;70;1;08;155;Citers;788;15;803
27;Bourgogne-Franche-Comté;70;2;09;156;Citey;106;1;107
27;Bourgogne-Franche-Comté;70;1;03;157;Clairegoutte;370;10;380
27;Bourgogne-Franche-Comté;70;2;14;158;Clans;104;1;105
27;Bourgogne-Franche-Comté;70;2;12;159;Cognières;91;0;91
27;Bourgogne-Franche-Comté;70;1;04;160;Coisevaux;322;19;341
27;Bourgogne-Franche-Comté;70;2;17;162;Colombe-lès-Vesoul;459;13;472
27;Bourgogne-Franche-Comté;70;2;16;163;Colombier;448;8;456
27;Bourgogne-Franche-Comté;70;2;17;164;Colombotte;84;2;86
27;Bourgogne-Franche-Comté;70;2;05;165;Combeaufontaine;546;42;588
27;Bourgogne-Franche-Comté;70;2;16;166;Comberjon;157;5;162
27;Bourgogne-Franche-Comté;70;2;11;167;Conflandey;357;13;370
27;Bourgogne-Franche-Comté;70;1;13;168;Conflans-sur-Lanterne;620;16;636
27;Bourgogne-Franche-Comté;70;2;05;169;Confracourt;219;5;224
27;Bourgogne-Franche-Comté;70;2;11;170;Contréglise;121;2;123
27;Bourgogne-Franche-Comté;70;1;13;171;Corbenay;1275;29;1304
27;Bourgogne-Franche-Comté;70;1;10;172;La Corbière;107;0;107
27;Bourgogne-Franche-Comté;70;2;12;174;Cordonnet;141;2;143
27;Bourgogne-Franche-Comté;70;2;05;175;Cornot;137;3;140
27;Bourgogne-Franche-Comté;70;1;10;176;Corravillers;191;3;194
27;Bourgogne-Franche-Comté;70;2;05;177;Corre;601;15;616
27;Bourgogne-Franche-Comté;70;1;07;178;La Côte;521;10;531
27;Bourgogne-Franche-Comté;70;2;16;179;Coulevon;170;3;173
27;Bourgogne-Franche-Comté;70;1;17;180;Courchaton;438;10;448
27;Bourgogne-Franche-Comté;70;2;09;181;Courcuire;130;0;130
27;Bourgogne-Franche-Comté;70;1;04;182;Courmont;138;0;138
27;Bourgogne-Franche-Comté;70;2;01;183;Courtesoult-et-Gatey;61;0;61
27;Bourgogne-Franche-Comté;70;1;04;184;Couthenans;718;21;739
27;Bourgogne-Franche-Comté;70;2;02;185;Cresancey;186;9;195
27;Bourgogne-Franche-Comté;70;1;06;186;La Creuse;74;1;75
27;Bourgogne-Franche-Comté;70;1;17;187;Crevans-et-la-Chapelle-lès-Granges;263;3;266
27;Bourgogne-Franche-Comté;70;1;06;188;Creveney;55;1;56
27;Bourgogne-Franche-Comté;70;2;12;189;Cromary;248;4;252
27;Bourgogne-Franche-Comté;70;2;11;190;Cubry-lès-Faverney;180;3;183
27;Bourgogne-Franche-Comté;70;2;09;192;Cugney;208;2;210
27;Bourgogne-Franche-Comté;70;2;09;193;Cult;232;3;235
27;Bourgogne-Franche-Comté;70;1;11;194;Cuve;137;9;146
27;Bourgogne-Franche-Comté;70;1;06;195;Dambenoît-lès-Colombe;274;4;278
27;Bourgogne-Franche-Comté;70;1;11;196;Dampierre-lès-Conflans;254;9;263
27;Bourgogne-Franche-Comté;70;2;12;197;Dampierre-sur-Linotte;797;15;812
27;Bourgogne-Franche-Comté;70;2;01;198;Dampierre-sur-Salon;1252;25;1277
27;Bourgogne-Franche-Comté;70;2;17;199;Dampvalley-lès-Colombe;116;0;116
27;Bourgogne-Franche-Comté;70;1;11;200;Dampvalley-Saint-Pancras;35;1;36
27;Bourgogne-Franche-Comté;70;2;01;201;Delain;214;1;215
27;Bourgogne-Franche-Comté;70;1;05;202;Demangevelle;276;7;283
27;Bourgogne-Franche-Comté;70;2;17;203;La Demie;146;2;148
27;Bourgogne-Franche-Comté;70;2;01;204;Denèvre;160;4;164
27;Bourgogne-Franche-Comté;70;1;03;205;Échavanne;204;2;206
27;Bourgogne-Franche-Comté;70;1;03;206;Échenans-sous-Mont-Vaudois;539;7;546
27;Bourgogne-Franche-Comté;70;2;15;207;Échenoz-la-Méline;3246;70;3316
27;Bourgogne-Franche-Comté;70;2;12;208;Échenoz-le-Sec;295;5;300
27;Bourgogne-Franche-Comté;70;1;10;210;Écromagny;157;5;162
27;Bourgogne-Franche-Comté;70;2;01;211;Écuelle;67;2;69
27;Bourgogne-Franche-Comté;70;1;13;213;Éhuns;227;6;233
27;Bourgogne-Franche-Comté;70;2;11;214;Équevilley;123;5;128
27;Bourgogne-Franche-Comté;70;1;03;215;Errevet;247;11;258
27;Bourgogne-Franche-Comté;70;1;08;216;Esboz-Brest;434;25;459
27;Bourgogne-Franche-Comté;70;1;10;217;Esmoulières;97;1;98
27;Bourgogne-Franche-Comté;70;2;02;218;Esmoulins;135;1;136
27;Bourgogne-Franche-Comté;70;1;17;219;Esprels;733;15;748
27;Bourgogne-Franche-Comté;70;2;02;220;Essertenne-et-Cecey;409;6;415
27;Bourgogne-Franche-Comté;70;1;04;221;Étobon;288;4;292
27;Bourgogne-Franche-Comté;70;2;14;222;Étrelles-et-la-Montbleuse;78;1;79
27;Bourgogne-Franche-Comté;70;2;09;224;Étuz;672;14;686
27;Bourgogne-Franche-Comté;70;2;01;225;Fahy-lès-Autrey;108;2;110
27;Bourgogne-Franche-Comté;70;1;17;226;Fallon;311;3;314
27;Bourgogne-Franche-Comté;70;1;10;227;Faucogney-et-la-Mer;504;16;520
27;Bourgogne-Franche-Comté;70;2;11;228;Faverney;973;11;984
27;Bourgogne-Franche-Comté;70;1;07;229;Faymont;261;6;267
27;Bourgogne-Franche-Comté;70;2;01;230;Fédry;97;4;101
27;Bourgogne-Franche-Comté;70;2;01;231;Ferrières-lès-Ray;34;0;34
27;Bourgogne-Franche-Comté;70;2;14;232;Ferrières-lès-Scey;124;5;129
27;Bourgogne-Franche-Comté;70;1;10;233;Les Fessey;135;2;137
27;Bourgogne-Franche-Comté;70;2;12;234;Filain;231;12;243
27;Bourgogne-Franche-Comté;70;2;11;235;Flagy;151;4;155
27;Bourgogne-Franche-Comté;70;2;11;236;Fleurey-lès-Faverney;463;9;472
27;Bourgogne-Franche-Comté;70;2;01;237;Fleurey-lès-Lavoncourt;98;0;98
27;Bourgogne-Franche-Comté;70;1;13;238;Fleurey-lès-Saint-Loup;136;4;140
27;Bourgogne-Franche-Comté;70;2;12;239;Fondremand;200;5;205
27;Bourgogne-Franche-Comté;70;1;13;240;Fontaine-lès-Luxeuil;1340;24;1364
27;Bourgogne-Franche-Comté;70;1;11;242;Fontenois-la-Ville;134;0;134
27;Bourgogne-Franche-Comté;70;2;12;243;Fontenois-lès-Montbozon;328;12;340
27;Bourgogne-Franche-Comté;70;2;05;244;Fouchécourt;112;0;112
27;Bourgogne-Franche-Comté;70;1;  ;245;Fougerolles-Saint-Valbert ;3804;123;3927
27;Bourgogne-Franche-Comté;70;2;01;247;Fouvent-Saint-Andoche;214;3;217
27;Bourgogne-Franche-Comté;70;1;03;248;Frahier-et-Chatebier;1378;35;1413
27;Bourgogne-Franche-Comté;70;2;01;252;Framont;177;3;180
27;Bourgogne-Franche-Comté;70;1;13;249;Francalmont;120;3;123
27;Bourgogne-Franche-Comté;70;1;06;250;Franchevelle;439;6;445
27;Bourgogne-Franche-Comté;70;2;01;251;Francourt;101;4;105
27;Bourgogne-Franche-Comté;70;2;14;253;Frasne-le-Château;294;28;322
27;Bourgogne-Franche-Comté;70;1;03;254;Frédéric-Fontaine;254;7;261
27;Bourgogne-Franche-Comté;70;2;14;255;Fresne-Saint-Mamès;500;4;504
27;Bourgogne-Franche-Comté;70;1;10;256;Fresse;710;12;722
27;Bourgogne-Franche-Comté;70;2;14;257;Fretigney-et-Velloreille;738;14;752
27;Bourgogne-Franche-Comté;70;1;08;258;Froideconche;1985;46;2031
27;Bourgogne-Franche-Comté;70;1;06;259;Froideterre;373;6;379
27;Bourgogne-Franche-Comté;70;1;07;260;Frotey-lès-Lure;687;20;707
27;Bourgogne-Franche-Comté;70;2;16;261;Frotey-lès-Vesoul;1386;33;1419
27;Bourgogne-Franche-Comté;70;1;07;262;Genevreuille;164;4;168
27;Bourgogne-Franche-Comté;70;1;06;263;Genevrey;241;2;243
27;Bourgogne-Franche-Comté;70;1;17;264;Georfans;55;0;55
27;Bourgogne-Franche-Comté;70;2;02;265;Germigney;156;5;161
27;Bourgogne-Franche-Comté;70;2;05;267;Gevigney-et-Mercey;479;7;486
27;Bourgogne-Franche-Comté;70;2;09;268;Gézier-et-Fontenelay;212;4;216
27;Bourgogne-Franche-Comté;70;1;11;269;Girefontaine;36;1;37
27;Bourgogne-Franche-Comté;70;1;17;271;Gouhenans;381;11;392
27;Bourgogne-Franche-Comté;70;2;05;272;Gourgeon;192;11;203
27;Bourgogne-Franche-Comté;70;1;17;273;Grammont;67;1;68
27;Bourgogne-Franche-Comté;70;2;09;443;La Grande-Résie;88;1;89
27;Bourgogne-Franche-Comté;70;2;01;274;Grandecourt;48;0;48
27;Bourgogne-Franche-Comté;70;2;14;275;Grandvelle-et-le-Perrenot;380;5;385
27;Bourgogne-Franche-Comté;70;1;17;276;Granges-la-Ville;184;8;192
27;Bourgogne-Franche-Comté;70;1;17;277;Granges-le-Bourg;384;9;393
27;Bourgogne-Franche-Comté;70;2;11;278;Grattery;213;4;217
27;Bourgogne-Franche-Comté;70;2;02;279;Gray;5541;424;5965
27;Bourgogne-Franche-Comté;70;2;02;280;Gray-la-Ville;943;36;979
27;Bourgogne-Franche-Comté;70;2;09;282;Gy;1021;20;1041
27;Bourgogne-Franche-Comté;70;1;10;283;Haut-du-Them-Château-Lambert;438;7;445
27;Bourgogne-Franche-Comté;70;1;13;284;Hautevelle;267;8;275
27;Bourgogne-Franche-Comté;70;1;  ;285;Héricourt ;10654;277;10931
27;Bourgogne-Franche-Comté;70;2;09;286;Hugier;128;3;131
27;Bourgogne-Franche-Comté;70;1;05;287;Hurecourt;42;0;42
27;Bourgogne-Franche-Comté;70;2;12;288;Hyet;122;1;123
27;Bourgogne-Franche-Comté;70;2;02;289;Igny;208;2;210
27;Bourgogne-Franche-Comté;70;1;11;290;Jasney;218;6;224
27;Bourgogne-Franche-Comté;70;2;05;291;Jonvelle;125;3;128
27;Bourgogne-Franche-Comté;70;2;05;292;Jussey;1581;35;1616
27;Bourgogne-Franche-Comté;70;2;05;293;Lambrey;80;2;82
27;Bourgogne-Franche-Comté;70;1;10;294;Lantenot;355;4;359
27;Bourgogne-Franche-Comté;70;1;10;295;La Lanterne-et-les-Armonts;218;5;223
27;Bourgogne-Franche-Comté;70;2;12;296;Larians-et-Munans;268;2;270
27;Bourgogne-Franche-Comté;70;2;01;297;Larret;60;0;60
27;Bourgogne-Franche-Comté;70;2;05;298;Lavigney;119;0;119
27;Bourgogne-Franche-Comté;70;2;01;299;Lavoncourt;302;2;304
27;Bourgogne-Franche-Comté;70;2;14;301;Lieffrans;59;0;59
27;Bourgogne-Franche-Comté;70;2;09;302;Lieucourt;76;1;77
27;Bourgogne-Franche-Comté;70;2;17;303;Liévans;153;1;154
27;Bourgogne-Franche-Comté;70;1;06;304;Linexert;125;1;126
27;Bourgogne-Franche-Comté;70;1;07;306;Lomont;452;13;465
27;Bourgogne-Franche-Comté;70;1;17;307;Longevelle;122;7;129
27;Bourgogne-Franche-Comté;70;1;10;308;La Longine;223;6;229
27;Bourgogne-Franche-Comté;70;2;12;309;Loulans-Verchamp;453;10;463
27;Bourgogne-Franche-Comté;70;1;98;310;Lure;8131;187;8318
27;Bourgogne-Franche-Comté;70;1;08;311;Luxeuil-les-Bains;6692;276;6968
27;Bourgogne-Franche-Comté;70;1;03;312;Luze;733;21;754
27;Bourgogne-Franche-Comté;70;1;07;313;Lyoffans;375;4;379
27;Bourgogne-Franche-Comté;70;2;01;305;Lœuilley;102;2;104
27;Bourgogne-Franche-Comté;70;1;10;314;Magnivray;168;6;174
27;Bourgogne-Franche-Comté;70;1;13;315;Magnoncourt;412;11;423
27;Bourgogne-Franche-Comté;70;2;12;316;Le Magnoray;86;4;90
27;Bourgogne-Franche-Comté;70;1;17;317;Les Magny;140;4;144
27;Bourgogne-Franche-Comté;70;1;07;318;Magny-Danigon;436;15;451
27;Bourgogne-Franche-Comté;70;1;07;319;Magny-Jobert;117;3;120
27;Bourgogne-Franche-Comté;70;2;05;320;Magny-lès-Jussey;101;3;104
27;Bourgogne-Franche-Comté;70;1;07;321;Magny-Vernois;1389;28;1417
27;Bourgogne-Franche-Comté;70;1;13;322;Mailleroncourt-Charette;284;6;290
27;Bourgogne-Franche-Comté;70;1;11;323;Mailleroncourt-Saint-Pancras;194;1;195
27;Bourgogne-Franche-Comté;70;2;14;324;Mailley-et-Chazelot;647;16;663
27;Bourgogne-Franche-Comté;70;2;12;325;Maizières;365;3;368
27;Bourgogne-Franche-Comté;70;2;12;326;La Malachère;307;3;310
27;Bourgogne-Franche-Comté;70;2;09;327;Malans;134;3;137
27;Bourgogne-Franche-Comté;70;1;06;328;Malbouhans;330;6;336
27;Bourgogne-Franche-Comté;70;2;05;329;Malvillers;62;4;66
27;Bourgogne-Franche-Comté;70;1;03;330;Mandrevillars;264;7;271
27;Bourgogne-Franche-Comté;70;2;02;331;Mantoche;443;20;463
27;Bourgogne-Franche-Comté;70;1;17;332;Marast;55;1;56
27;Bourgogne-Franche-Comté;70;2;09;334;Marnay;1495;24;1519
27;Bourgogne-Franche-Comté;70;2;12;335;Maussans;64;2;66
27;Bourgogne-Franche-Comté;70;1;17;336;Mélecey;139;3;142
27;Bourgogne-Franche-Comté;70;2;05;337;Melin;59;1;60
27;Bourgogne-Franche-Comté;70;1;11;338;Melincourt;233;7;240
27;Bourgogne-Franche-Comté;70;1;10;339;Mélisey;1668;31;1699
27;Bourgogne-Franche-Comté;70;2;01;340;Membrey;215;29;244
27;Bourgogne-Franche-Comté;70;2;11;341;Menoux;301;3;304
27;Bourgogne-Franche-Comté;70;2;14;342;Mercey-sur-Saône;134;1;135
27;Bourgogne-Franche-Comté;70;2;11;343;Mersuay;287;5;292
27;Bourgogne-Franche-Comté;70;1;13;344;Meurcourt;335;9;344
27;Bourgogne-Franche-Comté;70;1;17;347;Mignavillers;348;8;356
27;Bourgogne-Franche-Comté;70;1;07;348;Moffans-et-Vacheresse;622;12;634
27;Bourgogne-Franche-Comté;70;1;17;349;Moimay;235;3;238
27;Bourgogne-Franche-Comté;70;2;05;350;Molay;66;0;66
27;Bourgogne-Franche-Comté;70;1;07;351;Mollans;230;3;233
27;Bourgogne-Franche-Comté;70;2;15;367;Mont-le-Vernois;178;4;182
27;Bourgogne-Franche-Comté;70;2;01;369;Mont-Saint-Léger;49;0;49
27;Bourgogne-Franche-Comté;70;1;10;352;La Montagne;36;0;36
27;Bourgogne-Franche-Comté;70;2;09;353;Montagney;508;8;516
27;Bourgogne-Franche-Comté;70;2;12;355;Montarlot-lès-Rioz;293;4;297
27;Bourgogne-Franche-Comté;70;2;09;356;Montboillon;278;6;284
27;Bourgogne-Franche-Comté;70;2;12;357;Montbozon;552;91;643
27;Bourgogne-Franche-Comté;70;2;16;358;Montcey;274;4;278
27;Bourgogne-Franche-Comté;70;2;05;359;Montcourt;54;0;54
27;Bourgogne-Franche-Comté;70;1;05;360;Montdoré;74;1;75
27;Bourgogne-Franche-Comté;70;1;10;361;Montessaux;157;5;162
27;Bourgogne-Franche-Comté;70;2;05;362;Montigny-lès-Cherlieu;147;4;151
27;Bourgogne-Franche-Comté;70;2;15;363;Montigny-lès-Vesoul;652;15;667
27;Bourgogne-Franche-Comté;70;2;17;364;Montjustin-et-Velotte;119;1;120
27;Bourgogne-Franche-Comté;70;2;01;368;Montot;131;3;134
27;Bourgogne-Franche-Comté;70;2;01;371;Montureux-et-Prantigny;205;1;206
27;Bourgogne-Franche-Comté;70;2;11;372;Montureux-lès-Baulay;155;4;159
27;Bourgogne-Franche-Comté;70;2;09;374;Motey-Besuche;98;2;100
27;Bourgogne-Franche-Comté;70;2;02;376;Nantilly;472;10;482
27;Bourgogne-Franche-Comté;70;2;16;378;Navenne;1642;51;1693
27;Bourgogne-Franche-Comté;70;2;13;380;Neurey-en-Vaux;176;4;180
27;Bourgogne-Franche-Comté;70;2;17;381;Neurey-lès-la-Demie;335;9;344
27;Bourgogne-Franche-Comté;70;2;12;383;Neuvelle-lès-Cromary;409;4;413
27;Bourgogne-Franche-Comté;70;2;14;384;Neuvelle-lès-la-Charité;224;3;227
27;Bourgogne-Franche-Comté;70;1;06;385;La Neuvelle-lès-Lure;337;10;347
27;Bourgogne-Franche-Comté;70;2;05;386;La Neuvelle-lès-Scey;182;2;184
27;Bourgogne-Franche-Comté;70;2;14;387;Noidans-le-Ferroux;675;10;685
27;Bourgogne-Franche-Comté;70;2;15;388;Noidans-lès-Vesoul;1984;76;2060
27;Bourgogne-Franche-Comté;70;2;02;389;Noiron;57;2;59
27;Bourgogne-Franche-Comté;70;2;17;390;Noroy-le-Bourg;503;11;514
27;Bourgogne-Franche-Comté;70;2;05;392;Oigney;34;2;36
27;Bourgogne-Franche-Comté;70;2;14;393;Oiselay-et-Grachaux;423;6;429
27;Bourgogne-Franche-Comté;70;2;02;394;Onay;61;4;65
27;Bourgogne-Franche-Comté;70;1;17;395;Oppenans;52;0;52
27;Bourgogne-Franche-Comté;70;1;17;396;Oricourt;38;2;40
27;Bourgogne-Franche-Comté;70;2;12;397;Ormenans;80;0;80
27;Bourgogne-Franche-Comté;70;1;08;398;Ormoiche;66;0;66
27;Bourgogne-Franche-Comté;70;2;05;399;Ormoy;212;7;219
27;Bourgogne-Franche-Comté;70;2;05;400;Ouge;105;2;107
27;Bourgogne-Franche-Comté;70;2;14;401;Ovanches;134;1;135
27;Bourgogne-Franche-Comté;70;2;01;402;Oyrières;376;11;387
27;Bourgogne-Franche-Comté;70;1;07;403;Palante;241;3;244
27;Bourgogne-Franche-Comté;70;1;05;404;Passavant-la-Rochère;590;16;606
27;Bourgogne-Franche-Comté;70;2;12;405;Pennesières;193;4;197
27;Bourgogne-Franche-Comté;70;2;01;406;Percey-le-Grand;78;1;79
27;Bourgogne-Franche-Comté;70;2;12;407;Perrouse;270;5;275
27;Bourgogne-Franche-Comté;70;2;09;408;Pesmes;1077;29;1106
27;Bourgogne-Franche-Comté;70;2;01;409;Pierrecourt;114;2;116
27;Bourgogne-Franche-Comté;70;2;09;410;Pin;700;3;703
27;Bourgogne-Franche-Comté;70;1;11;411;La Pisseure;37;0;37
27;Bourgogne-Franche-Comté;70;1;11;412;Plainemont;69;0;69
27;Bourgogne-Franche-Comté;70;1;03;413;Plancher-Bas;1934;36;1970
27;Bourgogne-Franche-Comté;70;1;03;414;Plancher-les-Mines;960;15;975
27;Bourgogne-Franche-Comté;70;2;11;415;Polaincourt-et-Clairefontaine;696;9;705
27;Bourgogne-Franche-Comté;70;1;07;416;Pomoy;208;5;213
27;Bourgogne-Franche-Comté;70;1;05;419;Pont-du-Bois;107;4;111
27;Bourgogne-Franche-Comté;70;1;17;420;Pont-sur-l'Ognon;65;0;65
27;Bourgogne-Franche-Comté;70;2;14;417;Pontcey;315;3;318
27;Bourgogne-Franche-Comté;70;2;11;421;Port-sur-Saône;2944;54;2998
27;Bourgogne-Franche-Comté;70;2;01;422;Poyans;146;1;147
27;Bourgogne-Franche-Comté;70;2;05;423;Preigney;111;3;114
27;Bourgogne-Franche-Comté;70;1;10;425;La Proiselière-et-Langle;147;6;153
27;Bourgogne-Franche-Comté;70;2;11;426;Provenchère;255;7;262
27;Bourgogne-Franche-Comté;70;2;05;427;Purgerot;338;9;347
27;Bourgogne-Franche-Comté;70;2;15;428;Pusey;1457;49;1506
27;Bourgogne-Franche-Comté;70;2;15;429;Pusy-et-Épenoux;549;14;563
27;Bourgogne-Franche-Comté;70;2;05;430;La Quarte;67;1;68
27;Bourgogne-Franche-Comté;70;2;12;431;Quenoche;249;3;252
27;Bourgogne-Franche-Comté;70;1;06;432;Quers;334;7;341
27;Bourgogne-Franche-Comté;70;2;16;433;Quincey;1401;39;1440
27;Bourgogne-Franche-Comté;70;1;10;435;Raddon-et-Chapendu;846;23;869
27;Bourgogne-Franche-Comté;70;2;05;436;Raincourt;119;0;119
27;Bourgogne-Franche-Comté;70;2;05;437;Ranzevelle;16;0;16
27;Bourgogne-Franche-Comté;70;2;01;438;Ray-sur-Saône;212;3;215
27;Bourgogne-Franche-Comté;70;2;14;439;Raze;355;7;362
27;Bourgogne-Franche-Comté;70;2;01;440;Recologne;33;2;35
27;Bourgogne-Franche-Comté;70;2;12;441;Recologne-lès-Rioz;249;3;252
27;Bourgogne-Franche-Comté;70;2;01;442;Renaucourt;106;3;109
27;Bourgogne-Franche-Comté;70;2;09;444;La Résie-Saint-Martin;160;1;161
27;Bourgogne-Franche-Comté;70;1;10;445;Rignovelle;113;1;114
27;Bourgogne-Franche-Comté;70;2;01;446;Rigny;599;9;608
27;Bourgogne-Franche-Comté;70;2;12;447;Rioz;2283;82;2365
27;Bourgogne-Franche-Comté;70;2;01;448;Roche-et-Raucourt;156;2;158
27;Bourgogne-Franche-Comté;70;2;05;373;La Roche-Morey;283;4;287
27;Bourgogne-Franche-Comté;70;2;12;449;Roche-sur-Linotte-et-Sorans-les-Cordiers;63;0;63
27;Bourgogne-Franche-Comté;70;2;05;450;La Rochelle;40;0;40
27;Bourgogne-Franche-Comté;70;2;14;418;La Romaine;515;4;519
27;Bourgogne-Franche-Comté;70;1;06;451;Ronchamp;2743;28;2771
27;Bourgogne-Franche-Comté;70;2;14;452;Rosey;261;3;264
27;Bourgogne-Franche-Comté;70;1;10;453;La Rosière;80;3;83
27;Bourgogne-Franche-Comté;70;2;05;454;Rosières-sur-Mance;49;2;51
27;Bourgogne-Franche-Comté;70;1;07;455;Roye;1506;24;1530
27;Bourgogne-Franche-Comté;70;2;12;456;Ruhans;151;5;156
27;Bourgogne-Franche-Comté;70;2;14;457;Rupt-sur-Saône;109;3;112
27;Bourgogne-Franche-Comté;70;1;10;459;Saint-Barthélemy;1107;25;1132
27;Bourgogne-Franche-Comté;70;1;10;460;Saint-Bresson;435;9;444
27;Bourgogne-Franche-Comté;70;2;02;461;Saint-Broing;116;2;118
27;Bourgogne-Franche-Comté;70;1;17;462;Saint-Ferjeux;79;2;81
27;Bourgogne-Franche-Comté;70;2;14;463;Saint-Gand;142;1;143
27;Bourgogne-Franche-Comté;70;1;06;464;Saint-Germain;1347;23;1370
27;Bourgogne-Franche-Comté;70;2;02;466;Saint-Loup-Nantouard;124;3;127
27;Bourgogne-Franche-Comté;70;1;13;467;Saint-Loup-sur-Semouse;3206;67;3273
27;Bourgogne-Franche-Comté;70;2;05;468;Saint-Marcel;91;1;92
27;Bourgogne-Franche-Comté;70;2;11;472;Saint-Rémy-en-Comté;528;4;532
27;Bourgogne-Franche-Comté;70;1;08;473;Saint-Sauveur;1922;33;1955
27;Bourgogne-Franche-Comté;70;1;17;474;Saint-Sulpice;129;2;131
27;Bourgogne-Franche-Comté;70;1;10;469;Sainte-Marie-en-Chanois;214;4;218
27;Bourgogne-Franche-Comté;70;1;13;470;Sainte-Marie-en-Chaux;162;2;164
27;Bourgogne-Franche-Comté;70;2;14;471;Sainte-Reine;28;1;29
27;Bourgogne-Franche-Comté;70;2;11;476;Saponcourt;65;1;66
27;Bourgogne-Franche-Comté;70;1;04;477;Saulnot;762;13;775
27;Bourgogne-Franche-Comté;70;1;06;478;Saulx;887;15;902
27;Bourgogne-Franche-Comté;70;2;02;479;Sauvigney-lès-Gray;100;4;104
27;Bourgogne-Franche-Comté;70;2;09;480;Sauvigney-lès-Pesmes;137;7;144
27;Bourgogne-Franche-Comté;70;2;01;481;Savoyeux;208;4;212
27;Bourgogne-Franche-Comté;70;2;14;482;Scey-sur-Saône-et-Saint-Albin;1539;25;1564
27;Bourgogne-Franche-Comté;70;2;11;483;Scye;135;5;140
27;Bourgogne-Franche-Comté;70;1;17;484;Secenans;178;3;181
27;Bourgogne-Franche-Comté;70;1;05;485;Selles;203;5;208
27;Bourgogne-Franche-Comté;70;2;05;486;Semmadon;112;3;115
27;Bourgogne-Franche-Comté;70;1;17;487;Senargent-Mignafans;293;3;296
27;Bourgogne-Franche-Comté;70;2;11;488;Senoncourt;194;1;195
27;Bourgogne-Franche-Comté;70;1;10;489;Servance-Miellin;803;6;809
27;Bourgogne-Franche-Comté;70;1;06;490;Servigney;122;1;123
27;Bourgogne-Franche-Comté;70;2;14;491;Seveux-Motey;485;15;500
27;Bourgogne-Franche-Comté;70;2;14;492;Soing-Cubry-Charentenay;575;10;585
27;Bourgogne-Franche-Comté;70;2;12;493;Sorans-lès-Breurey;458;8;466
27;Bourgogne-Franche-Comté;70;2;09;494;Sornay;344;6;350
27;Bourgogne-Franche-Comté;70;2;05;496;Tartécourt;26;1;27
27;Bourgogne-Franche-Comté;70;1;10;498;Ternuay-Melay-et-Saint-Hilaire;469;14;483
27;Bourgogne-Franche-Comté;70;2;01;499;Theuley;104;2;106
27;Bourgogne-Franche-Comté;70;2;12;500;Thieffrans;170;10;180
27;Bourgogne-Franche-Comté;70;2;12;501;Thiénans;98;3;101
27;Bourgogne-Franche-Comté;70;2;01;502;Tincey-et-Pontrebeau;85;0;85
27;Bourgogne-Franche-Comté;70;2;12;503;Traitiéfontaine;163;2;165
27;Bourgogne-Franche-Comté;70;2;14;504;Traves;362;13;375
27;Bourgogne-Franche-Comté;70;2;02;505;Le Tremblois;169;7;176
27;Bourgogne-Franche-Comté;70;1;04;506;Trémoins;387;13;400
27;Bourgogne-Franche-Comté;70;2;12;507;Trésilley;234;5;239
27;Bourgogne-Franche-Comté;70;2;09;509;Tromarey;107;0;107
27;Bourgogne-Franche-Comté;70;2;09;510;Vadans;133;3;136
27;Bourgogne-Franche-Comté;70;2;01;511;Vaite;221;3;224
27;Bourgogne-Franche-Comté;70;1;13;512;La Vaivre;219;5;224
27;Bourgogne-Franche-Comté;70;2;15;513;Vaivre-et-Montoille;2418;55;2473
27;Bourgogne-Franche-Comté;70;1;07;515;Le Val-de-Gouhenans;66;1;67
27;Bourgogne-Franche-Comté;70;2;11;518;Le Val-Saint-Éloi;99;2;101
27;Bourgogne-Franche-Comté;70;2;09;514;Valay;681;11;692
27;Bourgogne-Franche-Comté;70;2;17;516;Vallerois-le-Bois;251;3;254
27;Bourgogne-Franche-Comté;70;2;17;517;Vallerois-Lorioz;391;18;409
27;Bourgogne-Franche-Comté;70;2;12;519;Vandelans;108;0;108
27;Bourgogne-Franche-Comté;70;2;01;520;Vanne;109;3;112
27;Bourgogne-Franche-Comté;70;2;09;521;Vantoux-et-Longevelle;180;4;184
27;Bourgogne-Franche-Comté;70;2;16;522;Varogne;152;3;155
27;Bourgogne-Franche-Comté;70;2;01;523;Vars;201;3;204
27;Bourgogne-Franche-Comté;70;2;11;524;Vauchoux;111;3;114
27;Bourgogne-Franche-Comté;70;2;01;525;Vauconcourt-Nervezain;216;3;219
27;Bourgogne-Franche-Comté;70;1;05;526;Vauvillers;643;14;657
27;Bourgogne-Franche-Comté;70;2;14;527;Vaux-le-Moncelot;72;1;73
27;Bourgogne-Franche-Comté;70;2;02;528;Velesmes-Échevanne;485;9;494
27;Bourgogne-Franche-Comté;70;2;02;529;Velet;389;16;405
27;Bourgogne-Franche-Comté;70;2;14;536;Velle-le-Châtel;132;2;134
27;Bourgogne-Franche-Comté;70;1;17;530;Vellechevreux-et-Courbenans;124;0;124
27;Bourgogne-Franche-Comté;70;2;09;531;Velleclaire;107;1;108
27;Bourgogne-Franche-Comté;70;2;12;532;Vellefaux;507;6;513
27;Bourgogne-Franche-Comté;70;2;09;533;Vellefrey-et-Vellefrange;122;0;122
27;Bourgogne-Franche-Comté;70;2;16;534;Vellefrie;126;1;127
27;Bourgogne-Franche-Comté;70;2;14;535;Velleguindry-et-Levrecey;153;1;154
27;Bourgogne-Franche-Comté;70;1;06;537;Velleminfroy;297;6;303
27;Bourgogne-Franche-Comté;70;2;14;538;Vellemoz;83;0;83
27;Bourgogne-Franche-Comté;70;2;14;539;Vellexon-Queutrey-et-Vaudey;455;12;467
27;Bourgogne-Franche-Comté;70;2;09;540;Velloreille-lès-Choye;79;4;83
27;Bourgogne-Franche-Comté;70;1;13;541;Velorcey;204;4;208
27;Bourgogne-Franche-Comté;70;2;09;542;Venère;213;5;218
27;Bourgogne-Franche-Comté;70;2;11;545;Venisey;132;3;135
27;Bourgogne-Franche-Comté;70;2;01;546;Vereux;223;22;245
27;Bourgogne-Franche-Comté;70;1;17;544;La Vergenne;114;2;116
27;Bourgogne-Franche-Comté;70;1;04;547;Verlans;171;3;174
27;Bourgogne-Franche-Comté;70;2;05;548;Vernois-sur-Mance;144;1;145
27;Bourgogne-Franche-Comté;70;2;14;549;La Vernotte;77;1;78
27;Bourgogne-Franche-Comté;70;2;99;550;Vesoul;14973;752;15725
27;Bourgogne-Franche-Comté;70;1;17;552;Villafans;214;3;217
27;Bourgogne-Franche-Comté;70;1;17;553;Villargent;117;2;119
27;Bourgogne-Franche-Comté;70;2;05;554;Villars-le-Pautel;193;1;194
27;Bourgogne-Franche-Comté;70;1;13;555;La Villedieu-en-Fontenette;173;1;174
27;Bourgogne-Franche-Comté;70;2;09;557;Villefrancon;136;4;140
27;Bourgogne-Franche-Comté;70;2;16;558;La Villeneuve-Bellenoye-et-la-Maize;139;2;141
27;Bourgogne-Franche-Comté;70;2;16;559;Villeparois;201;4;205
27;Bourgogne-Franche-Comté;70;2;12;560;Villers-Bouton;163;2;165
27;Bourgogne-Franche-Comté;70;2;09;366;Villers-Chemin-et-Mont-lès-Étrelles;123;0;123
27;Bourgogne-Franche-Comté;70;1;17;562;Villers-la-Ville;150;3;153
27;Bourgogne-Franche-Comté;70;2;17;563;Villers-le-Sec;534;13;547
27;Bourgogne-Franche-Comté;70;1;13;564;Villers-lès-Luxeuil;307;16;323
27;Bourgogne-Franche-Comté;70;2;12;565;Villers-Pater;52;2;54
27;Bourgogne-Franche-Comté;70;2;11;566;Villers-sur-Port;204;5;209
27;Bourgogne-Franche-Comté;70;1;04;567;Villers-sur-Saulnot;135;9;144
27;Bourgogne-Franche-Comté;70;2;01;568;Villers-Vaudey;57;4;61
27;Bourgogne-Franche-Comté;70;1;17;561;Villersexel;1428;107;1535
27;Bourgogne-Franche-Comté;70;2;16;569;Vilory;63;1;64
27;Bourgogne-Franche-Comté;70;1;13;571;Visoncourt;40;2;42
27;Bourgogne-Franche-Comté;70;2;05;572;Vitrey-sur-Mance;284;5;289
27;Bourgogne-Franche-Comté;70;1;10;573;La Voivre;135;1;136
27;Bourgogne-Franche-Comté;70;2;01;574;Volon;59;0;59
27;Bourgogne-Franche-Comté;70;2;12;575;Voray-sur-l'Ognon;834;16;850
27;Bourgogne-Franche-Comté;70;2;05;576;Vougécourt;150;1;151
27;Bourgogne-Franche-Comté;70;1;07;577;Vouhenans;376;9;385
27;Bourgogne-Franche-Comté;70;2;09;578;Vregille;175;2;177
27;Bourgogne-Franche-Comté;70;2;14;580;Vy-le-Ferroux;155;5;160
27;Bourgogne-Franche-Comté;70;2;12;583;Vy-lès-Filain;129;1;130
27;Bourgogne-Franche-Comté;70;1;07;581;Vy-lès-Lure;690;16;706
27;Bourgogne-Franche-Comté;70;2;14;582;Vy-lès-Rupt;82;0;82
27;Bourgogne-Franche-Comté;70;1;04;579;Vyans-le-Val;441;16;457
27;Bourgogne-Franche-Comté;71;4;14;001;L' Abergement-de-Cuisery;797;15;812
27;Bourgogne-Franche-Comté;71;4;24;002;L' Abergement-Sainte-Colombe;1237;20;1257
27;Bourgogne-Franche-Comté;71;2;16;003;Allerey-sur-Saône;799;6;805
27;Bourgogne-Franche-Comté;71;2;24;004;Allériot;1149;25;1174
27;Bourgogne-Franche-Comté;71;2;04;005;Aluze;251;10;261
27;Bourgogne-Franche-Comté;71;3;10;006;Amanzé;180;5;185
27;Bourgogne-Franche-Comté;71;5;11;007;Ameugny;170;4;174
27;Bourgogne-Franche-Comté;71;3;10;008;Anglure-sous-Dun;154;7;161
27;Bourgogne-Franche-Comté;71;1;01;009;Anost;724;14;738
27;Bourgogne-Franche-Comté;71;1;02;010;Antully;858;10;868
27;Bourgogne-Franche-Comté;71;3;25;011;Anzy-le-Duc;456;89;545
27;Bourgogne-Franche-Comté;71;3;25;012;Artaix;329;15;344
27;Bourgogne-Franche-Comté;71;4;26;013;Authumes;262;5;267
27;Bourgogne-Franche-Comté;71;1;96;014;Autun;13157;1042;14199
27;Bourgogne-Franche-Comté;71;1;02;015;Auxy;922;29;951
27;Bourgogne-Franche-Comté;71;5;19;016;Azé;1064;27;1091
27;Bourgogne-Franche-Comté;71;3;09;017;Ballore;94;4;98
27;Bourgogne-Franche-Comté;71;4;14;018;Bantanges;548;11;559
27;Bourgogne-Franche-Comté;71;2;17;019;Barizey;144;7;151
27;Bourgogne-Franche-Comté;71;1;01;020;Barnay;99;2;101
27;Bourgogne-Franche-Comté;71;3;09;021;Baron;292;22;314
27;Bourgogne-Franche-Comté;71;3;10;022;Baudemont;632;9;641
27;Bourgogne-Franche-Comté;71;4;24;023;Baudrières;947;26;973
27;Bourgogne-Franche-Comté;71;3;25;024;Baugy;505;17;522
27;Bourgogne-Franche-Comté;71;3;09;025;Beaubery;363;8;371
27;Bourgogne-Franche-Comté;71;2;29;026;Beaumont-sur-Grosne;342;13;355
27;Bourgogne-Franche-Comté;71;4;26;027;Beaurepaire-en-Bresse;717;7;724
27;Bourgogne-Franche-Comté;71;4;26;028;Beauvernois;108;3;111
27;Bourgogne-Franche-Comté;71;4;26;029;Bellevesvre;290;4;294
27;Bourgogne-Franche-Comté;71;5;11;030;Bergesserin;204;4;208
27;Bourgogne-Franche-Comté;71;5;19;032;Berzé-la-Ville;683;14;697
27;Bourgogne-Franche-Comté;71;5;11;031;Berzé-le-Châtel;59;1;60
27;Bourgogne-Franche-Comté;71;2;16;033;Bey;853;19;872
27;Bourgogne-Franche-Comté;71;2;17;034;Bissey-sous-Cruchaud;338;7;345
27;Bourgogne-Franche-Comté;71;5;19;035;Bissy-la-Mâconnaise;204;3;207
27;Bourgogne-Franche-Comté;71;2;11;036;Bissy-sous-Uxelles;69;0;69
27;Bourgogne-Franche-Comté;71;2;17;037;Bissy-sur-Fley;87;6;93
27;Bourgogne-Franche-Comté;71;1;03;038;Les Bizots;466;13;479
27;Bourgogne-Franche-Comté;71;5;11;039;Blanot;180;1;181
27;Bourgogne-Franche-Comté;71;1;03;040;Blanzy;6097;140;6237
27;Bourgogne-Franche-Comté;71;3;10;041;Bois-Sainte-Marie;193;2;195
27;Bourgogne-Franche-Comté;71;5;11;042;Bonnay;322;7;329
27;Bourgogne-Franche-Comté;71;2;16;043;Les Bordes;83;3;86
27;Bourgogne-Franche-Comté;71;4;26;044;Bosjean;302;6;308
27;Bourgogne-Franche-Comté;71;4;26;045;Bouhans;177;6;183
27;Bourgogne-Franche-Comté;71;1;02;046;La Boulaye;95;0;95
27;Bourgogne-Franche-Comté;71;3;15;047;Bourbon-Lancy;4820;73;4893
27;Bourgogne-Franche-Comté;71;3;25;048;Bourg-le-Comte;178;2;180
27;Bourgogne-Franche-Comté;71;5;08;050;Bourgvilain;335;7;342
27;Bourgogne-Franche-Comté;71;2;04;051;Bouzeron;133;7;140
27;Bourgogne-Franche-Comté;71;2;29;052;Boyer;723;11;734
27;Bourgogne-Franche-Comté;71;2;16;054;Bragny-sur-Saône;659;12;671
27;Bourgogne-Franche-Comté;71;4;20;056;Branges;2359;37;2396
27;Bourgogne-Franche-Comté;71;5;11;057;Bray;123;3;126
27;Bourgogne-Franche-Comté;71;2;29;058;Bresse-sur-Grosne;185;11;196
27;Bourgogne-Franche-Comté;71;1;13;059;Le Breuil;3556;67;3623
27;Bourgogne-Franche-Comté;71;3;10;060;Briant;226;2;228
27;Bourgogne-Franche-Comté;71;4;14;061;Brienne;464;16;480
27;Bourgogne-Franche-Comté;71;1;02;062;Brion;295;8;303
27;Bourgogne-Franche-Comté;71;1;02;063;Broye;759;14;773
27;Bourgogne-Franche-Comté;71;4;20;064;Bruailles;991;25;1016
27;Bourgogne-Franche-Comté;71;5;11;065;Buffières;276;8;284
27;Bourgogne-Franche-Comté;71;5;19;066;Burgy;121;3;124
27;Bourgogne-Franche-Comté;71;2;11;067;Burnand;127;3;130
27;Bourgogne-Franche-Comté;71;5;11;068;Burzy;58;2;60
27;Bourgogne-Franche-Comté;71;5;19;069;Bussières;573;27;600
27;Bourgogne-Franche-Comté;71;2;17;070;Buxy;2132;84;2216
27;Bourgogne-Franche-Comté;71;1;01;509;La Celle-en-Morvan;475;6;481
27;Bourgogne-Franche-Comté;71;3;25;071;Céron;261;8;269
27;Bourgogne-Franche-Comté;71;2;17;072;Cersot;140;2;142
27;Bourgogne-Franche-Comté;71;2;04;073;Chagny;5535;77;5612
27;Bourgogne-Franche-Comté;71;5;08;074;Chaintré;572;19;591
27;Bourgogne-Franche-Comté;71;3;15;075;Chalmoux;632;11;643
27;Bourgogne-Franche-Comté;71;2;97;076;Chalon-sur-Saône;44810;1506;46316
27;Bourgogne-Franche-Comté;71;3;25;077;Chambilly;514;4;518
27;Bourgogne-Franche-Comté;71;2;04;078;Chamilly;155;3;158
27;Bourgogne-Franche-Comté;71;4;14;079;Champagnat;457;11;468
27;Bourgogne-Franche-Comté;71;2;29;080;Champagny-sous-Uxelles;97;0;97
27;Bourgogne-Franche-Comté;71;2;05;081;Champforgeuil;2580;56;2636
27;Bourgogne-Franche-Comté;71;3;09;082;Champlecy;222;3;225
27;Bourgogne-Franche-Comté;71;5;08;084;Chânes;535;11;546
27;Bourgogne-Franche-Comté;71;2;04;085;Change;221;2;223
27;Bourgogne-Franche-Comté;71;3;09;086;Changy;465;9;474
27;Bourgogne-Franche-Comté;71;2;11;087;Chapaize;161;1;162
27;Bourgogne-Franche-Comté;71;3;18;088;La Chapelle-au-Mans;228;11;239
27;Bourgogne-Franche-Comté;71;2;29;089;La Chapelle-de-Bragny;243;2;245
27;Bourgogne-Franche-Comté;71;5;08;090;La Chapelle-de-Guinchay;4158;52;4210
27;Bourgogne-Franche-Comté;71;5;08;091;La Chapelle-du-Mont-de-France;188;2;190
27;Bourgogne-Franche-Comté;71;4;20;092;La Chapelle-Naude;512;13;525
27;Bourgogne-Franche-Comté;71;4;26;093;La Chapelle-Saint-Sauveur;678;19;697
27;Bourgogne-Franche-Comté;71;5;29;094;La Chapelle-sous-Brancion;137;2;139
27;Bourgogne-Franche-Comté;71;3;10;095;La Chapelle-sous-Dun;443;10;453
27;Bourgogne-Franche-Comté;71;1;02;096;La Chapelle-sous-Uchon;193;2;195
27;Bourgogne-Franche-Comté;71;4;14;097;La Chapelle-Thècle;478;12;490
27;Bourgogne-Franche-Comté;71;1;02;098;Charbonnat;249;4;253
27;Bourgogne-Franche-Comté;71;5;19;099;Charbonnières;322;14;336
27;Bourgogne-Franche-Comté;71;5;29;100;Chardonnay;199;0;199
27;Bourgogne-Franche-Comté;71;4;26;101;Charette-Varennes;454;8;462
27;Bourgogne-Franche-Comté;71;2;27;102;La Charmée;691;24;715
27;Bourgogne-Franche-Comté;71;1;02;103;Charmoy;266;6;272
27;Bourgogne-Franche-Comté;71;2;16;104;Charnay-lès-Chalon;190;7;197
27;Bourgogne-Franche-Comté;71;5;21;105;Charnay-lès-Mâcon;7559;305;7864
27;Bourgogne-Franche-Comté;71;3;09;106;Charolles;2810;436;3246
27;Bourgogne-Franche-Comté;71;2;04;107;Charrecey;327;10;337
27;Bourgogne-Franche-Comté;71;5;08;108;Chasselas;172;5;177
27;Bourgogne-Franche-Comté;71;2;04;109;Chassey-le-Camp;348;2;350
27;Bourgogne-Franche-Comté;71;3;10;110;Chassigny-sous-Dun;572;10;582
27;Bourgogne-Franche-Comté;71;3;18;111;Chassy;308;11;319
27;Bourgogne-Franche-Comté;71;5;11;112;Château;223;8;231
27;Bourgogne-Franche-Comté;71;3;10;113;Châteauneuf;104;0;104
27;Bourgogne-Franche-Comté;71;2;17;115;Châtel-Moron;97;4;101
27;Bourgogne-Franche-Comté;71;3;10;116;Châtenay;167;2;169
27;Bourgogne-Franche-Comté;71;2;24;117;Châtenoy-en-Bresse;1103;31;1134
27;Bourgogne-Franche-Comté;71;2;07;118;Châtenoy-le-Royal;6153;142;6295
27;Bourgogne-Franche-Comté;71;2;04;119;Chaudenay;1114;24;1138
27;Bourgogne-Franche-Comté;71;3;10;120;Chauffailles;3700;69;3769
27;Bourgogne-Franche-Comté;71;4;26;121;La Chaux;309;3;312
27;Bourgogne-Franche-Comté;71;2;04;122;Cheilly-lès-Maranges;557;15;572
27;Bourgogne-Franche-Comté;71;3;25;123;Chenay-le-Châtel;376;4;380
27;Bourgogne-Franche-Comté;71;2;17;124;Chenôves;204;7;211
27;Bourgogne-Franche-Comté;71;5;11;125;Chérizet;20;0;20
27;Bourgogne-Franche-Comté;71;5;19;126;Chevagny-les-Chevrières;589;23;612
27;Bourgogne-Franche-Comté;71;5;11;127;Chevagny-sur-Guye;67;5;72
27;Bourgogne-Franche-Comté;71;5;11;128;Chiddes;90;5;95
27;Bourgogne-Franche-Comté;71;1;01;129;Chissey-en-Morvan;272;7;279
27;Bourgogne-Franche-Comté;71;5;11;130;Chissey-lès-Mâcon;233;6;239
27;Bourgogne-Franche-Comté;71;2;16;131;Ciel;767;13;780
27;Bourgogne-Franche-Comté;71;1;28;132;Ciry-le-Noble;2262;30;2292
27;Bourgogne-Franche-Comté;71;3;10;133;La Clayette;1636;58;1694
27;Bourgogne-Franche-Comté;71;5;19;135;Clessé;881;20;901
27;Bourgogne-Franche-Comté;71;3;18;136;Clessy;264;8;272
27;Bourgogne-Franche-Comté;71;5;11;137;Cluny;4880;257;5137
27;Bourgogne-Franche-Comté;71;2;16;578;Clux-Villeneuve;319;11;330
27;Bourgogne-Franche-Comté;71;2;03;139;Collonge-en-Charollais;142;0;142
27;Bourgogne-Franche-Comté;71;1;01;140;Collonge-la-Madeleine;48;0;48
27;Bourgogne-Franche-Comté;71;3;09;141;Colombier-en-Brionnais;308;6;314
27;Bourgogne-Franche-Comté;71;1;02;142;La Comelle;232;4;236
27;Bourgogne-Franche-Comté;71;4;14;143;Condal;450;8;458
27;Bourgogne-Franche-Comté;71;1;01;144;Cordesse;190;5;195
27;Bourgogne-Franche-Comté;71;2;11;145;Cormatin;562;5;567
27;Bourgogne-Franche-Comté;71;5;11;146;Cortambert;232;7;239
27;Bourgogne-Franche-Comté;71;5;11;147;Cortevaix;252;6;258
27;Bourgogne-Franche-Comté;71;3;10;148;Coublanc;838;17;855
27;Bourgogne-Franche-Comté;71;1;04;149;Couches;1336;29;1365
27;Bourgogne-Franche-Comté;71;5;08;150;Crêches-sur-Saône;3037;85;3122
27;Bourgogne-Franche-Comté;71;1;01;151;Créot;80;4;84
27;Bourgogne-Franche-Comté;71;3;18;152;Cressy-sur-Somme;184;9;193
27;Bourgogne-Franche-Comté;71;1;98;153;Le Creusot;21491;296;21787
27;Bourgogne-Franche-Comté;71;2;05;154;Crissey;2475;62;2537
27;Bourgogne-Franche-Comté;71;3;15;155;Cronat;522;16;538
27;Bourgogne-Franche-Comté;71;5;19;156;Cruzille;263;65;328
27;Bourgogne-Franche-Comté;71;4;14;157;Cuiseaux;1841;31;1872
27;Bourgogne-Franche-Comté;71;4;14;158;Cuisery;1555;38;1593
27;Bourgogne-Franche-Comté;71;2;17;159;Culles-les-Roches;200;8;208
27;Bourgogne-Franche-Comté;71;3;10;160;Curbigny;315;9;324
27;Bourgogne-Franche-Comté;71;3;18;161;Curdin;314;6;320
27;Bourgogne-Franche-Comté;71;1;01;162;Curgy;1148;43;1191
27;Bourgogne-Franche-Comté;71;5;11;163;Curtil-sous-Buffières;90;1;91
27;Bourgogne-Franche-Comté;71;2;11;164;Curtil-sous-Burnand;131;3;134
27;Bourgogne-Franche-Comté;71;1;01;165;Cussy-en-Morvan;383;8;391
27;Bourgogne-Franche-Comté;71;3;18;166;Cuzy;116;4;120
27;Bourgogne-Franche-Comté;71;2;16;167;Damerey;555;20;575
27;Bourgogne-Franche-Comté;71;4;26;168;Dampierre-en-Bresse;172;1;173
27;Bourgogne-Franche-Comté;71;5;08;169;Davayé;697;107;804
27;Bourgogne-Franche-Comté;71;2;16;170;Demigny;1803;40;1843
27;Bourgogne-Franche-Comté;71;2;04;171;Dennevy;305;9;314
27;Bourgogne-Franche-Comté;71;1;02;172;Dettey;83;1;84
27;Bourgogne-Franche-Comté;71;4;26;173;Devrouze;310;4;314
27;Bourgogne-Franche-Comté;71;2;04;174;Dezize-lès-Maranges;173;4;177
27;Bourgogne-Franche-Comté;71;4;26;175;Diconne;340;4;344
27;Bourgogne-Franche-Comté;71;3;15;176;Digoin;7777;247;8024
27;Bourgogne-Franche-Comté;71;4;14;177;Dommartin-lès-Cuiseaux;798;12;810
27;Bourgogne-Franche-Comté;71;5;08;178;Dompierre-les-Ormes;898;31;929
27;Bourgogne-Franche-Comté;71;3;18;179;Dompierre-sous-Sanvignes;80;1;81
27;Bourgogne-Franche-Comté;71;5;11;181;Donzy-le-Pertuis;167;4;171
27;Bourgogne-Franche-Comté;71;2;17;182;Dracy-le-Fort;1395;52;1447
27;Bourgogne-Franche-Comté;71;1;04;183;Dracy-lès-Couches;155;3;158
27;Bourgogne-Franche-Comté;71;1;01;184;Dracy-Saint-Loup;587;9;596
27;Bourgogne-Franche-Comté;71;3;09;185;Dyo;337;14;351
27;Bourgogne-Franche-Comté;71;2;16;186;Écuelles;268;5;273
27;Bourgogne-Franche-Comté;71;1;03;187;Écuisses;1581;34;1615
27;Bourgogne-Franche-Comté;71;1;01;188;Épertully;61;1;62
27;Bourgogne-Franche-Comté;71;2;27;189;Épervans;1619;52;1671
27;Bourgogne-Franche-Comté;71;1;01;190;Épinac;2182;30;2212
27;Bourgogne-Franche-Comté;71;1;04;191;Essertenne;475;10;485
27;Bourgogne-Franche-Comté;71;1;02;192;Étang-sur-Arroux;1835;149;1984
27;Bourgogne-Franche-Comté;71;2;29;193;Étrigny;473;11;484
27;Bourgogne-Franche-Comté;71;2;05;194;Farges-lès-Chalon;786;15;801
27;Bourgogne-Franche-Comté;71;5;29;195;Farges-lès-Mâcon;221;1;222
27;Bourgogne-Franche-Comté;71;4;20;196;Le Fay;638;8;646
27;Bourgogne-Franche-Comté;71;4;14;198;Flacey-en-Bresse;405;7;412
27;Bourgogne-Franche-Comté;71;5;11;199;Flagy;172;8;180
27;Bourgogne-Franche-Comté;71;5;19;591;Fleurville;520;8;528
27;Bourgogne-Franche-Comté;71;3;10;200;Fleury-la-Montagne;696;17;713
27;Bourgogne-Franche-Comté;71;2;17;201;Fley;201;7;208
27;Bourgogne-Franche-Comté;71;2;04;202;Fontaines;1902;367;2269
27;Bourgogne-Franche-Comté;71;3;09;203;Fontenay;48;1;49
27;Bourgogne-Franche-Comté;71;2;05;204;Fragnes-La Loyère;1499;42;1541
27;Bourgogne-Franche-Comté;71;4;26;205;Frangy-en-Bresse;636;9;645
27;Bourgogne-Franche-Comté;71;4;14;206;La Frette;242;4;246
27;Bourgogne-Franche-Comté;71;4;26;207;Fretterans;288;11;299
27;Bourgogne-Franche-Comté;71;4;26;208;Frontenard;217;4;221
27;Bourgogne-Franche-Comté;71;4;14;209;Frontenaud;729;14;743
27;Bourgogne-Franche-Comté;71;5;08;210;Fuissé;377;19;396
27;Bourgogne-Franche-Comté;71;1;28;212;Génelard;1380;33;1413
27;Bourgogne-Franche-Comté;71;4;14;213;La Genête;571;17;588
27;Bourgogne-Franche-Comté;71;2;03;214;Genouilly;423;11;434
27;Bourgogne-Franche-Comté;71;2;16;215;Gergy;2563;71;2634
27;Bourgogne-Franche-Comté;71;2;17;216;Germagny;200;5;205
27;Bourgogne-Franche-Comté;71;5;08;217;Germolles-sur-Grosne;126;5;131
27;Bourgogne-Franche-Comté;71;3;10;218;Gibles;586;21;607
27;Bourgogne-Franche-Comté;71;2;29;219;Gigny-sur-Saône;551;15;566
27;Bourgogne-Franche-Comté;71;3;15;220;Gilly-sur-Loire;478;3;481
27;Bourgogne-Franche-Comté;71;2;17;221;Givry;3695;160;3855
27;Bourgogne-Franche-Comté;71;1;03;222;Gourdon;895;26;921
27;Bourgogne-Franche-Comté;71;1;02;223;La Grande-Verrière;565;8;573
27;Bourgogne-Franche-Comté;71;3;09;224;Grandvaux;79;6;85
27;Bourgogne-Franche-Comté;71;2;17;225;Granges;521;13;534
27;Bourgogne-Franche-Comté;71;5;29;226;Grevilly;32;0;32
27;Bourgogne-Franche-Comté;71;3;18;227;Grury;524;8;532
27;Bourgogne-Franche-Comté;71;2;24;228;Guerfand;207;0;207
27;Bourgogne-Franche-Comté;71;3;15;229;Les Guerreaux;235;1;236
27;Bourgogne-Franche-Comté;71;3;18;230;Gueugnon;6948;195;7143
27;Bourgogne-Franche-Comté;71;5;11;231;La Guiche;624;11;635
27;Bourgogne-Franche-Comté;71;3;25;232;Hautefond;203;14;217
27;Bourgogne-Franche-Comté;71;3;25;233;L' Hôpital-le-Mercier;304;7;311
27;Bourgogne-Franche-Comté;71;4;14;234;Huilly-sur-Seille;339;6;345
27;Bourgogne-Franche-Comté;71;5;19;235;Hurigny;1968;107;2075
27;Bourgogne-Franche-Comté;71;5;19;236;Igé;875;21;896
27;Bourgogne-Franche-Comté;71;1;01;237;Igornay;530;7;537
27;Bourgogne-Franche-Comté;71;3;10;238;Iguerande;993;18;1011
27;Bourgogne-Franche-Comté;71;3;18;239;Issy-l'Évêque;703;11;714
27;Bourgogne-Franche-Comté;71;5;11;240;Jalogny;371;14;385
27;Bourgogne-Franche-Comté;71;2;17;241;Jambles;491;18;509
27;Bourgogne-Franche-Comté;71;5;03;242;Joncy;526;11;537
27;Bourgogne-Franche-Comté;71;4;14;243;Joudes;374;4;378
27;Bourgogne-Franche-Comté;71;4;14;244;Jouvençon;433;2;435
27;Bourgogne-Franche-Comté;71;2;29;245;Jugy;318;6;324
27;Bourgogne-Franche-Comté;71;4;20;246;Juif;254;3;257
27;Bourgogne-Franche-Comté;71;2;17;247;Jully-lès-Buxy;343;10;353
27;Bourgogne-Franche-Comté;71;5;29;248;Lacrost;720;20;740
27;Bourgogne-Franche-Comté;71;2;29;249;Laives;1005;38;1043
27;Bourgogne-Franche-Comté;71;5;19;250;Laizé;1085;48;1133
27;Bourgogne-Franche-Comté;71;1;02;251;Laizy;585;13;598
27;Bourgogne-Franche-Comté;71;2;29;252;Lalheue;382;14;396
27;Bourgogne-Franche-Comté;71;2;24;253;Lans;925;25;950
27;Bourgogne-Franche-Comté;71;4;26;254;Lays-sur-le-Doubs;147;1;148
27;Bourgogne-Franche-Comté;71;3;15;255;Lesme;183;2;185
27;Bourgogne-Franche-Comté;71;4;24;256;Lessard-en-Bresse;539;12;551
27;Bourgogne-Franche-Comté;71;2;16;257;Lessard-le-National;649;12;661
27;Bourgogne-Franche-Comté;71;5;08;258;Leynes;511;15;526
27;Bourgogne-Franche-Comté;71;3;10;259;Ligny-en-Brionnais;352;7;359
27;Bourgogne-Franche-Comté;71;4;14;261;Loisy;656;16;672
27;Bourgogne-Franche-Comté;71;2;16;262;Longepierre;163;4;167
27;Bourgogne-Franche-Comté;71;4;20;263;Louhans;6399;214;6613
27;Bourgogne-Franche-Comté;71;5;11;264;Lournand;328;9;337
27;Bourgogne-Franche-Comté;71;1;01;266;Lucenay-l'Évêque;316;3;319
27;Bourgogne-Franche-Comté;71;5;19;267;Lugny;863;84;947
27;Bourgogne-Franche-Comté;71;3;09;268;Lugny-lès-Charolles;349;10;359
27;Bourgogne-Franche-Comté;71;2;27;269;Lux;2048;33;2081
27;Bourgogne-Franche-Comté;71;5;99;270;Mâcon;33810;751;34561
27;Bourgogne-Franche-Comté;71;3;10;271;Mailly;152;6;158
27;Bourgogne-Franche-Comté;71;2;11;272;Malay;204;9;213
27;Bourgogne-Franche-Comté;71;3;15;273;Maltat;283;6;289
27;Bourgogne-Franche-Comté;71;2;29;274;Mancey;387;10;397
27;Bourgogne-Franche-Comté;71;3;25;275;Marcigny;1754;31;1785
27;Bourgogne-Franche-Comté;71;3;09;276;Marcilly-la-Gueurce;122;5;127
27;Bourgogne-Franche-Comté;71;2;17;277;Marcilly-lès-Buxy;678;19;697
27;Bourgogne-Franche-Comté;71;1;03;278;Marigny;155;5;160
27;Bourgogne-Franche-Comté;71;3;18;280;Marly-sous-Issy;88;2;90
27;Bourgogne-Franche-Comté;71;3;18;281;Marly-sur-Arroux;315;14;329
27;Bourgogne-Franche-Comté;71;1;02;282;Marmagne;1241;33;1274
27;Bourgogne-Franche-Comté;71;2;27;283;Marnay;548;7;555
27;Bourgogne-Franche-Comté;71;5;29;284;Martailly-lès-Brancion;142;7;149
27;Bourgogne-Franche-Comté;71;3;09;285;Martigny-le-Comte;414;6;420
27;Bourgogne-Franche-Comté;71;1;03;286;Mary;254;4;258
27;Bourgogne-Franche-Comté;71;5;11;287;Massilly;342;6;348
27;Bourgogne-Franche-Comté;71;5;08;289;Matour;1123;22;1145
27;Bourgogne-Franche-Comté;71;5;11;290;Mazille;380;68;448
27;Bourgogne-Franche-Comté;71;3;25;291;Melay;980;24;1004
27;Bourgogne-Franche-Comté;71;2;17;292;Mellecey;1311;45;1356
27;Bourgogne-Franche-Comté;71;4;14;293;Ménetreuil;409;10;419
27;Bourgogne-Franche-Comté;71;2;17;294;Mercurey;1213;170;1383
27;Bourgogne-Franche-Comté;71;4;26;295;Mervans;1499;25;1524
27;Bourgogne-Franche-Comté;71;2;17;296;Messey-sur-Grosne;752;19;771
27;Bourgogne-Franche-Comté;71;1;02;297;Mesvres;757;22;779
27;Bourgogne-Franche-Comté;71;5;19;299;Milly-Lamartine;322;7;329
27;Bourgogne-Franche-Comté;71;4;14;300;Le Miroir;614;8;622
27;Bourgogne-Franche-Comté;71;3;15;301;Mont;174;2;176
27;Bourgogne-Franche-Comté;71;2;16;315;Mont-lès-Seurre;183;2;185
27;Bourgogne-Franche-Comté;71;1;03;320;Mont-Saint-Vincent;321;3;324
27;Bourgogne-Franche-Comté;71;2;17;302;Montagny-lès-Buxy;216;9;225
27;Bourgogne-Franche-Comté;71;4;20;303;Montagny-près-Louhans;470;6;476
27;Bourgogne-Franche-Comté;71;5;19;305;Montbellet;816;14;830
27;Bourgogne-Franche-Comté;71;1;23;306;Montceau-les-Mines;17897;321;18218
27;Bourgogne-Franche-Comté;71;3;25;307;Montceaux-l'Étoile;290;7;297
27;Bourgogne-Franche-Comté;71;2;29;308;Montceaux-Ragny;31;1;32
27;Bourgogne-Franche-Comté;71;1;12;309;Montcenis;2009;62;2071
27;Bourgogne-Franche-Comté;71;1;03;310;Montchanin;4963;88;5051
27;Bourgogne-Franche-Comté;71;4;20;311;Montcony;261;5;266
27;Bourgogne-Franche-Comté;71;2;24;312;Montcoy;253;1;254
27;Bourgogne-Franche-Comté;71;1;01;313;Monthelon;383;15;398
27;Bourgogne-Franche-Comté;71;4;26;314;Montjay;204;0;204
27;Bourgogne-Franche-Comté;71;5;08;316;Montmelard;364;6;370
27;Bourgogne-Franche-Comté;71;3;18;317;Montmort;180;3;183
27;Bourgogne-Franche-Comté;71;4;14;318;Montpont-en-Bresse;1097;20;1117
27;Bourgogne-Franche-Comté;71;4;20;319;Montret;790;16;806
27;Bourgogne-Franche-Comté;71;1;04;321;Morey;195;4;199
27;Bourgogne-Franche-Comté;71;1;01;322;Morlet;54;1;55
27;Bourgogne-Franche-Comté;71;3;09;323;Mornay;136;0;136
27;Bourgogne-Franche-Comté;71;2;17;324;Moroges;574;23;597
27;Bourgogne-Franche-Comté;71;3;15;325;La Motte-Saint-Jean;1211;33;1244
27;Bourgogne-Franche-Comté;71;4;26;326;Mouthier-en-Bresse;424;7;431
27;Bourgogne-Franche-Comté;71;3;10;327;Mussy-sous-Dun;349;8;357
27;Bourgogne-Franche-Comté;71;2;29;328;Nanton;635;12;647
27;Bourgogne-Franche-Comté;71;2;16;329;Navilly;417;9;426
27;Bourgogne-Franche-Comté;71;5;08;134;Navour-sur-Grosne ;660;21;681
27;Bourgogne-Franche-Comté;71;3;18;330;Neuvy-Grandchamp;758;15;773
27;Bourgogne-Franche-Comté;71;3;25;331;Nochize;115;1;116
27;Bourgogne-Franche-Comté;71;4;14;332;Ormes;473;5;478
27;Bourgogne-Franche-Comté;71;2;24;333;Oslon;1224;39;1263
27;Bourgogne-Franche-Comté;71;3;09;334;Oudry;385;9;394
27;Bourgogne-Franche-Comté;71;3;09;335;Ouroux-sous-le-Bois-Sainte-Marie;67;0;67
27;Bourgogne-Franche-Comté;71;4;24;336;Ouroux-sur-Saône;3073;79;3152
27;Bourgogne-Franche-Comté;71;3;10;337;Oyé;301;8;309
27;Bourgogne-Franche-Comté;71;5;29;338;Ozenay;217;2;219
27;Bourgogne-Franche-Comté;71;3;09;339;Ozolles;404;8;412
27;Bourgogne-Franche-Comté;71;3;09;340;Palinges;1513;26;1539
27;Bourgogne-Franche-Comté;71;2;16;341;Palleau;249;2;251
27;Bourgogne-Franche-Comté;71;3;25;342;Paray-le-Monial;9209;428;9637
27;Bourgogne-Franche-Comté;71;2;04;343;Paris-l'Hôpital;310;4;314
27;Bourgogne-Franche-Comté;71;5;11;344;Passy;64;2;66
27;Bourgogne-Franche-Comté;71;5;19;345;Péronne;661;11;672
27;Bourgogne-Franche-Comté;71;1;28;346;Perrecy-les-Forges;1597;26;1623
27;Bourgogne-Franche-Comté;71;1;04;347;Perreuil;551;15;566
27;Bourgogne-Franche-Comté;71;3;15;348;Perrigny-sur-Loire;133;3;136
27;Bourgogne-Franche-Comté;71;1;01;349;La Petite-Verrière;52;1;53
27;Bourgogne-Franche-Comté;71;4;26;351;Pierre-de-Bresse;1940;31;1971
27;Bourgogne-Franche-Comté;71;5;08;350;Pierreclos;890;31;921
27;Bourgogne-Franche-Comté;71;4;26;352;Le Planois;90;3;93
27;Bourgogne-Franche-Comté;71;5;29;353;Plottes;529;7;536
27;Bourgogne-Franche-Comté;71;3;25;354;Poisson;569;22;591
27;Bourgogne-Franche-Comté;71;2;16;355;Pontoux;279;7;286
27;Bourgogne-Franche-Comté;71;1;09;356;Pouilloux;982;17;999
27;Bourgogne-Franche-Comté;71;4;26;357;Pourlans;215;0;215
27;Bourgogne-Franche-Comté;71;5;11;358;Pressy-sous-Dondin;101;3;104
27;Bourgogne-Franche-Comté;71;5;29;359;Préty;558;10;568
27;Bourgogne-Franche-Comté;71;5;19;360;Prissé;1952;47;1999
27;Bourgogne-Franche-Comté;71;3;09;361;Prizy;60;5;65
27;Bourgogne-Franche-Comté;71;5;08;362;Pruzilly;338;5;343
27;Bourgogne-Franche-Comté;71;2;03;363;Le Puley;92;5;97
27;Bourgogne-Franche-Comté;71;4;26;364;La Racineuse;175;1;176
27;Bourgogne-Franche-Comté;71;4;14;365;Rancy;577;8;585
27;Bourgogne-Franche-Comté;71;4;14;366;Ratenelle;384;8;392
27;Bourgogne-Franche-Comté;71;4;20;367;Ratte;364;5;369
27;Bourgogne-Franche-Comté;71;1;01;368;Reclesne;312;16;328
27;Bourgogne-Franche-Comté;71;2;04;369;Remigny;430;7;437
27;Bourgogne-Franche-Comté;71;3;18;370;Rigny-sur-Arroux;634;11;645
27;Bourgogne-Franche-Comté;71;5;19;371;La Roche-Vineuse;1557;40;1597
27;Bourgogne-Franche-Comté;71;5;08;372;Romanèche-Thorins;2010;32;2042
27;Bourgogne-Franche-Comté;71;4;14;373;Romenay;1687;21;1708
27;Bourgogne-Franche-Comté;71;2;17;374;Rosey;164;2;166
27;Bourgogne-Franche-Comté;71;3;09;279;Le Rousset-Marizy;634;19;653
27;Bourgogne-Franche-Comté;71;1;01;376;Roussillon-en-Morvan;273;8;281
27;Bourgogne-Franche-Comté;71;5;29;377;Royer;130;2;132
27;Bourgogne-Franche-Comté;71;2;04;378;Rully;1551;35;1586
27;Bourgogne-Franche-Comté;71;4;20;379;Sagy;1229;20;1249
27;Bourgogne-Franche-Comté;71;4;26;380;Saillenard;789;17;806
27;Bourgogne-Franche-Comté;71;5;11;381;Sailly;79;0;79
27;Bourgogne-Franche-Comté;71;3;15;382;Saint-Agnan;701;15;716
27;Bourgogne-Franche-Comté;71;5;19;383;Saint-Albain;523;5;528
27;Bourgogne-Franche-Comté;71;2;29;384;Saint-Ambreuil;505;8;513
27;Bourgogne-Franche-Comté;71;5;08;385;Saint-Amour-Bellevue;567;20;587
27;Bourgogne-Franche-Comté;71;4;20;386;Saint-André-en-Bresse;96;0;96
27;Bourgogne-Franche-Comté;71;5;11;387;Saint-André-le-Désert;250;9;259
27;Bourgogne-Franche-Comté;71;3;09;388;Saint-Aubin-en-Charollais;469;20;489
27;Bourgogne-Franche-Comté;71;3;15;389;Saint-Aubin-sur-Loire;284;5;289
27;Bourgogne-Franche-Comté;71;1;23;390;Saint-Berain-sous-Sanvignes;1088;22;1110
27;Bourgogne-Franche-Comté;71;2;04;391;Saint-Bérain-sur-Dheune;556;17;573
27;Bourgogne-Franche-Comté;71;2;17;392;Saint-Boil;492;9;501
27;Bourgogne-Franche-Comté;71;3;10;393;Saint-Bonnet-de-Cray;488;17;505
27;Bourgogne-Franche-Comté;71;3;09;394;Saint-Bonnet-de-Joux;764;21;785
27;Bourgogne-Franche-Comté;71;3;09;395;Saint-Bonnet-de-Vieille-Vigne;205;2;207
27;Bourgogne-Franche-Comté;71;4;26;396;Saint-Bonnet-en-Bresse;488;4;492
27;Bourgogne-Franche-Comté;71;4;24;398;Saint-Christophe-en-Bresse;1066;31;1097
27;Bourgogne-Franche-Comté;71;3;10;399;Saint-Christophe-en-Brionnais;525;15;540
27;Bourgogne-Franche-Comté;71;5;11;400;Saint-Clément-sur-Guye;131;4;135
27;Bourgogne-Franche-Comté;71;2;29;402;Saint-Cyr;739;25;764
27;Bourgogne-Franche-Comté;71;2;17;403;Saint-Denis-de-Vaux;261;10;271
27;Bourgogne-Franche-Comté;71;2;17;404;Saint-Désert;889;22;911
27;Bourgogne-Franche-Comté;71;2;16;405;Saint-Didier-en-Bresse;193;1;194
27;Bourgogne-Franche-Comté;71;3;10;406;Saint-Didier-en-Brionnais;130;10;140
27;Bourgogne-Franche-Comté;71;1;02;407;Saint-Didier-sur-Arroux;226;4;230
27;Bourgogne-Franche-Comté;71;3;10;408;Saint-Edmond;420;9;429
27;Bourgogne-Franche-Comté;71;1;02;409;Saint-Émiland;327;9;336
27;Bourgogne-Franche-Comté;71;4;20;410;Saint-Étienne-en-Bresse;790;15;805
27;Bourgogne-Franche-Comté;71;1;02;411;Saint-Eugène;156;8;164
27;Bourgogne-Franche-Comté;71;1;03;412;Saint-Eusèbe;1196;24;1220
27;Bourgogne-Franche-Comté;71;1;13;413;Saint-Firmin;861;11;872
27;Bourgogne-Franche-Comté;71;1;01;414;Saint-Forgeot;456;17;473
27;Bourgogne-Franche-Comté;71;5;19;416;Saint-Gengoux-de-Scissé;600;6;606
27;Bourgogne-Franche-Comté;71;2;11;417;Saint-Gengoux-le-National;1049;7;1056
27;Bourgogne-Franche-Comté;71;4;26;419;Saint-Germain-du-Bois;1888;42;1930
27;Bourgogne-Franche-Comté;71;4;24;420;Saint-Germain-du-Plain;2300;50;2350
27;Bourgogne-Franche-Comté;71;3;09;421;Saint-Germain-en-Brionnais;189;7;196
27;Bourgogne-Franche-Comté;71;2;17;422;Saint-Germain-lès-Buxy;267;9;276
27;Bourgogne-Franche-Comté;71;2;16;423;Saint-Gervais-en-Vallière;436;5;441
27;Bourgogne-Franche-Comté;71;1;01;424;Saint-Gervais-sur-Couches;206;3;209
27;Bourgogne-Franche-Comté;71;2;04;425;Saint-Gilles;277;11;288
27;Bourgogne-Franche-Comté;71;5;11;427;Saint-Huruge;52;1;53
27;Bourgogne-Franche-Comté;71;3;10;428;Saint-Igny-de-Roche;763;26;789
27;Bourgogne-Franche-Comté;71;1;04;431;Saint-Jean-de-Trézy;374;13;387
27;Bourgogne-Franche-Comté;71;2;17;430;Saint-Jean-de-Vaux;401;16;417
27;Bourgogne-Franche-Comté;71;3;09;433;Saint-Julien-de-Civry;489;14;503
27;Bourgogne-Franche-Comté;71;3;10;434;Saint-Julien-de-Jonzy;346;7;353
27;Bourgogne-Franche-Comté;71;1;03;435;Saint-Julien-sur-Dheune;244;9;253
27;Bourgogne-Franche-Comté;71;1;03;436;Saint-Laurent-d'Andenay;1012;20;1032
27;Bourgogne-Franche-Comté;71;3;10;437;Saint-Laurent-en-Brionnais;325;11;336
27;Bourgogne-Franche-Comté;71;1;01;438;Saint-Léger-du-Bois;533;19;552
27;Bourgogne-Franche-Comté;71;3;25;439;Saint-Léger-lès-Paray;740;19;759
27;Bourgogne-Franche-Comté;71;1;02;440;Saint-Léger-sous-Beuvray;375;9;384
27;Bourgogne-Franche-Comté;71;5;08;441;Saint-Léger-sous-la-Bussière;275;4;279
27;Bourgogne-Franche-Comté;71;2;04;442;Saint-Léger-sur-Dheune;1567;21;1588
27;Bourgogne-Franche-Comté;71;2;27;444;Saint-Loup-de-Varennes;1179;30;1209
27;Bourgogne-Franche-Comté;71;2;16;443;Saint-Loup-Géanges;1636;57;1693
27;Bourgogne-Franche-Comté;71;2;27;445;Saint-Marcel;6113;177;6290
27;Bourgogne-Franche-Comté;71;5;11;446;Saint-Marcelin-de-Cray;187;6;193
27;Bourgogne-Franche-Comté;71;2;17;447;Saint-Mard-de-Vaux;273;14;287
27;Bourgogne-Franche-Comté;71;5;19;448;Saint-Martin-Belle-Roche;1390;33;1423
27;Bourgogne-Franche-Comté;71;2;17;449;Saint-Martin-d'Auxy;118;6;124
27;Bourgogne-Franche-Comté;71;1;02;450;Saint-Martin-de-Commune;103;6;109
27;Bourgogne-Franche-Comté;71;3;10;451;Saint-Martin-de-Lixy;94;0;94
27;Bourgogne-Franche-Comté;71;5;11;452;Saint-Martin-de-Salencey;98;1;99
27;Bourgogne-Franche-Comté;71;3;25;453;Saint-Martin-du-Lac;242;11;253
27;Bourgogne-Franche-Comté;71;4;20;454;Saint-Martin-du-Mont;195;8;203
27;Bourgogne-Franche-Comté;71;2;17;455;Saint-Martin-du-Tartre;159;4;163
27;Bourgogne-Franche-Comté;71;2;24;456;Saint-Martin-en-Bresse;1916;73;1989
27;Bourgogne-Franche-Comté;71;2;16;457;Saint-Martin-en-Gâtinois;122;2;124
27;Bourgogne-Franche-Comté;71;5;03;458;Saint-Martin-la-Patrouille;61;0;61
27;Bourgogne-Franche-Comté;71;2;17;459;Saint-Martin-sous-Montaigu;344;17;361
27;Bourgogne-Franche-Comté;71;5;19;460;Saint-Maurice-de-Satonnay;477;23;500
27;Bourgogne-Franche-Comté;71;2;17;461;Saint-Maurice-des-Champs;62;1;63
27;Bourgogne-Franche-Comté;71;2;16;462;Saint-Maurice-en-Rivière;537;11;548
27;Bourgogne-Franche-Comté;71;3;10;463;Saint-Maurice-lès-Châteauneuf;568;12;580
27;Bourgogne-Franche-Comté;71;1;04;464;Saint-Maurice-lès-Couches;188;4;192
27;Bourgogne-Franche-Comté;71;1;03;465;Saint-Micaud;273;9;282
27;Bourgogne-Franche-Comté;71;1;02;466;Saint-Nizier-sur-Arroux;123;4;127
27;Bourgogne-Franche-Comté;71;1;13;468;Saint-Pierre-de-Varennes;850;16;866
27;Bourgogne-Franche-Comté;71;5;08;469;Saint-Pierre-le-Vieux;361;10;371
27;Bourgogne-Franche-Comté;71;5;08;470;Saint-Point;338;14;352
27;Bourgogne-Franche-Comté;71;2;17;471;Saint-Privé;90;1;91
27;Bourgogne-Franche-Comté;71;1;02;472;Saint-Prix;213;8;221
27;Bourgogne-Franche-Comté;71;3;10;473;Saint-Racho;161;1;162
27;Bourgogne-Franche-Comté;71;2;27;475;Saint-Rémy;6617;156;6773
27;Bourgogne-Franche-Comté;71;1;09;477;Saint-Romain-sous-Gourdon;485;9;494
27;Bourgogne-Franche-Comté;71;3;18;478;Saint-Romain-sous-Versigny;86;2;88
27;Bourgogne-Franche-Comté;71;1;13;479;Saint-Sernin-du-Bois;1775;36;1811
27;Bourgogne-Franche-Comté;71;2;04;480;Saint-Sernin-du-Plain;588;13;601
27;Bourgogne-Franche-Comté;71;5;08;481;Saint-Symphorien-d'Ancelles;1168;21;1189
27;Bourgogne-Franche-Comté;71;1;02;482;Saint-Symphorien-de-Marmagne;841;11;852
27;Bourgogne-Franche-Comté;71;3;10;483;Saint-Symphorien-des-Bois;432;12;444
27;Bourgogne-Franche-Comté;71;4;20;484;Saint-Usuge;1308;29;1337
27;Bourgogne-Franche-Comté;71;2;17;485;Saint-Vallerin;261;13;274
27;Bourgogne-Franche-Comté;71;1;28;486;Saint-Vallier;8616;172;8788
27;Bourgogne-Franche-Comté;71;5;08;487;Saint-Vérand;164;3;167
27;Bourgogne-Franche-Comté;71;3;09;490;Saint-Vincent-Bragny;1008;17;1025
27;Bourgogne-Franche-Comté;71;5;11;488;Saint-Vincent-des-Prés;106;3;109
27;Bourgogne-Franche-Comté;71;4;20;489;Saint-Vincent-en-Bresse;571;9;580
27;Bourgogne-Franche-Comté;71;3;25;491;Saint-Yan;1159;24;1183
27;Bourgogne-Franche-Comté;71;5;11;492;Saint-Ythaire;126;2;128
27;Bourgogne-Franche-Comté;71;5;11;397;Sainte-Cécile;286;8;294
27;Bourgogne-Franche-Comté;71;4;14;401;Sainte-Croix;630;13;643
27;Bourgogne-Franche-Comté;71;3;10;415;Sainte-Foy;138;2;140
27;Bourgogne-Franche-Comté;71;2;17;426;Sainte-Hélène;529;11;540
27;Bourgogne-Franche-Comté;71;3;18;474;Sainte-Radegonde;150;2;152
27;Bourgogne-Franche-Comté;71;1;01;493;Saisy;338;7;345
27;Bourgogne-Franche-Comté;71;5;19;494;La Salle;535;14;549
27;Bourgogne-Franche-Comté;71;5;11;495;Salornay-sur-Guye;872;12;884
27;Bourgogne-Franche-Comté;71;2;04;496;Sampigny-lès-Maranges;145;10;155
27;Bourgogne-Franche-Comté;71;5;21;497;Sancé;2134;53;2187
27;Bourgogne-Franche-Comté;71;2;17;498;Santilly;133;6;139
27;Bourgogne-Franche-Comté;71;1;28;499;Sanvignes-les-Mines;4311;81;4392
27;Bourgogne-Franche-Comté;71;3;10;500;Sarry;95;3;98
27;Bourgogne-Franche-Comté;71;2;17;501;Sassangy;145;3;148
27;Bourgogne-Franche-Comté;71;2;16;502;Sassenay;1582;45;1627
27;Bourgogne-Franche-Comté;71;2;17;503;Saules;128;3;131
27;Bourgogne-Franche-Comté;71;2;16;504;Saunières;80;2;82
27;Bourgogne-Franche-Comté;71;2;17;505;Savianges;75;1;76
27;Bourgogne-Franche-Comté;71;4;26;506;Savigny-en-Revermont;1142;17;1159
27;Bourgogne-Franche-Comté;71;2;11;507;Savigny-sur-Grosne;169;1;170
27;Bourgogne-Franche-Comté;71;4;14;508;Savigny-sur-Seille;414;9;423
27;Bourgogne-Franche-Comté;71;3;10;510;Semur-en-Brionnais;607;19;626
27;Bourgogne-Franche-Comté;71;2;29;512;Sennecey-le-Grand;3080;70;3150
27;Bourgogne-Franche-Comté;71;5;19;513;Senozan;1126;36;1162
27;Bourgogne-Franche-Comté;71;4;26;514;Sens-sur-Seille;417;5;422
27;Bourgogne-Franche-Comté;71;2;17;515;Sercy;99;3;102
27;Bourgogne-Franche-Comté;71;4;26;516;Serley;607;7;614
27;Bourgogne-Franche-Comté;71;2;16;517;Sermesse;234;3;237
27;Bourgogne-Franche-Comté;71;5;08;518;Serrières;276;9;285
27;Bourgogne-Franche-Comté;71;4;26;519;Serrigny-en-Bresse;194;4;198
27;Bourgogne-Franche-Comté;71;2;27;520;Sevrey;1285;25;1310
27;Bourgogne-Franche-Comté;71;5;11;521;Sigy-le-Châtel;104;2;106
27;Bourgogne-Franche-Comté;71;4;14;522;Simandre;1739;19;1758
27;Bourgogne-Franche-Comté;71;4;20;523;Simard;1189;12;1201
27;Bourgogne-Franche-Comté;71;5;11;524;Sivignon;169;7;176
27;Bourgogne-Franche-Comté;71;5;19;525;Sologny;584;11;595
27;Bourgogne-Franche-Comté;71;5;08;526;Solutré-Pouilly;358;7;365
27;Bourgogne-Franche-Comté;71;1;01;527;Sommant;210;4;214
27;Bourgogne-Franche-Comté;71;4;20;528;Sornay;2012;45;2057
27;Bourgogne-Franche-Comté;71;3;09;529;Suin;261;7;268
27;Bourgogne-Franche-Comté;71;1;01;530;Sully;491;14;505
27;Bourgogne-Franche-Comté;71;1;02;531;La Tagnière;222;1;223
27;Bourgogne-Franche-Comté;71;5;11;532;Taizé;186;3;189
27;Bourgogne-Franche-Comté;71;3;10;533;Tancon;535;18;553
27;Bourgogne-Franche-Comté;71;4;26;534;Le Tartre;114;5;119
27;Bourgogne-Franche-Comté;71;1;01;535;Tavernay;504;11;515
27;Bourgogne-Franche-Comté;71;1;02;537;Thil-sur-Arroux;131;0;131
27;Bourgogne-Franche-Comté;71;4;26;538;Thurey;449;11;460
27;Bourgogne-Franche-Comté;71;1;01;539;Tintry;78;2;80
27;Bourgogne-Franche-Comté;71;1;12;540;Torcy;2886;39;2925
27;Bourgogne-Franche-Comté;71;4;26;541;Torpes;372;4;376
27;Bourgogne-Franche-Comté;71;3;18;542;Toulon-sur-Arroux;1548;27;1575
27;Bourgogne-Franche-Comté;71;5;29;543;Tournus;5524;337;5861
27;Bourgogne-Franche-Comté;71;2;16;544;Toutenant;194;5;199
27;Bourgogne-Franche-Comté;71;5;08;545;Tramayes;1060;19;1079
27;Bourgogne-Franche-Comté;71;5;08;546;Trambly;402;8;410
27;Bourgogne-Franche-Comté;71;5;08;547;Trivy;267;7;274
27;Bourgogne-Franche-Comté;71;4;24;548;Tronchy;253;2;255
27;Bourgogne-Franche-Comté;71;5;29;549;La Truchère;220;6;226
27;Bourgogne-Franche-Comté;71;5;29;550;Uchizy;834;14;848
27;Bourgogne-Franche-Comté;71;1;02;551;Uchon;93;5;98
27;Bourgogne-Franche-Comté;71;3;18;552;Uxeau;518;13;531
27;Bourgogne-Franche-Comté;71;3;10;553;Vareilles;270;5;275
27;Bourgogne-Franche-Comté;71;3;10;554;Varenne-l'Arconce;115;3;118
27;Bourgogne-Franche-Comté;71;3;15;557;Varenne-Saint-Germain;718;17;735
27;Bourgogne-Franche-Comté;71;2;27;555;Varennes-le-Grand;2319;48;2367
27;Bourgogne-Franche-Comté;71;5;22;556;Varennes-lès-Mâcon;557;8;565
27;Bourgogne-Franche-Comté;71;4;14;558;Varennes-Saint-Sauveur;1135;26;1161
27;Bourgogne-Franche-Comté;71;3;10;559;Varennes-sous-Dun;556;14;570
27;Bourgogne-Franche-Comté;71;3;10;561;Vauban;222;9;231
27;Bourgogne-Franche-Comté;71;3;09;562;Vaudebarrier;215;33;248
27;Bourgogne-Franche-Comté;71;2;11;563;Vaux-en-Pré;77;1;78
27;Bourgogne-Franche-Comté;71;3;09;564;Vendenesse-lès-Charolles;742;20;762
27;Bourgogne-Franche-Comté;71;3;18;565;Vendenesse-sur-Arroux;576;12;588
27;Bourgogne-Franche-Comté;71;2;16;566;Verdun-sur-le-Doubs;1071;8;1079
27;Bourgogne-Franche-Comté;71;5;08;567;Vergisson;256;7;263
27;Bourgogne-Franche-Comté;71;4;20;568;Vérissey;56;0;56
27;Bourgogne-Franche-Comté;71;2;16;570;Verjux;522;14;536
27;Bourgogne-Franche-Comté;71;5;08;571;Verosvres;457;38;495
27;Bourgogne-Franche-Comté;71;2;29;572;Vers;232;0;232
27;Bourgogne-Franche-Comté;71;3;25;573;Versaugues;193;5;198
27;Bourgogne-Franche-Comté;71;5;19;574;Verzé;805;27;832
27;Bourgogne-Franche-Comté;71;5;29;576;Le Villars;282;5;287
27;Bourgogne-Franche-Comté;71;2;24;577;Villegaudin;212;4;216
27;Bourgogne-Franche-Comté;71;2;17;579;Villeneuve-en-Montagne;165;2;167
27;Bourgogne-Franche-Comté;71;4;20;580;Vincelles;421;10;431
27;Bourgogne-Franche-Comté;71;3;25;581;Vindecy;255;5;260
27;Bourgogne-Franche-Comté;71;5;11;582;Vineuse sur Fregande ;654;18;672
27;Bourgogne-Franche-Comté;71;5;08;583;Vinzelles;710;22;732
27;Bourgogne-Franche-Comté;71;5;19;584;Viré;1195;28;1223
27;Bourgogne-Franche-Comté;71;2;05;585;Virey-le-Grand;1354;72;1426
27;Bourgogne-Franche-Comté;71;3;09;586;Viry;256;4;260
27;Bourgogne-Franche-Comté;71;3;25;588;Vitry-en-Charollais;1098;38;1136
27;Bourgogne-Franche-Comté;71;3;15;589;Vitry-sur-Loire;427;8;435
27;Bourgogne-Franche-Comté;71;3;25;590;Volesvres;621;22;643
52;Pays de la Loire;72;3;11;001;Aigné;1686;37;1723
52;Pays de la Loire;72;2;09;002;Aillières-Beauvoir;211;3;214
52;Pays de la Loire;72;3;16;003;Allonnes;11075;109;11184
52;Pays de la Loire;72;1;07;004;Amné;579;3;582
52;Pays de la Loire;72;2;20;005;Ancinnes;938;22;960
52;Pays de la Loire;72;2;19;007;Ardenay-sur-Mérize;494;11;505
52;Pays de la Loire;72;3;15;008;Arnage;5351;122;5473
52;Pays de la Loire;72;1;06;009;Arthezé;377;8;385
52;Pays de la Loire;72;2;09;006;Arçonnay;1874;231;2105
52;Pays de la Loire;72;1;17;010;Asnières-sur-Vègre;403;11;414
52;Pays de la Loire;72;2;20;011;Assé-le-Boisne;909;17;926
52;Pays de la Loire;72;2;20;012;Assé-le-Riboul;504;10;514
52;Pays de la Loire;72;1;08;013;Aubigné-Racan;2115;27;2142
52;Pays de la Loire;72;2;09;015;Les Aulneaux;116;0;116
52;Pays de la Loire;72;1;17;016;Auvers-le-Hamon;1472;35;1507
52;Pays de la Loire;72;1;07;017;Auvers-sous-Montfaucon;242;3;245
52;Pays de la Loire;72;2;09;018;Avesnes-en-Saosnois;89;1;90
52;Pays de la Loire;72;1;07;019;Avessé;377;9;386
52;Pays de la Loire;72;2;05;020;Avezé;716;17;733
52;Pays de la Loire;72;1;17;021;Avoise;599;7;606
52;Pays de la Loire;72;1;17;022;Le Bailleul;1227;27;1254
52;Pays de la Loire;72;3;01;023;Ballon-Saint Mars;2250;30;2280
52;Pays de la Loire;72;3;01;024;La Bazoge;3640;60;3700
52;Pays de la Loire;72;1;06;025;Bazouges Cré sur Loir;2021;56;2077
52;Pays de la Loire;72;2;01;026;Beaufay;1499;16;1515
52;Pays de la Loire;72;1;03;028;Beaumont-Pied-de-Bœuf;487;7;494
52;Pays de la Loire;72;1;03;027;Beaumont-sur-Dême;329;8;337
52;Pays de la Loire;72;2;20;029;Beaumont-sur-Sarthe;1964;28;1992
52;Pays de la Loire;72;2;05;031;Beillé;528;3;531
52;Pays de la Loire;72;2;18;032;Berfay;330;10;340
52;Pays de la Loire;72;2;07;219;Bernay-Neuvy-en-Champagne ;867;58;925
52;Pays de la Loire;72;2;20;034;Bérus;442;12;454
52;Pays de la Loire;72;2;18;035;Bessé-sur-Braye;2166;46;2212
52;Pays de la Loire;72;2;20;036;Béthon;318;4;322
52;Pays de la Loire;72;2;09;037;Blèves;112;1;113
52;Pays de la Loire;72;2;05;038;Boëssé-le-Sec;604;1;605
52;Pays de la Loire;72;2;01;039;Bonnétable;3834;57;3891
52;Pays de la Loire;72;2;05;040;La Bosse;139;2;141
52;Pays de la Loire;72;2;05;041;Bouër;339;5;344
52;Pays de la Loire;72;2;18;042;Bouloire;2088;25;2113
52;Pays de la Loire;72;2;20;043;Bourg-le-Roi;323;7;330
52;Pays de la Loire;72;1;06;044;Bousse;439;5;444
52;Pays de la Loire;72;1;07;045;Brains-sur-Gée;827;13;840
52;Pays de la Loire;72;2;19;046;Le Breil-sur-Mérize;1544;27;1571
52;Pays de la Loire;72;3;02;047;Brette-les-Pins;2129;130;2259
52;Pays de la Loire;72;2;01;048;Briosne-lès-Sables;528;4;532
52;Pays de la Loire;72;1;08;049;La Bruère-sur-Loir;245;1;246
52;Pays de la Loire;72;1;07;050;Brûlon;1550;30;1580
52;Pays de la Loire;72;1;08;051;Cérans-Foulletourte;3379;35;3414
52;Pays de la Loire;72;1;03;052;Chahaignes;686;9;695
52;Pays de la Loire;72;3;02;053;Challes;1228;14;1242
52;Pays de la Loire;72;3;02;054;Champagné;3816;75;3891
52;Pays de la Loire;72;2;09;056;Champfleur;1343;24;1367
52;Pays de la Loire;72;2;18;057;Champrond;71;3;74
52;Pays de la Loire;72;3;02;058;Changé;6549;197;6746
52;Pays de la Loire;72;1;07;059;Chantenay-Villedieu;853;20;873
52;Pays de la Loire;72;1;08;060;La Chapelle-aux-Choux;263;3;266
52;Pays de la Loire;72;1;06;061;La Chapelle-d'Aligné;1698;25;1723
52;Pays de la Loire;72;2;05;062;La Chapelle-du-Bois;862;25;887
52;Pays de la Loire;72;2;18;064;La Chapelle-Huon;538;10;548
52;Pays de la Loire;72;3;11;065;La Chapelle-Saint-Aubin;2331;67;2398
52;Pays de la Loire;72;2;07;066;La Chapelle-Saint-Fray;427;7;434
52;Pays de la Loire;72;2;05;067;La Chapelle-Saint-Rémy;989;16;1005
52;Pays de la Loire;72;1;03;068;La Chartre-sur-le-Loir;1403;16;1419
52;Pays de la Loire;72;1;07;070;Chassillé;243;7;250
52;Pays de la Loire;72;1;08;072;Château-l'Hermitage;252;2;254
52;Pays de la Loire;72;3;16;073;Chaufour-Notre-Dame;1070;22;1092
52;Pays de la Loire;72;1;07;074;Chemiré-en-Charnie;210;4;214
52;Pays de la Loire;72;1;21;075;Chemiré-le-Gaudin;990;26;1016
52;Pays de la Loire;72;2;09;076;Chenay;236;2;238
52;Pays de la Loire;72;1;08;077;Chenu;428;7;435
52;Pays de la Loire;72;2;20;078;Chérancé;358;3;361
52;Pays de la Loire;72;2;20;079;Chérisay;310;3;313
52;Pays de la Loire;72;2;05;080;Cherré-Au ;2708;79;2787
52;Pays de la Loire;72;1;07;083;Chevillé;396;12;408
52;Pays de la Loire;72;1;06;084;Clermont-Créans;1261;35;1296
52;Pays de la Loire;72;2;18;085;Cogners;182;2;184
52;Pays de la Loire;72;2;09;086;Commerveil;137;4;141
52;Pays de la Loire;72;2;18;087;Conflans-sur-Anille;494;14;508
52;Pays de la Loire;72;2;09;088;Congé-sur-Orne;338;11;349
52;Pays de la Loire;72;2;07;089;Conlie;1881;38;1919
52;Pays de la Loire;72;2;19;090;Connerré;2916;59;2975
52;Pays de la Loire;72;2;09;091;Contilly;136;2;138
52;Pays de la Loire;72;2;05;093;Cormes;903;14;917
52;Pays de la Loire;72;2;18;094;Coudrecieux;615;9;624
52;Pays de la Loire;72;3;13;095;Coulaines;7600;114;7714
52;Pays de la Loire;72;1;07;096;Coulans-sur-Gée;1653;82;1735
52;Pays de la Loire;72;1;08;098;Coulongé;512;6;518
52;Pays de la Loire;72;3;01;099;Courcebœufs;638;7;645
52;Pays de la Loire;72;1;06;100;Courcelles-la-Forêt;411;4;415
52;Pays de la Loire;72;2;01;101;Courcemont;675;13;688
52;Pays de la Loire;72;2;01;102;Courcival;97;1;98
52;Pays de la Loire;72;1;03;103;Courdemanche;610;8;618
52;Pays de la Loire;72;2;09;104;Courgains;576;15;591
52;Pays de la Loire;72;2;18;105;Courgenard;496;5;501
52;Pays de la Loire;72;1;17;106;Courtillers;939;28;967
52;Pays de la Loire;72;1;07;107;Crannes-en-Champagne;351;6;357
52;Pays de la Loire;72;2;20;109;Crissé;569;6;575
52;Pays de la Loire;72;1;06;110;Crosmières;1044;20;1064
52;Pays de la Loire;72;2;07;111;Cures;479;15;494
52;Pays de la Loire;72;2;09;112;Dangeul;474;5;479
52;Pays de la Loire;72;2;07;113;Degré;774;12;786
52;Pays de la Loire;72;2;05;114;Dehault;269;6;275
52;Pays de la Loire;72;1;03;115;Dissay-sous-Courcillon;923;22;945
52;Pays de la Loire;72;2;18;118;Dollon;1474;23;1497
52;Pays de la Loire;72;2;07;119;Domfront-en-Champagne;1041;19;1060
52;Pays de la Loire;72;2;20;120;Doucelles;251;3;254
52;Pays de la Loire;72;2;20;121;Douillet;324;10;334
52;Pays de la Loire;72;2;05;122;Duneau;1043;21;1064
52;Pays de la Loire;72;1;17;123;Dureil;72;0;72
52;Pays de la Loire;72;3;04;124;Écommoy;4710;72;4782
52;Pays de la Loire;72;2;18;125;Écorpain;297;9;306
52;Pays de la Loire;72;1;07;126;Épineu-le-Chevreuil;290;9;299
52;Pays de la Loire;72;1;21;127;Étival-lès-le-Mans;1943;36;1979
52;Pays de la Loire;72;2;19;129;Fatines;849;16;865
52;Pays de la Loire;72;3;16;130;Fay;694;12;706
52;Pays de la Loire;72;1;21;131;Fercé-sur-Sarthe;598;8;606
52;Pays de la Loire;72;2;05;132;La Ferté-Bernard;8852;337;9189
52;Pays de la Loire;72;1;21;133;Fillé;1483;23;1506
52;Pays de la Loire;72;1;06;154;La Flèche;14902;1047;15949
52;Pays de la Loire;72;1;03;134;Flée;535;14;549
52;Pays de la Loire;72;1;08;135;La Fontaine-Saint-Martin;612;6;618
52;Pays de la Loire;72;1;07;136;Fontenay-sur-Vègre;319;8;327
52;Pays de la Loire;72;2;20;138;Fresnay-sur-Sarthe ;2915;46;2961
52;Pays de la Loire;72;2;20;139;Fyé;980;41;1021
52;Pays de la Loire;72;2;20;141;Gesnes-le-Gandelin;943;35;978
52;Pays de la Loire;72;1;03;143;Le Grand-Lucé;1926;26;1952
52;Pays de la Loire;72;2;20;142;Grandchamp;153;5;158
52;Pays de la Loire;72;2;18;144;Gréez-sur-Roc;329;4;333
52;Pays de la Loire;72;2;20;145;Le Grez;396;7;403
52;Pays de la Loire;72;1;21;146;Guécélard;3062;53;3115
52;Pays de la Loire;72;3;01;147;La Guierche;1132;24;1156
52;Pays de la Loire;72;2;01;148;Jauzé;83;1;84
52;Pays de la Loire;72;1;07;149;Joué-en-Charnie;643;10;653
52;Pays de la Loire;72;3;01;150;Joué-l'Abbé;1270;23;1293
52;Pays de la Loire;72;1;17;151;Juigné-sur-Sarthe;1141;31;1172
52;Pays de la Loire;72;2;20;152;Juillé;459;11;470
52;Pays de la Loire;72;1;03;153;Jupilles;560;12;572
52;Pays de la Loire;72;3;04;155;Laigné-en-Belin;2331;29;2360
52;Pays de la Loire;72;2;18;156;Lamnay;945;23;968
52;Pays de la Loire;72;2;07;157;Lavardin;724;13;737
52;Pays de la Loire;72;2;18;158;Lavaré;843;12;855
52;Pays de la Loire;72;1;03;160;Lavernat;591;7;598
52;Pays de la Loire;72;1;03;161;Lhomme;902;13;915
52;Pays de la Loire;72;1;06;163;Ligron;497;9;506
52;Pays de la Loire;72;2;20;164;Livet-en-Saosnois;70;0;70
52;Pays de la Loire;72;1;03;262;Loir en Vallée ;2171;174;2345
52;Pays de la Loire;72;2;19;165;Lombron;1901;24;1925
52;Pays de la Loire;72;1;07;166;Longnes;320;10;330
52;Pays de la Loire;72;1;17;167;Louailles;722;13;735
52;Pays de la Loire;72;1;07;168;Loué;2084;41;2125
52;Pays de la Loire;72;1;21;169;Louplande;1457;24;1481
52;Pays de la Loire;72;2;09;170;Louvigny;175;7;182
52;Pays de la Loire;72;2;09;171;Louzes;102;1;103
52;Pays de la Loire;72;2;05;172;Le Luart;1442;13;1455
52;Pays de la Loire;72;2;09;174;Lucé-sous-Ballon;103;1;104
52;Pays de la Loire;72;1;03;173;Luceau;1229;26;1255
52;Pays de la Loire;72;1;08;175;Luché-Pringé;1555;14;1569
52;Pays de la Loire;72;1;08;176;Lude ;4167;71;4238
52;Pays de la Loire;72;1;07;177;Maigné;356;4;360
52;Pays de la Loire;72;2;18;178;Maisoncelles;192;1;193
52;Pays de la Loire;72;1;21;179;Malicorne-sur-Sarthe;1895;34;1929
52;Pays de la Loire;72;2;09;180;Mamers;5231;174;5405
52;Pays de la Loire;72;3;99;181;Le Mans;143252;2838;146090
52;Pays de la Loire;72;1;08;182;Mansigné;1554;29;1583
52;Pays de la Loire;72;1;07;184;Mareil-en-Champagne;385;6;391
52;Pays de la Loire;72;1;06;185;Mareil-sur-Loir;664;9;673
52;Pays de la Loire;72;2;20;186;Maresché;888;11;899
52;Pays de la Loire;72;3;04;187;Marigné-Laillé;1608;16;1624
52;Pays de la Loire;72;2;09;189;Marolles-les-Braults;2157;27;2184
52;Pays de la Loire;72;2;18;190;Marolles-lès-Saint-Calais;277;4;281
52;Pays de la Loire;72;2;09;188;Marollette;151;2;153
52;Pays de la Loire;72;1;03;183;Marçon;1064;16;1080
52;Pays de la Loire;72;1;08;191;Mayet;3128;39;3167
52;Pays de la Loire;72;2;09;192;Les Mées;97;2;99
52;Pays de la Loire;72;2;18;193;Melleray;431;7;438
52;Pays de la Loire;72;2;09;194;Meurcé;269;2;271
52;Pays de la Loire;72;1;21;195;Mézeray;1896;29;1925
52;Pays de la Loire;72;2;07;197;Mézières-sous-Lavardin;692;5;697
52;Pays de la Loire;72;2;09;196;Mézières-sur-Ponthouin;719;6;725
52;Pays de la Loire;72;3;11;198;La Milesse;2638;36;2674
52;Pays de la Loire;72;2;20;199;Moitron-sur-Sarthe;279;1;280
52;Pays de la Loire;72;3;04;200;Moncé-en-Belin;3738;61;3799
52;Pays de la Loire;72;2;09;201;Moncé-en-Saosnois;259;4;263
52;Pays de la Loire;72;2;09;202;Monhoudou;202;11;213
52;Pays de la Loire;72;2;20;211;Mont-Saint-Jean;637;11;648
52;Pays de la Loire;72;2;18;204;Montaillé;529;6;535
52;Pays de la Loire;72;3;01;205;Montbizot;1794;26;1820
52;Pays de la Loire;72;2;19;241;Montfort-le-Gesnois;2948;48;2996
52;Pays de la Loire;72;2;18;208;Montmirail;374;9;383
52;Pays de la Loire;72;2;20;209;Montreuil-le-Chétif;304;1;305
52;Pays de la Loire;72;1;03;210;Montreuil-le-Henri;306;5;311
52;Pays de la Loire;72;1;03;071;Montval-sur-Loir ;6069;246;6315
52;Pays de la Loire;72;2;20;212;Moulins-le-Carbonnel;700;13;713
52;Pays de la Loire;72;3;04;213;Mulsanne;5232;63;5295
52;Pays de la Loire;72;2;09;214;Nauvay;10;2;12
52;Pays de la Loire;72;2;09;215;Neufchâtel-en-Saosnois;1023;12;1035
52;Pays de la Loire;72;2;07;216;Neuvillalais;590;14;604
52;Pays de la Loire;72;3;01;217;Neuville-sur-Sarthe;2434;48;2482
52;Pays de la Loire;72;2;20;218;Neuvillette-en-Charnie;288;4;292
52;Pays de la Loire;72;2;01;220;Nogent-le-Bernard;908;37;945
52;Pays de la Loire;72;1;03;221;Nogent-sur-Loir;376;4;380
52;Pays de la Loire;72;1;17;232;Notre-Dame-du-Pé;647;10;657
52;Pays de la Loire;72;2;09;222;Nouans;279;0;279
52;Pays de la Loire;72;1;07;223;Noyen-sur-Sarthe;2625;32;2657
52;Pays de la Loire;72;2;19;224;Nuillé-le-Jalais;537;3;540
52;Pays de la Loire;72;2;20;225;Oisseau-le-Petit;664;8;672
52;Pays de la Loire;72;1;08;226;Oizé;1327;17;1344
52;Pays de la Loire;72;2;09;227;Panon;43;0;43
52;Pays de la Loire;72;1;17;228;Parcé-sur-Sarthe;2094;50;2144
52;Pays de la Loire;72;2;20;229;Parennes;490;7;497
52;Pays de la Loire;72;3;02;231;Parigné-l'Évêque;5173;80;5253
52;Pays de la Loire;72;1;21;230;Parigné-le-Pôlin;1075;27;1102
52;Pays de la Loire;72;2;09;233;Peray;61;0;61
52;Pays de la Loire;72;2;20;234;Pezé-le-Robert;367;10;377
52;Pays de la Loire;72;2;20;235;Piacé;380;6;386
52;Pays de la Loire;72;1;17;236;Pincé;192;8;200
52;Pays de la Loire;72;1;07;237;Pirmil;505;6;511
52;Pays de la Loire;72;2;09;238;Pizieux;71;0;71
52;Pays de la Loire;72;1;07;239;Poillé-sur-Vègre;615;21;636
52;Pays de la Loire;72;1;08;243;Pontvallain;1662;25;1687
52;Pays de la Loire;72;1;17;244;Précigné;2965;64;3029
52;Pays de la Loire;72;2;05;245;Préval;688;15;703
52;Pays de la Loire;72;2;05;246;Prévelles;213;6;219
52;Pays de la Loire;72;1;03;248;Pruillé-l'Éguillé;825;24;849
52;Pays de la Loire;72;3;16;247;Pruillé-le-Chétif;1344;31;1375
52;Pays de la Loire;72;2;07;249;La Quinte;770;13;783
52;Pays de la Loire;72;2;18;250;Rahay;154;9;163
52;Pays de la Loire;72;2;09;251;René;381;5;386
52;Pays de la Loire;72;1;08;252;Requeil;1163;10;1173
52;Pays de la Loire;72;1;21;253;Roézé-sur-Sarthe;2620;69;2689
52;Pays de la Loire;72;2;20;254;Rouessé-Fontaine;272;6;278
52;Pays de la Loire;72;2;20;255;Rouessé-Vassé;806;16;822
52;Pays de la Loire;72;2;20;256;Rouez;767;7;774
52;Pays de la Loire;72;3;10;257;Rouillon;2281;317;2598
52;Pays de la Loire;72;2;01;259;Rouperroux-le-Coquet;287;7;294
52;Pays de la Loire;72;3;04;260;Ruaudin;3436;68;3504
52;Pays de la Loire;72;2;07;261;Ruillé-en-Champagne;306;12;318
52;Pays de la Loire;72;1;17;264;Sablé-sur-Sarthe;12127;481;12608
52;Pays de la Loire;72;2;09;265;Saint-Aignan;240;2;242
52;Pays de la Loire;72;2;20;266;Saint-Aubin-de-Locquenay;712;17;729
52;Pays de la Loire;72;2;05;267;Saint-Aubin-des-Coudrais;919;21;940
52;Pays de la Loire;72;3;04;268;Saint-Biez-en-Belin;706;11;717
52;Pays de la Loire;72;2;18;269;Saint-Calais;3245;195;3440
52;Pays de la Loire;72;2;09;270;Saint-Calez-en-Saosnois;189;1;190
52;Pays de la Loire;72;2;19;271;Saint-Célerin;916;15;931
52;Pays de la Loire;72;2;20;273;Saint-Christophe-du-Jambet;232;3;235
52;Pays de la Loire;72;1;07;274;Saint-Christophe-en-Champagne;208;7;215
52;Pays de la Loire;72;2;19;275;Saint-Corneille;1466;14;1480
52;Pays de la Loire;72;2;09;276;Saint-Cosme-en-Vairais;1944;47;1991
52;Pays de la Loire;72;1;07;278;Saint-Denis-d'Orques;786;11;797
52;Pays de la Loire;72;2;05;277;Saint-Denis-des-Coudrais;114;1;115
52;Pays de la Loire;72;1;03;279;Saint-Georges-de-la-Couée;157;3;160
52;Pays de la Loire;72;3;16;280;Saint-Georges-du-Bois;2141;36;2177
52;Pays de la Loire;72;2;01;281;Saint-Georges-du-Rosay;439;5;444
52;Pays de la Loire;72;2;20;282;Saint-Georges-le-Gaultier;534;5;539
52;Pays de la Loire;72;1;08;283;Saint-Germain-d'Arcé;335;5;340
52;Pays de la Loire;72;2;18;286;Saint-Gervais-de-Vic;391;7;398
52;Pays de la Loire;72;3;04;287;Saint-Gervais-en-Belin;2048;44;2092
52;Pays de la Loire;72;3;01;290;Saint-Jean-d'Assé;1773;15;1788
52;Pays de la Loire;72;1;08;291;Saint-Jean-de-la-Motte;976;20;996
52;Pays de la Loire;72;2;18;292;Saint-Jean-des-Échelles;246;5;251
52;Pays de la Loire;72;1;21;293;Saint-Jean-du-Bois;621;7;628
52;Pays de la Loire;72;2;20;294;Saint-Léonard-des-Bois;471;15;486
52;Pays de la Loire;72;2;09;295;Saint-Longis;502;7;509
52;Pays de la Loire;72;2;18;296;Saint-Maixent;749;21;770
52;Pays de la Loire;72;2;20;297;Saint-Marceau;555;12;567
52;Pays de la Loire;72;3;02;299;Saint-Mars-d'Outillé;2429;35;2464
52;Pays de la Loire;72;2;18;298;Saint-Mars-de-Locquenay;574;10;584
52;Pays de la Loire;72;2;19;300;Saint-Mars-la-Brière;2693;29;2722
52;Pays de la Loire;72;2;05;302;Saint-Martin-des-Monts;175;4;179
52;Pays de la Loire;72;2;18;303;Saint-Michel-de-Chavaignes;734;10;744
52;Pays de la Loire;72;2;20;305;Saint-Ouen-de-Mimbré;1003;26;1029
52;Pays de la Loire;72;3;04;306;Saint-Ouen-en-Belin;1312;24;1336
52;Pays de la Loire;72;1;07;307;Saint-Ouen-en-Champagne;242;6;248
52;Pays de la Loire;72;2;09;308;Saint-Paterne - Le Chevain;2113;228;2341
52;Pays de la Loire;72;2;20;309;Saint-Paul-le-Gaultier;287;7;294
52;Pays de la Loire;72;3;01;310;Saint-Pavace;1921;58;1979
52;Pays de la Loire;72;1;03;311;Saint-Pierre-de-Chevillé;357;6;363
52;Pays de la Loire;72;1;07;312;Saint-Pierre-des-Bois;233;3;236
52;Pays de la Loire;72;2;09;313;Saint-Pierre-des-Ormes;225;5;230
52;Pays de la Loire;72;1;03;314;Saint-Pierre-du-Lorouër;376;8;384
52;Pays de la Loire;72;2;20;315;Saint-Rémy-de-Sillé;825;14;839
52;Pays de la Loire;72;2;09;316;Saint-Rémy-des-Monts;683;21;704
52;Pays de la Loire;72;2;09;317;Saint-Rémy-du-Val;509;18;527
52;Pays de la Loire;72;3;11;320;Saint-Saturnin;2560;81;2641
52;Pays de la Loire;72;2;07;321;Saint-Symphorien;539;10;549
52;Pays de la Loire;72;2;18;322;Saint-Ulphace;224;2;226
52;Pays de la Loire;72;2;20;323;Saint-Victeur;456;2;458
52;Pays de la Loire;72;2;09;324;Saint-Vincent-des-Prés;510;14;524
52;Pays de la Loire;72;1;03;325;Saint-Vincent-du-Lorouër;847;17;864
52;Pays de la Loire;72;2;18;272;Sainte-Cérotte;315;6;321
52;Pays de la Loire;72;3;01;289;Sainte-Jamme-sur-Sarthe;2043;33;2076
52;Pays de la Loire;72;2;07;319;Sainte-Sabine-sur-Longève;752;19;771
52;Pays de la Loire;72;2;09;326;Saosnes;208;5;213
52;Pays de la Loire;72;1;08;327;Sarcé;299;4;303
52;Pays de la Loire;72;3;02;328;Sargé-lès-le-Mans;3650;137;3787
52;Pays de la Loire;72;2;19;329;Savigné-l'Évêque;4030;82;4112
52;Pays de la Loire;72;1;08;330;Savigné-sous-le-Lude;430;13;443
52;Pays de la Loire;72;2;05;331;Sceaux-sur-Huisne;570;11;581
52;Pays de la Loire;72;2;20;332;Ségrie;607;8;615
52;Pays de la Loire;72;2;18;333;Semur-en-Vallon;444;11;455
52;Pays de la Loire;72;2;20;334;Sillé-le-Guillaume;2267;88;2355
52;Pays de la Loire;72;2;19;335;Sillé-le-Philippe;1070;14;1084
52;Pays de la Loire;72;1;17;336;Solesmes;1206;40;1246
52;Pays de la Loire;72;2;20;337;Sougé-le-Ganelon;883;21;904
52;Pays de la Loire;72;3;01;338;Souillé;716;10;726
52;Pays de la Loire;72;1;21;339;Souligné-Flacé;679;10;689
52;Pays de la Loire;72;3;01;340;Souligné-sous-Ballon;1207;22;1229
52;Pays de la Loire;72;2;19;341;Soulitré;622;12;634
52;Pays de la Loire;72;2;05;342;Souvigné-sur-Même;170;7;177
52;Pays de la Loire;72;1;17;343;Souvigné-sur-Sarthe;625;11;636
52;Pays de la Loire;72;1;21;344;Spay;2885;48;2933
52;Pays de la Loire;72;2;19;345;Surfonds;340;5;345
52;Pays de la Loire;72;1;21;346;La Suze-sur-Sarthe;4473;55;4528
52;Pays de la Loire;72;1;07;347;Tassé;305;5;310
52;Pays de la Loire;72;1;07;348;Tassillé;130;1;131
52;Pays de la Loire;72;3;01;349;Teillé;478;2;480
52;Pays de la Loire;72;3;04;350;Teloché;3056;61;3117
52;Pays de la Loire;72;2;07;351;Tennie;1052;20;1072
52;Pays de la Loire;72;2;01;352;Terrehault;137;0;137
52;Pays de la Loire;72;2;05;353;Théligny;214;5;219
52;Pays de la Loire;72;2;09;354;Thoigné;163;4;167
52;Pays de la Loire;72;2;20;355;Thoiré-sous-Contensor;99;1;100
52;Pays de la Loire;72;1;03;356;Thoiré-sur-Dinan;422;5;427
52;Pays de la Loire;72;1;06;357;Thorée-les-Pins;726;12;738
52;Pays de la Loire;72;2;18;358;Thorigné-sur-Dué;1611;36;1647
52;Pays de la Loire;72;2;19;359;Torcé-en-Vallée;1421;9;1430
52;Pays de la Loire;72;3;16;360;Trangé;1458;32;1490
52;Pays de la Loire;72;2;18;361;Tresson;475;8;483
52;Pays de la Loire;72;2;20;362;Le Tronchet;164;1;165
52;Pays de la Loire;72;2;05;363;Tuffé Val de la Chéronne;1657;16;1673
52;Pays de la Loire;72;1;08;364;Vaas;1470;25;1495
52;Pays de la Loire;72;2;18;128;Val-d'Étangson ;531;5;536
52;Pays de la Loire;72;2;18;366;Valennes;316;4;320
52;Pays de la Loire;72;1;07;367;Vallon-sur-Gée;799;12;811
52;Pays de la Loire;72;2;18;368;Vancé;323;6;329
52;Pays de la Loire;72;1;08;369;Verneil-le-Chétif;610;73;683
52;Pays de la Loire;72;2;20;370;Vernie;329;6;335
52;Pays de la Loire;72;2;09;372;Vezot;76;1;77
52;Pays de la Loire;72;2;18;373;Vibraye;2531;55;2586
52;Pays de la Loire;72;2;09;374;Villaines-la-Carelle;151;5;156
52;Pays de la Loire;72;2;05;375;Villaines-la-Gonais;548;14;562
52;Pays de la Loire;72;1;03;376;Villaines-sous-Lucé;710;21;731
52;Pays de la Loire;72;1;06;377;Villaines-sous-Malicorne;1023;11;1034
52;Pays de la Loire;72;2;09;137;Villeneuve-en-Perseigne;2186;38;2224
52;Pays de la Loire;72;1;17;378;Vion;1448;33;1481
52;Pays de la Loire;72;1;07;379;Viré-en-Champagne;197;6;203
52;Pays de la Loire;72;2;20;380;Vivoin;949;22;971
52;Pays de la Loire;72;1;21;381;Voivres-lès-le-Mans;1377;11;1388
52;Pays de la Loire;72;2;18;382;Volnay;932;18;950
52;Pays de la Loire;72;2;05;383;Vouvray-sur-Huisne;132;4;136
52;Pays de la Loire;72;3;02;386;Yvré-l'Évêque;4196;131;4327
52;Pays de la Loire;72;1;08;385;Yvré-le-Pôlin;1774;24;1798
84;Auvergne-Rhône-Alpes;73;2;14;001;Aiguebelette-le-Lac;234;9;243
84;Auvergne-Rhône-Alpes;73;2;16;004;Aillon-le-Jeune;434;16;450
84;Auvergne-Rhône-Alpes;73;2;16;005;Aillon-le-Vieux;181;4;185
84;Auvergne-Rhône-Alpes;73;1;05;006;Aime-la-Plagne ;4486;110;4596
84;Auvergne-Rhône-Alpes;73;3;18;007;Aiton;1674;22;1696
84;Auvergne-Rhône-Alpes;73;2;97;008;Aix-les-Bains;29993;570;30563
84;Auvergne-Rhône-Alpes;73;1;98;011;Albertville;19214;558;19772
84;Auvergne-Rhône-Alpes;73;3;17;012;Albiez-le-Jeune;147;2;149
84;Auvergne-Rhône-Alpes;73;3;17;013;Albiez-Montrond;370;10;380
84;Auvergne-Rhône-Alpes;73;1;03;014;Allondaz;279;2;281
84;Auvergne-Rhône-Alpes;73;1;13;015;Les Allues;1857;43;1900
84;Auvergne-Rhône-Alpes;73;2;11;017;Apremont;1000;21;1021
84;Auvergne-Rhône-Alpes;73;2;11;018;Arbin;773;21;794
84;Auvergne-Rhône-Alpes;73;3;18;019;Argentine;954;20;974
84;Auvergne-Rhône-Alpes;73;2;16;020;Arith;442;11;453
84;Auvergne-Rhône-Alpes;73;2;11;021;Arvillard;858;16;874
84;Auvergne-Rhône-Alpes;73;2;14;022;Attignat-Oncin;551;15;566
84;Auvergne-Rhône-Alpes;73;3;10;023;Aussois;691;22;713
84;Auvergne-Rhône-Alpes;73;1;13;024;Les Avanchers-Valmorel;781;22;803
84;Auvergne-Rhône-Alpes;73;2;06;025;Avressieux;524;11;535
84;Auvergne-Rhône-Alpes;73;3;10;026;Avrieux;388;14;402
84;Auvergne-Rhône-Alpes;73;2;14;027;Ayn;385;6;391
84;Auvergne-Rhône-Alpes;73;2;06;028;La Balme;328;3;331
84;Auvergne-Rhône-Alpes;73;2;15;029;Barberaz;4876;114;4990
84;Auvergne-Rhône-Alpes;73;2;16;030;Barby;3422;40;3462
84;Auvergne-Rhône-Alpes;73;2;16;031;Bassens;4625;121;4746
84;Auvergne-Rhône-Alpes;73;1;03;032;La Bâthie;2176;38;2214
84;Auvergne-Rhône-Alpes;73;2;14;033;La Bauche;499;5;504
84;Auvergne-Rhône-Alpes;73;1;19;034;Beaufort;2051;89;2140
84;Auvergne-Rhône-Alpes;73;2;16;036;Bellecombe-en-Bauges;674;18;692
84;Auvergne-Rhône-Alpes;73;1;13;257;Belleville ;3503;117;3620
84;Auvergne-Rhône-Alpes;73;2;14;039;Belmont-Tramonet;548;12;560
84;Auvergne-Rhône-Alpes;73;3;10;040;Bessans;360;8;368
84;Auvergne-Rhône-Alpes;73;2;18;041;Betton-Bettonet;311;6;317
84;Auvergne-Rhône-Alpes;73;2;06;042;Billième;266;7;273
84;Auvergne-Rhône-Alpes;73;2;01;043;La Biolle;2699;34;2733
84;Auvergne-Rhône-Alpes;73;3;10;047;Bonneval-sur-Arc;260;8;268
84;Auvergne-Rhône-Alpes;73;1;04;048;Bonvillard;358;14;372
84;Auvergne-Rhône-Alpes;73;3;18;049;Bonvillaret;146;0;146
84;Auvergne-Rhône-Alpes;73;2;12;050;Bourdeau;565;20;585
84;Auvergne-Rhône-Alpes;73;1;05;054;Bourg-Saint-Maurice;7252;402;7654
84;Auvergne-Rhône-Alpes;73;2;12;051;Le Bourget-du-Lac;5018;100;5118
84;Auvergne-Rhône-Alpes;73;2;11;052;Bourget-en-Huile;147;4;151
84;Auvergne-Rhône-Alpes;73;2;18;053;Bourgneuf;680;11;691
84;Auvergne-Rhône-Alpes;73;1;13;055;Bozel;1864;59;1923
84;Auvergne-Rhône-Alpes;73;1;13;057;Brides-les-Bains;500;12;512
84;Auvergne-Rhône-Alpes;73;2;14;058;La Bridoire;1270;19;1289
84;Auvergne-Rhône-Alpes;73;2;01;059;Brison-Saint-Innocent;2196;67;2263
84;Auvergne-Rhône-Alpes;73;1;19;061;Césarches;428;14;442
84;Auvergne-Rhône-Alpes;73;1;03;063;Cevins;730;10;740
84;Auvergne-Rhône-Alpes;73;2;15;064;Challes-les-Eaux;5584;272;5856
84;Auvergne-Rhône-Alpes;73;2;99;065;Chambéry;58833;1543;60376
84;Auvergne-Rhône-Alpes;73;3;17;067;La Chambre;1157;22;1179
84;Auvergne-Rhône-Alpes;73;2;18;068;Chamousset;587;20;607
84;Auvergne-Rhône-Alpes;73;2;18;069;Chamoux-sur-Gelon;947;17;964
84;Auvergne-Rhône-Alpes;73;2;18;072;Champ-Laurent;34;1;35
84;Auvergne-Rhône-Alpes;73;2;06;070;Champagneux;695;8;703
84;Auvergne-Rhône-Alpes;73;1;13;071;Champagny-en-Vanoise;566;22;588
84;Auvergne-Rhône-Alpes;73;2;06;073;Chanaz;524;7;531
84;Auvergne-Rhône-Alpes;73;3;17;074;La Chapelle;331;11;342
84;Auvergne-Rhône-Alpes;73;2;11;075;La Chapelle-Blanche;566;20;586
84;Auvergne-Rhône-Alpes;73;2;12;076;La Chapelle-du-Mont-du-Chat;260;4;264
84;Auvergne-Rhône-Alpes;73;2;06;078;La Chapelle-Saint-Martin;145;6;151
84;Auvergne-Rhône-Alpes;73;1;05;077;Les Chapelles;564;9;573
84;Auvergne-Rhône-Alpes;73;2;18;079;Châteauneuf;913;15;928
84;Auvergne-Rhône-Alpes;73;2;16;081;Le Châtelard;669;44;713
84;Auvergne-Rhône-Alpes;73;2;11;082;La Chavanne;735;38;773
84;Auvergne-Rhône-Alpes;73;3;17;083;Les Chavannes-en-Maurienne;234;3;237
84;Auvergne-Rhône-Alpes;73;2;11;084;Chignin;956;27;983
84;Auvergne-Rhône-Alpes;73;2;06;085;Chindrieux;1382;21;1403
84;Auvergne-Rhône-Alpes;73;1;04;086;Cléry;399;12;411
84;Auvergne-Rhône-Alpes;73;2;09;087;Cognin;6264;182;6446
84;Auvergne-Rhône-Alpes;73;1;19;088;Cohennoz;160;8;168
84;Auvergne-Rhône-Alpes;73;2;18;089;Coise-Saint-Jean-Pied-Gauthier;1259;21;1280
84;Auvergne-Rhône-Alpes;73;2;16;090;La Compôte;260;7;267
84;Auvergne-Rhône-Alpes;73;2;06;091;Conjux;204;3;207
84;Auvergne-Rhône-Alpes;73;2;14;092;Corbel;155;4;159
84;Auvergne-Rhône-Alpes;73;1;13;227;Courchevel;2362;73;2435
84;Auvergne-Rhône-Alpes;73;1;19;094;Crest-Voland;337;14;351
84;Auvergne-Rhône-Alpes;73;2;11;095;La Croix-de-la-Rochette;377;8;385
84;Auvergne-Rhône-Alpes;73;2;18;096;Cruet;1040;19;1059
84;Auvergne-Rhône-Alpes;73;2;16;097;Curienne;685;21;706
84;Auvergne-Rhône-Alpes;73;2;16;098;Les Déserts;810;22;832
84;Auvergne-Rhône-Alpes;73;2;11;099;Détrier;429;4;433
84;Auvergne-Rhône-Alpes;73;2;14;100;Domessin;1880;46;1926
84;Auvergne-Rhône-Alpes;73;2;16;101;Doucy-en-Bauges;96;3;99
84;Auvergne-Rhône-Alpes;73;2;12;103;Drumettaz-Clarafond;2871;65;2936
84;Auvergne-Rhône-Alpes;73;2;14;104;Dullin;462;5;467
84;Auvergne-Rhône-Alpes;73;2;14;105;Les Échelles;1231;17;1248
84;Auvergne-Rhône-Alpes;73;2;16;106;École;301;6;307
84;Auvergne-Rhône-Alpes;73;2;01;010;Entrelacs;6290;141;6431
84;Auvergne-Rhône-Alpes;73;2;14;107;Entremont-le-Vieux;648;8;656
84;Auvergne-Rhône-Alpes;73;3;18;109;Épierre;767;9;776
84;Auvergne-Rhône-Alpes;73;1;03;110;Esserts-Blay;792;7;799
84;Auvergne-Rhône-Alpes;73;1;13;113;Feissons-sur-Salins;178;3;181
84;Auvergne-Rhône-Alpes;73;1;19;114;Flumet;808;29;837
84;Auvergne-Rhône-Alpes;73;3;17;116;Fontcouverte-la-Toussuire;496;12;508
84;Auvergne-Rhône-Alpes;73;3;10;117;Fourneaux;682;9;691
84;Auvergne-Rhône-Alpes;73;3;10;119;Freney;102;4;106
84;Auvergne-Rhône-Alpes;73;2;18;120;Fréterive;589;13;602
84;Auvergne-Rhône-Alpes;73;1;04;121;Frontenex;1913;48;1961
84;Auvergne-Rhône-Alpes;73;2;06;122;Gerbaix;417;19;436
84;Auvergne-Rhône-Alpes;73;1;19;123;La Giettaz;391;15;406
84;Auvergne-Rhône-Alpes;73;1;04;124;Gilly-sur-Isère;3029;77;3106
84;Auvergne-Rhône-Alpes;73;1;13;003;Grand-Aigueblanche ;3818;111;3929
84;Auvergne-Rhône-Alpes;73;2;01;128;Grésy-sur-Aix;4570;101;4671
84;Auvergne-Rhône-Alpes;73;1;04;129;Grésy-sur-Isère;1229;40;1269
84;Auvergne-Rhône-Alpes;73;1;04;130;Grignon;2113;38;2151
84;Auvergne-Rhône-Alpes;73;1;13;131;Hautecour;305;8;313
84;Auvergne-Rhône-Alpes;73;1;19;132;Hauteluce;758;23;781
84;Auvergne-Rhône-Alpes;73;2;18;133;Hauteville;350;7;357
84;Auvergne-Rhône-Alpes;73;2;08;137;Jacob-Bellecombette;4070;79;4149
84;Auvergne-Rhône-Alpes;73;3;17;138;Jarrier;497;11;508
84;Auvergne-Rhône-Alpes;73;2;16;139;Jarsy;269;12;281
84;Auvergne-Rhône-Alpes;73;2;06;140;Jongieux;287;7;294
84;Auvergne-Rhône-Alpes;73;2;11;141;Laissaud;679;14;693
84;Auvergne-Rhône-Alpes;73;1;05;142;Landry;821;20;841
84;Auvergne-Rhône-Alpes;73;1;13;187;Léchère ;2634;56;2690
84;Auvergne-Rhône-Alpes;73;2;14;145;Lépin-le-Lac;460;14;474
84;Auvergne-Rhône-Alpes;73;2;16;146;Lescheraines;773;17;790
84;Auvergne-Rhône-Alpes;73;2;06;147;Loisieux;204;0;204
84;Auvergne-Rhône-Alpes;73;2;06;149;Lucey;311;6;317
84;Auvergne-Rhône-Alpes;73;2;06;152;Marcieux;204;5;209
84;Auvergne-Rhône-Alpes;73;1;19;153;Marthod;1360;30;1390
84;Auvergne-Rhône-Alpes;73;1;03;154;Mercury;3159;90;3249
84;Auvergne-Rhône-Alpes;73;2;12;155;Méry;1900;40;1940
84;Auvergne-Rhône-Alpes;73;2;06;156;Meyrieux-Trouet;309;6;315
84;Auvergne-Rhône-Alpes;73;3;10;157;Modane;3077;136;3213
84;Auvergne-Rhône-Alpes;73;2;11;159;Les Mollettes;830;8;838
84;Auvergne-Rhône-Alpes;73;2;14;160;Montagnole;932;24;956
84;Auvergne-Rhône-Alpes;73;1;13;161;Montagny;658;14;672
84;Auvergne-Rhône-Alpes;73;1;04;162;Montailleur;679;23;702
84;Auvergne-Rhône-Alpes;73;2;01;164;Montcel;1010;61;1071
84;Auvergne-Rhône-Alpes;73;2;18;166;Montendry;56;2;58
84;Auvergne-Rhône-Alpes;73;3;18;168;Montgilbert;121;1;122
84;Auvergne-Rhône-Alpes;73;1;04;170;Monthion;538;11;549
84;Auvergne-Rhône-Alpes;73;2;11;171;Montmélian;4101;72;4173
84;Auvergne-Rhône-Alpes;73;3;17;173;Montricher-Albanne;473;11;484
84;Auvergne-Rhône-Alpes;73;3;18;175;Montsapey;68;0;68
84;Auvergne-Rhône-Alpes;73;1;05;176;Montvalezan;701;10;711
84;Auvergne-Rhône-Alpes;73;3;17;177;Montvernier;233;7;240
84;Auvergne-Rhône-Alpes;73;2;16;178;La Motte-en-Bauges;501;11;512
84;Auvergne-Rhône-Alpes;73;2;12;179;La Motte-Servolex;11932;578;12510
84;Auvergne-Rhône-Alpes;73;2;06;180;Motz;435;6;441
84;Auvergne-Rhône-Alpes;73;1;13;181;Moûtiers;3511;457;3968
84;Auvergne-Rhône-Alpes;73;2;02;182;Mouxy;2226;52;2278
84;Auvergne-Rhône-Alpes;73;2;11;183;Myans;1262;33;1295
84;Auvergne-Rhône-Alpes;73;2;14;184;Nances;502;11;513
84;Auvergne-Rhône-Alpes;73;1;19;186;Notre-Dame-de-Bellecombe;476;14;490
84;Auvergne-Rhône-Alpes;73;1;04;188;Notre-Dame-des-Millières;1031;25;1056
84;Auvergne-Rhône-Alpes;73;3;17;189;Notre-Dame-du-Cruet;228;2;230
84;Auvergne-Rhône-Alpes;73;1;13;190;Notre-Dame-du-Pré;250;5;255
84;Auvergne-Rhône-Alpes;73;2;06;191;Novalaise;2109;68;2177
84;Auvergne-Rhône-Alpes;73;2;16;192;Le Noyer;214;5;219
84;Auvergne-Rhône-Alpes;73;2;06;193;Ontex;106;3;109
84;Auvergne-Rhône-Alpes;73;3;10;194;Orelle;338;10;348
84;Auvergne-Rhône-Alpes;73;1;19;196;Pallud;792;19;811
84;Auvergne-Rhône-Alpes;73;1;05;197;Peisey-Nancroix;643;25;668
84;Auvergne-Rhône-Alpes;73;1;05;150;La Plagne Tarentaise;3705;126;3831
84;Auvergne-Rhône-Alpes;73;2;11;200;Planaise;552;7;559
84;Auvergne-Rhône-Alpes;73;1;13;201;Planay;434;13;447
84;Auvergne-Rhône-Alpes;73;1;04;202;Plancherine;446;10;456
84;Auvergne-Rhône-Alpes;73;2;14;204;Le Pont-de-Beauvoisin;2073;32;2105
84;Auvergne-Rhône-Alpes;73;2;11;205;Le Pontet;119;4;123
84;Auvergne-Rhône-Alpes;73;2;11;151;Porte-de-Savoie ;3717;86;3803
84;Auvergne-Rhône-Alpes;73;1;13;206;Pralognan-la-Vanoise;715;23;738
84;Auvergne-Rhône-Alpes;73;2;11;207;Presle;425;12;437
84;Auvergne-Rhône-Alpes;73;2;01;208;Pugny-Chatenod;955;41;996
84;Auvergne-Rhône-Alpes;73;2;16;210;Puygros;382;5;387
84;Auvergne-Rhône-Alpes;73;1;19;211;Queige;794;25;819
84;Auvergne-Rhône-Alpes;73;2;15;213;La Ravoire;8494;566;9060
84;Auvergne-Rhône-Alpes;73;2;06;214;Rochefort;234;10;244
84;Auvergne-Rhône-Alpes;73;1;03;216;Rognaix;484;6;490
84;Auvergne-Rhône-Alpes;73;2;11;217;Rotherens;368;11;379
84;Auvergne-Rhône-Alpes;73;2;06;218;Ruffieux;826;16;842
84;Auvergne-Rhône-Alpes;73;3;18;220;Saint-Alban-d'Hurtières;365;11;376
84;Auvergne-Rhône-Alpes;73;2;14;219;Saint-Alban-de-Montbel;653;16;669
84;Auvergne-Rhône-Alpes;73;3;17;221;Saint-Alban-des-Villards;94;3;97
84;Auvergne-Rhône-Alpes;73;2;16;222;Saint-Alban-Leysse;6146;208;6354
84;Auvergne-Rhône-Alpes;73;3;10;223;Saint-André;448;6;454
84;Auvergne-Rhône-Alpes;73;3;17;224;Saint-Avre;878;21;899
84;Auvergne-Rhône-Alpes;73;2;15;225;Saint-Baldoph;2778;91;2869
84;Auvergne-Rhône-Alpes;73;2;14;226;Saint-Béron;1688;22;1710
84;Auvergne-Rhône-Alpes;73;2;14;228;Saint-Cassin;848;22;870
84;Auvergne-Rhône-Alpes;73;2;14;229;Saint-Christophe;532;13;545
84;Auvergne-Rhône-Alpes;73;3;17;230;Saint-Colomban-des-Villards;133;0;133
84;Auvergne-Rhône-Alpes;73;3;17;231;Saint-Étienne-de-Cuines;1203;22;1225
84;Auvergne-Rhône-Alpes;73;2;14;233;Saint-Franc;167;10;177
84;Auvergne-Rhône-Alpes;73;2;16;234;Saint-François-de-Sales;149;4;153
84;Auvergne-Rhône-Alpes;73;3;17;235;Saint François Longchamp;545;6;551
84;Auvergne-Rhône-Alpes;73;2;06;236;Saint-Genix-les-Villages ;2924;66;2990
84;Auvergne-Rhône-Alpes;73;3;18;237;Saint-Georges-d'Hurtières;343;3;346
84;Auvergne-Rhône-Alpes;73;3;17;242;Saint-Jean-d'Arves;269;10;279
84;Auvergne-Rhône-Alpes;73;2;16;243;Saint-Jean-d'Arvey;1712;56;1768
84;Auvergne-Rhône-Alpes;73;2;06;245;Saint-Jean-de-Chevelu;817;16;833
84;Auvergne-Rhône-Alpes;73;2;14;246;Saint-Jean-de-Couz;295;5;300
84;Auvergne-Rhône-Alpes;73;2;18;247;Saint-Jean-de-la-Porte;955;71;1026
84;Auvergne-Rhône-Alpes;73;3;17;248;Saint-Jean-de-Maurienne;7683;360;8043
84;Auvergne-Rhône-Alpes;73;2;15;249;Saint-Jeoire-Prieuré;1765;43;1808
84;Auvergne-Rhône-Alpes;73;3;17;250;Saint-Julien-Mont-Denis;1616;44;1660
84;Auvergne-Rhône-Alpes;73;3;18;252;Saint-Léger;231;3;234
84;Auvergne-Rhône-Alpes;73;1;13;253;Saint-Marcel;607;8;615
84;Auvergne-Rhône-Alpes;73;3;10;256;Saint-Martin-d'Arc;344;9;353
84;Auvergne-Rhône-Alpes;73;3;10;258;Saint-Martin-de-la-Porte;679;20;699
84;Auvergne-Rhône-Alpes;73;3;17;259;Saint-Martin-sur-la-Chambre;549;14;563
84;Auvergne-Rhône-Alpes;73;3;10;261;Saint-Michel-de-Maurienne;2466;280;2746
84;Auvergne-Rhône-Alpes;73;1;19;262;Saint-Nicolas-la-Chapelle;463;33;496
84;Auvergne-Rhône-Alpes;73;2;01;263;Saint-Offenge;1120;21;1141
84;Auvergne-Rhône-Alpes;73;2;01;265;Saint-Ours;700;18;718
84;Auvergne-Rhône-Alpes;73;3;17;267;Saint-Pancrace;294;10;304
84;Auvergne-Rhône-Alpes;73;2;06;269;Saint-Paul;705;13;718
84;Auvergne-Rhône-Alpes;73;1;03;268;Saint-Paul-sur-Isère;531;59;590
84;Auvergne-Rhône-Alpes;73;2;18;270;Saint-Pierre-d'Albigny;4027;103;4130
84;Auvergne-Rhône-Alpes;73;2;06;271;Saint-Pierre-d'Alvey;302;10;312
84;Auvergne-Rhône-Alpes;73;2;14;274;Saint-Pierre-d'Entremont;456;15;471
84;Auvergne-Rhône-Alpes;73;3;18;272;Saint-Pierre-de-Belleville;175;4;179
84;Auvergne-Rhône-Alpes;73;2;06;273;Saint-Pierre-de-Curtille;489;6;495
84;Auvergne-Rhône-Alpes;73;2;14;275;Saint-Pierre-de-Genebroz;327;8;335
84;Auvergne-Rhône-Alpes;73;2;11;276;Saint-Pierre-de-Soucy;426;18;444
84;Auvergne-Rhône-Alpes;73;3;17;278;Saint-Rémy-de-Maurienne;1238;21;1259
84;Auvergne-Rhône-Alpes;73;3;17;280;Saint-Sorlin-d'Arves;338;8;346
84;Auvergne-Rhône-Alpes;73;2;14;281;Saint-Sulpice;752;20;772
84;Auvergne-Rhône-Alpes;73;2;14;282;Saint-Thibaud-de-Couz;1065;20;1085
84;Auvergne-Rhône-Alpes;73;1;04;283;Saint-Vital;705;14;719
84;Auvergne-Rhône-Alpes;73;1;05;232;Sainte-Foy-Tarentaise;750;24;774
84;Auvergne-Rhône-Alpes;73;2;11;240;Sainte-Hélène-du-Lac;784;20;804
84;Auvergne-Rhône-Alpes;73;1;04;241;Sainte-Hélène-sur-Isère;1182;20;1202
84;Auvergne-Rhône-Alpes;73;2;06;254;Sainte-Marie-d'Alvey;116;2;118
84;Auvergne-Rhône-Alpes;73;3;17;255;Sainte-Marie-de-Cuines;818;21;839
84;Auvergne-Rhône-Alpes;73;2;16;277;Sainte-Reine;166;7;173
84;Auvergne-Rhône-Alpes;73;1;13;284;Salins-Fontaine;1009;19;1028
84;Auvergne-Rhône-Alpes;73;1;05;285;Séez;2342;70;2412
84;Auvergne-Rhône-Alpes;73;2;06;286;Serrières-en-Chautagne;1188;21;1209
84;Auvergne-Rhône-Alpes;73;2;07;288;Sonnaz;1932;45;1977
84;Auvergne-Rhône-Alpes;73;2;11;289;La Table;435;9;444
84;Auvergne-Rhône-Alpes;73;1;19;292;Thénésol;313;7;320
84;Auvergne-Rhône-Alpes;73;2;16;293;Thoiry;456;7;463
84;Auvergne-Rhône-Alpes;73;2;16;294;La Thuile;329;7;336
84;Auvergne-Rhône-Alpes;73;1;05;296;Tignes;2034;42;2076
84;Auvergne-Rhône-Alpes;73;3;17;135;Tour-en-Maurienne ;1077;26;1103
84;Auvergne-Rhône-Alpes;73;1;04;297;Tournon;602;22;624
84;Auvergne-Rhône-Alpes;73;1;03;298;Tours-en-Savoie;935;11;946
84;Auvergne-Rhône-Alpes;73;2;06;299;Traize;322;6;328
84;Auvergne-Rhône-Alpes;73;2;02;300;Tresserve;3003;106;3109
84;Auvergne-Rhône-Alpes;73;2;01;301;Trévignin;795;15;810
84;Auvergne-Rhône-Alpes;73;2;11;302;La Trinité;342;2;344
84;Auvergne-Rhône-Alpes;73;1;19;303;Ugine;7076;288;7364
84;Auvergne-Rhône-Alpes;73;3;10;290;Val-Cenis;2061;38;2099
84;Auvergne-Rhône-Alpes;73;3;18;212;Val-d'Arc ;2012;29;2041
84;Auvergne-Rhône-Alpes;73;1;05;304;Val-d'Isère;1577;46;1623
84;Auvergne-Rhône-Alpes;73;2;11;215;Valgelon-La Rochette ;4150;100;4250
84;Auvergne-Rhône-Alpes;73;3;10;306;Valloire;1058;25;1083
84;Auvergne-Rhône-Alpes;73;3;10;307;Valmeinier;541;3;544
84;Auvergne-Rhône-Alpes;73;1;19;308;Venthon;607;18;625
84;Auvergne-Rhône-Alpes;73;2;14;309;Verel-de-Montbel;299;5;304
84;Auvergne-Rhône-Alpes;73;2;16;310;Verel-Pragondran;475;12;487
84;Auvergne-Rhône-Alpes;73;2;11;311;Le Verneil;104;1;105
84;Auvergne-Rhône-Alpes;73;1;04;312;Verrens-Arvey;910;30;940
84;Auvergne-Rhône-Alpes;73;2;06;313;Verthemex;231;1;232
84;Auvergne-Rhône-Alpes;73;2;11;314;Villard-d'Héry;264;5;269
84;Auvergne-Rhône-Alpes;73;2;18;315;Villard-Léger;465;8;473
84;Auvergne-Rhône-Alpes;73;2;11;316;Villard-Sallet;290;4;294
84;Auvergne-Rhône-Alpes;73;1;19;317;Villard-sur-Doron;708;27;735
84;Auvergne-Rhône-Alpes;73;3;17;318;Villarembert;249;9;258
84;Auvergne-Rhône-Alpes;73;3;17;320;Villargondran;857;25;882
84;Auvergne-Rhône-Alpes;73;3;10;322;Villarodin-Bourget;532;14;546
84;Auvergne-Rhône-Alpes;73;1;05;323;Villaroger;356;15;371
84;Auvergne-Rhône-Alpes;73;2;11;324;Villaroux;198;8;206
84;Auvergne-Rhône-Alpes;73;2;14;326;Vimines;2059;39;2098
84;Auvergne-Rhône-Alpes;73;2;06;327;Vions;401;6;407
84;Auvergne-Rhône-Alpes;73;2;12;328;Viviers-du-Lac;2253;56;2309
84;Auvergne-Rhône-Alpes;73;2;12;329;Voglans;1897;36;1933
84;Auvergne-Rhône-Alpes;73;2;06;330;Yenne;2999;34;3033
84;Auvergne-Rhône-Alpes;74;4;07;001;Abondance;1435;117;1552
84;Auvergne-Rhône-Alpes;74;1;12;002;Alby-sur-Chéran;2577;55;2632
84;Auvergne-Rhône-Alpes;74;1;08;003;Alex;1091;34;1125
84;Auvergne-Rhône-Alpes;74;1;12;004;Allèves;415;8;423
84;Auvergne-Rhône-Alpes;74;4;17;005;Allinges;4494;120;4614
84;Auvergne-Rhône-Alpes;74;3;11;006;Allonzier-la-Caille;2176;30;2206
84;Auvergne-Rhône-Alpes;74;2;11;007;Amancy;2713;54;2767
84;Auvergne-Rhône-Alpes;74;3;04;008;Ambilly;6261;68;6329
84;Auvergne-Rhône-Alpes;74;3;11;009;Andilly;927;17;944
84;Auvergne-Rhône-Alpes;74;1;  ;010;Annecy ;128199;3282;131481
84;Auvergne-Rhône-Alpes;74;3;04;012;Annemasse;36250;398;36648
84;Auvergne-Rhône-Alpes;74;4;15;013;Anthy-sur-Léman;2185;90;2275
84;Auvergne-Rhône-Alpes;74;2;14;014;Arâches-la-Frasse;1880;55;1935
84;Auvergne-Rhône-Alpes;74;3;11;015;Arbusigny;1127;24;1151
84;Auvergne-Rhône-Alpes;74;3;13;016;Archamps;2588;34;2622
84;Auvergne-Rhône-Alpes;74;2;05;018;Arenthon;1804;46;1850
84;Auvergne-Rhône-Alpes;74;1;03;019;Argonay;3184;265;3449
84;Auvergne-Rhône-Alpes;74;4;17;020;Armoy;1287;54;1341
84;Auvergne-Rhône-Alpes;74;3;09;021;Arthaz-Pont-Notre-Dame;1600;30;1630
84;Auvergne-Rhône-Alpes;74;2;05;024;Ayse;2220;60;2280
84;Auvergne-Rhône-Alpes;74;4;15;025;Ballaison;1486;20;1506
84;Auvergne-Rhône-Alpes;74;1;01;026;La Balme-de-Sillingy;5027;161;5188
84;Auvergne-Rhône-Alpes;74;1;08;027;La Balme-de-Thuy;458;9;467
84;Auvergne-Rhône-Alpes;74;3;13;029;Bassy;416;14;430
84;Auvergne-Rhône-Alpes;74;4;07;030;La Baume;321;6;327
84;Auvergne-Rhône-Alpes;74;3;13;031;Beaumont;2842;63;2905
84;Auvergne-Rhône-Alpes;74;4;17;032;Bellevaux;1286;40;1326
84;Auvergne-Rhône-Alpes;74;4;07;033;Bernex;1364;27;1391
84;Auvergne-Rhône-Alpes;74;4;07;034;Le Biot;594;7;601
84;Auvergne-Rhône-Alpes;74;1;12;035;Bloye;601;24;625
84;Auvergne-Rhône-Alpes;74;1;08;036;Bluffy;383;12;395
84;Auvergne-Rhône-Alpes;74;4;15;037;Boëge;1811;59;1870
84;Auvergne-Rhône-Alpes;74;4;15;038;Bogève;1144;29;1173
84;Auvergne-Rhône-Alpes;74;3;09;040;Bonne;3184;143;3327
84;Auvergne-Rhône-Alpes;74;4;07;041;Bonnevaux;279;5;284
84;Auvergne-Rhône-Alpes;74;2;05;042;Bonneville;12557;411;12968
84;Auvergne-Rhône-Alpes;74;4;15;043;Bons-en-Chablais;5700;107;5807
84;Auvergne-Rhône-Alpes;74;3;13;044;Bossey;1031;12;1043
84;Auvergne-Rhône-Alpes;74;1;08;045;Le Bouchet-Mont-Charvin;246;6;252
84;Auvergne-Rhône-Alpes;74;1;12;046;Boussy;508;12;520
84;Auvergne-Rhône-Alpes;74;4;15;048;Brenthonne;1070;21;1091
84;Auvergne-Rhône-Alpes;74;2;05;049;Brizon;484;2;486
84;Auvergne-Rhône-Alpes;74;4;15;050;Burdignin;651;15;666
84;Auvergne-Rhône-Alpes;74;3;11;051;Cercier;689;11;700
84;Auvergne-Rhône-Alpes;74;3;11;052;Cernex;1032;17;1049
84;Auvergne-Rhône-Alpes;74;4;17;053;Cervens;1225;22;1247
84;Auvergne-Rhône-Alpes;74;1;12;054;Chainaz-les-Frasses;746;28;774
84;Auvergne-Rhône-Alpes;74;3;13;055;Challonges;541;13;554
84;Auvergne-Rhône-Alpes;74;2;10;056;Chamonix-Mont-Blanc;8648;386;9034
84;Auvergne-Rhône-Alpes;74;4;07;057;Champanges;1080;30;1110
84;Auvergne-Rhône-Alpes;74;1;12;061;Chapeiry;909;34;943
84;Auvergne-Rhône-Alpes;74;4;07;058;La Chapelle-d'Abondance;931;17;948
84;Auvergne-Rhône-Alpes;74;2;11;059;La Chapelle-Rambaud;260;6;266
84;Auvergne-Rhône-Alpes;74;1;16;060;La Chapelle-Saint-Maurice;116;0;116
84;Auvergne-Rhône-Alpes;74;1;03;062;Charvonnex;1392;25;1417
84;Auvergne-Rhône-Alpes;74;4;07;063;Châtel;1250;42;1292
84;Auvergne-Rhône-Alpes;74;2;06;064;Châtillon-sur-Cluses;1220;45;1265
84;Auvergne-Rhône-Alpes;74;3;13;065;Chaumont;499;15;514
84;Auvergne-Rhône-Alpes;74;3;13;066;Chavannaz;250;2;252
84;Auvergne-Rhône-Alpes;74;1;16;067;Chavanod;2682;168;2850
84;Auvergne-Rhône-Alpes;74;3;13;068;Chêne-en-Semine;513;8;521
84;Auvergne-Rhône-Alpes;74;3;13;069;Chênex;813;14;827
84;Auvergne-Rhône-Alpes;74;4;15;070;Chens-sur-Léman;2771;34;2805
84;Auvergne-Rhône-Alpes;74;3;13;071;Chessenaz;217;6;223
84;Auvergne-Rhône-Alpes;74;1;08;072;Chevaline;201;6;207
84;Auvergne-Rhône-Alpes;74;4;07;073;Chevenoz;634;12;646
84;Auvergne-Rhône-Alpes;74;3;13;074;Chevrier;600;6;606
84;Auvergne-Rhône-Alpes;74;3;13;075;Chilly;1414;22;1436
84;Auvergne-Rhône-Alpes;74;1;01;076;Choisy;1632;43;1675
84;Auvergne-Rhône-Alpes;74;3;13;077;Clarafond-Arcine;1031;26;1057
84;Auvergne-Rhône-Alpes;74;1;08;079;Les Clefs;668;6;674
84;Auvergne-Rhône-Alpes;74;3;13;078;Clermont;406;6;412
84;Auvergne-Rhône-Alpes;74;1;08;080;La Clusaz;1714;53;1767
84;Auvergne-Rhône-Alpes;74;2;06;081;Cluses;16996;405;17401
84;Auvergne-Rhône-Alpes;74;3;13;082;Collonges-sous-Salève;3952;117;4069
84;Auvergne-Rhône-Alpes;74;2;14;083;Combloux;2105;115;2220
84;Auvergne-Rhône-Alpes;74;3;13;086;Contamine-Sarzin;720;12;732
84;Auvergne-Rhône-Alpes;74;2;05;087;Contamine-sur-Arve;2091;150;2241
84;Auvergne-Rhône-Alpes;74;2;10;085;Les Contamines-Montjoie;1143;48;1191
84;Auvergne-Rhône-Alpes;74;3;11;088;Copponex;1175;22;1197
84;Auvergne-Rhône-Alpes;74;2;14;089;Cordon;979;26;1005
84;Auvergne-Rhône-Alpes;74;2;11;090;Cornier;1328;19;1347
84;Auvergne-Rhône-Alpes;74;2;07;091;La Côte-d'Arbroz;350;2;352
84;Auvergne-Rhône-Alpes;74;3;09;094;Cranves-Sales;6902;166;7068
84;Auvergne-Rhône-Alpes;74;1;12;095;Crempigny-Bonneguête;317;10;327
84;Auvergne-Rhône-Alpes;74;3;11;096;Cruseilles;4496;315;4811
84;Auvergne-Rhône-Alpes;74;1;12;097;Cusy;1842;55;1897
84;Auvergne-Rhône-Alpes;74;1;11;098;Cuvat;1490;52;1542
84;Auvergne-Rhône-Alpes;74;2;14;099;Demi-Quartier;874;39;913
84;Auvergne-Rhône-Alpes;74;3;13;100;Desingy;796;26;822
84;Auvergne-Rhône-Alpes;74;3;13;101;Dingy-en-Vuache;701;17;718
84;Auvergne-Rhône-Alpes;74;1;08;102;Dingy-Saint-Clair;1438;47;1485
84;Auvergne-Rhône-Alpes;74;2;14;103;Domancy;2176;75;2251
84;Auvergne-Rhône-Alpes;74;1;08;104;Doussard;3575;86;3661
84;Auvergne-Rhône-Alpes;74;4;15;105;Douvaine;6077;75;6152
84;Auvergne-Rhône-Alpes;74;4;17;106;Draillant;888;31;919
84;Auvergne-Rhône-Alpes;74;3;13;107;Droisy;156;5;161
84;Auvergne-Rhône-Alpes;74;1;16;108;Duingt;998;21;1019
84;Auvergne-Rhône-Alpes;74;3;13;109;Éloise;895;18;913
84;Auvergne-Rhône-Alpes;74;1;16;111;Entrevernes;214;3;217
84;Auvergne-Rhône-Alpes;74;1;03;112;Epagny Metz-Tessy;8010;193;8203
84;Auvergne-Rhône-Alpes;74;4;07;114;Essert-Romand;513;6;519
84;Auvergne-Rhône-Alpes;74;2;11;116;Etaux;2012;69;2081
84;Auvergne-Rhône-Alpes;74;1;12;117;Étercy;822;21;843
84;Auvergne-Rhône-Alpes;74;3;09;118;Étrembières;2501;29;2530
84;Auvergne-Rhône-Alpes;74;4;07;119;Évian-les-Bains;9100;250;9350
84;Auvergne-Rhône-Alpes;74;4;15;121;Excenevex;1164;17;1181
84;Auvergne-Rhône-Alpes;74;2;05;122;Faucigny;634;21;655
84;Auvergne-Rhône-Alpes;74;1;08;123;Faverges-Seythenex;7608;236;7844
84;Auvergne-Rhône-Alpes;74;3;13;124;Feigères;1683;30;1713
84;Auvergne-Rhône-Alpes;74;4;15;126;Fessy;954;29;983
84;Auvergne-Rhône-Alpes;74;4;07;127;Féternes;1420;42;1462
84;Auvergne-Rhône-Alpes;74;1;03;282;Fillière;9331;233;9564
84;Auvergne-Rhône-Alpes;74;3;05;128;Fillinges;3479;87;3566
84;Auvergne-Rhône-Alpes;74;4;07;129;La Forclaz;232;4;236
84;Auvergne-Rhône-Alpes;74;3;13;130;Franclens;536;37;573
84;Auvergne-Rhône-Alpes;74;3;13;131;Frangy;2086;40;2126
84;Auvergne-Rhône-Alpes;74;3;09;133;Gaillard;10419;120;10539
84;Auvergne-Rhône-Alpes;74;2;07;134;Les Gets;1227;27;1254
84;Auvergne-Rhône-Alpes;74;1;08;135;Giez;532;8;540
84;Auvergne-Rhône-Alpes;74;2;  ;212;Glières-Val-de-Borne ;1809;31;1840
84;Auvergne-Rhône-Alpes;74;1;08;136;Le Grand-Bornand;2118;48;2166
84;Auvergne-Rhône-Alpes;74;1;03;137;Groisy;3717;142;3859
84;Auvergne-Rhône-Alpes;74;1;12;138;Gruffy;1545;63;1608
84;Auvergne-Rhône-Alpes;74;4;15;139;Habère-Lullin;1037;31;1068
84;Auvergne-Rhône-Alpes;74;4;15;140;Habère-Poche;1470;27;1497
84;Auvergne-Rhône-Alpes;74;1;12;141;Hauteville-sur-Fier;993;25;1018
84;Auvergne-Rhône-Alpes;74;1;12;142;Héry-sur-Alby;979;31;1010
84;Auvergne-Rhône-Alpes;74;2;10;143;Les Houches;2976;78;3054
84;Auvergne-Rhône-Alpes;74;3;13;144;Jonzier-Épagny;820;19;839
84;Auvergne-Rhône-Alpes;74;3;09;145;Juvigny;634;12;646
84;Auvergne-Rhône-Alpes;74;4;07;146;Larringes;1456;44;1500
84;Auvergne-Rhône-Alpes;74;1;08;147;Lathuile;1003;25;1028
84;Auvergne-Rhône-Alpes;74;1;16;148;Leschaux;273;7;280
84;Auvergne-Rhône-Alpes;74;4;15;150;Loisin;1598;29;1627
84;Auvergne-Rhône-Alpes;74;1;12;151;Lornay;566;9;575
84;Auvergne-Rhône-Alpes;74;1;01;152;Lovagny;1272;41;1313
84;Auvergne-Rhône-Alpes;74;3;09;153;Lucinges;1617;65;1682
84;Auvergne-Rhône-Alpes;74;4;07;154;Lugrin;2470;51;2521
84;Auvergne-Rhône-Alpes;74;4;17;155;Lullin;800;27;827
84;Auvergne-Rhône-Alpes;74;4;15;156;Lully;693;13;706
84;Auvergne-Rhône-Alpes;74;4;17;157;Lyaud;1737;63;1800
84;Auvergne-Rhône-Alpes;74;3;09;158;Machilly;1091;17;1108
84;Auvergne-Rhône-Alpes;74;2;14;159;Magland;3260;68;3328
84;Auvergne-Rhône-Alpes;74;1;08;160;Manigod;998;22;1020
84;Auvergne-Rhône-Alpes;74;2;05;162;Marcellaz;1044;18;1062
84;Auvergne-Rhône-Alpes;74;1;12;161;Marcellaz-Albanais;1930;57;1987
84;Auvergne-Rhône-Alpes;74;4;15;163;Margencel;2181;78;2259
84;Auvergne-Rhône-Alpes;74;2;05;164;Marignier;6412;187;6599
84;Auvergne-Rhône-Alpes;74;1;12;165;Marigny-Saint-Marcel;681;9;690
84;Auvergne-Rhône-Alpes;74;4;07;166;Marin;1807;51;1858
84;Auvergne-Rhône-Alpes;74;3;13;168;Marlioz;1041;11;1052
84;Auvergne-Rhône-Alpes;74;2;06;169;Marnaz;5607;116;5723
84;Auvergne-Rhône-Alpes;74;1;12;170;Massingy;878;19;897
84;Auvergne-Rhône-Alpes;74;4;15;171;Massongy;1533;34;1567
84;Auvergne-Rhône-Alpes;74;4;07;172;Maxilly-sur-Léman;1464;34;1498
84;Auvergne-Rhône-Alpes;74;2;14;173;Megève;3043;129;3172
84;Auvergne-Rhône-Alpes;74;2;05;174;Mégevette;592;25;617
84;Auvergne-Rhône-Alpes;74;4;07;175;Meillerie;312;5;317
84;Auvergne-Rhône-Alpes;74;1;08;176;Menthon-Saint-Bernard;1884;70;1954
84;Auvergne-Rhône-Alpes;74;3;11;177;Menthonnex-en-Bornes;1069;19;1088
84;Auvergne-Rhône-Alpes;74;3;13;178;Menthonnex-sous-Clermont;724;13;737
84;Auvergne-Rhône-Alpes;74;1;01;179;Mésigny;767;26;793
84;Auvergne-Rhône-Alpes;74;4;15;180;Messery;2148;49;2197
84;Auvergne-Rhône-Alpes;74;2;06;183;Mieussy;2380;63;2443
84;Auvergne-Rhône-Alpes;74;3;13;184;Minzier;1037;20;1057
84;Auvergne-Rhône-Alpes;74;3;11;185;Monnetier-Mornex;2304;46;2350
84;Auvergne-Rhône-Alpes;74;2;06;189;Mont-Saxonnex;1668;59;1727
84;Auvergne-Rhône-Alpes;74;1;16;186;Montagny-les-Lanches;705;20;725
84;Auvergne-Rhône-Alpes;74;4;07;188;Montriond;918;23;941
84;Auvergne-Rhône-Alpes;74;2;06;190;Morillon;678;13;691
84;Auvergne-Rhône-Alpes;74;4;07;191;Morzine;2743;74;2817
84;Auvergne-Rhône-Alpes;74;1;12;192;Moye;1000;38;1038
84;Auvergne-Rhône-Alpes;74;3;11;193;La Muraz;1052;11;1063
84;Auvergne-Rhône-Alpes;74;1;12;194;Mûres;839;23;862
84;Auvergne-Rhône-Alpes;74;3;13;195;Musièges;416;7;423
84;Auvergne-Rhône-Alpes;74;2;06;196;Nancy-sur-Cluses;462;15;477
84;Auvergne-Rhône-Alpes;74;3;11;197;Nangy;1578;34;1612
84;Auvergne-Rhône-Alpes;74;1;03;198;Nâves-Parmelan;982;39;1021
84;Auvergne-Rhône-Alpes;74;4;15;199;Nernier;376;7;383
84;Auvergne-Rhône-Alpes;74;4;07;200;Neuvecelle;3076;94;3170
84;Auvergne-Rhône-Alpes;74;3;13;201;Neydens;2032;22;2054
84;Auvergne-Rhône-Alpes;74;1;01;202;Nonglard;699;7;706
84;Auvergne-Rhône-Alpes;74;4;07;203;Novel;49;2;51
84;Auvergne-Rhône-Alpes;74;2;05;205;Onnion;1309;29;1338
84;Auvergne-Rhône-Alpes;74;4;17;206;Orcier;1018;18;1036
84;Auvergne-Rhône-Alpes;74;2;10;208;Passy;11203;409;11612
84;Auvergne-Rhône-Alpes;74;2;05;209;Peillonnex;1391;40;1431
84;Auvergne-Rhône-Alpes;74;4;17;210;Perrignier;1868;39;1907
84;Auvergne-Rhône-Alpes;74;3;11;211;Pers-Jussy;3080;89;3169
84;Auvergne-Rhône-Alpes;74;1;01;213;Poisy;8109;356;8465
84;Auvergne-Rhône-Alpes;74;2;14;215;Praz-sur-Arly;1236;36;1272
84;Auvergne-Rhône-Alpes;74;3;13;216;Présilly;1051;17;1068
84;Auvergne-Rhône-Alpes;74;4;07;218;Publier;7264;211;7475
84;Auvergne-Rhône-Alpes;74;1;16;219;Quintal;1253;51;1304
84;Auvergne-Rhône-Alpes;74;3;11;220;Reignier-Ésery;8033;202;8235
84;Auvergne-Rhône-Alpes;74;2;06;221;Le Reposoir;528;21;549
84;Auvergne-Rhône-Alpes;74;4;17;222;Reyvroz;507;9;516
84;Auvergne-Rhône-Alpes;74;2;06;223;La Rivière-Enverse;469;5;474
84;Auvergne-Rhône-Alpes;74;2;11;224;La Roche-sur-Foron;11175;341;11516
84;Auvergne-Rhône-Alpes;74;1;12;225;Rumilly;15373;369;15742
84;Auvergne-Rhône-Alpes;74;4;15;226;Saint-André-de-Boëge;558;11;569
84;Auvergne-Rhône-Alpes;74;3;11;228;Saint-Blaise;351;12;363
84;Auvergne-Rhône-Alpes;74;3;09;229;Saint-Cergues;3624;73;3697
84;Auvergne-Rhône-Alpes;74;1;12;231;Saint-Eusèbe;571;13;584
84;Auvergne-Rhône-Alpes;74;1;16;232;Saint-Eustache;506;21;527
84;Auvergne-Rhône-Alpes;74;1;12;233;Saint-Félix;2438;30;2468
84;Auvergne-Rhône-Alpes;74;1;08;234;Saint-Ferréol;874;22;896
84;Auvergne-Rhône-Alpes;74;3;13;235;Saint-Germain-sur-Rhône;556;11;567
84;Auvergne-Rhône-Alpes;74;2;10;236;Saint-Gervais-les-Bains;5590;129;5719
84;Auvergne-Rhône-Alpes;74;4;07;237;Saint-Gingolph;863;4;867
84;Auvergne-Rhône-Alpes;74;4;07;238;Saint-Jean-d'Aulps;1540;26;1566
84;Auvergne-Rhône-Alpes;74;1;08;239;Saint-Jean-de-Sixt;1457;38;1495
84;Auvergne-Rhône-Alpes;74;2;05;240;Saint-Jean-de-Tholome;1004;28;1032
84;Auvergne-Rhône-Alpes;74;2;05;241;Saint-Jeoire;3326;107;3433
84;Auvergne-Rhône-Alpes;74;1;16;242;Saint-Jorioz;5864;195;6059
84;Auvergne-Rhône-Alpes;74;3;13;243;Saint-Julien-en-Genevois;15509;249;15758
84;Auvergne-Rhône-Alpes;74;2;11;244;Saint-Laurent;837;34;871
84;Auvergne-Rhône-Alpes;74;4;07;249;Saint-Paul-en-Chablais;2393;80;2473
84;Auvergne-Rhône-Alpes;74;2;05;250;Saint-Pierre-en-Faucigny;6889;137;7026
84;Auvergne-Rhône-Alpes;74;2;06;252;Saint-Sigismond;591;33;624
84;Auvergne-Rhône-Alpes;74;2;11;253;Saint-Sixt;1020;38;1058
84;Auvergne-Rhône-Alpes;74;1;12;254;Saint-Sylvestre;606;16;622
84;Auvergne-Rhône-Alpes;74;1;12;255;Sales;1995;49;2044
84;Auvergne-Rhône-Alpes;74;2;14;256;Sallanches;16508;496;17004
84;Auvergne-Rhône-Alpes;74;1;01;257;Sallenôves;745;21;766
84;Auvergne-Rhône-Alpes;74;2;06;258;Samoëns;2468;63;2531
84;Auvergne-Rhône-Alpes;74;3;11;259;Le Sappey;421;8;429
84;Auvergne-Rhône-Alpes;74;3;13;260;Savigny;936;20;956
84;Auvergne-Rhône-Alpes;74;4;15;261;Saxel;483;8;491
84;Auvergne-Rhône-Alpes;74;3;11;262;Scientrier;1143;21;1164
84;Auvergne-Rhône-Alpes;74;4;15;263;Sciez;6190;140;6330
84;Auvergne-Rhône-Alpes;74;2;06;264;Scionzier;8808;136;8944
84;Auvergne-Rhône-Alpes;74;1;08;265;Serraval;697;72;769
84;Auvergne-Rhône-Alpes;74;2;10;266;Servoz;1041;35;1076
84;Auvergne-Rhône-Alpes;74;1;02;267;Sevrier;4150;181;4331
84;Auvergne-Rhône-Alpes;74;3;13;269;Seyssel;2336;78;2414
84;Auvergne-Rhône-Alpes;74;4;07;271;Seytroux;520;13;533
84;Auvergne-Rhône-Alpes;74;1;01;272;Sillingy;5348;129;5477
84;Auvergne-Rhône-Alpes;74;2;06;273;Sixt-Fer-à-Cheval;764;18;782
84;Auvergne-Rhône-Alpes;74;1;08;275;Talloires-Montmin;1971;68;2039
84;Auvergne-Rhône-Alpes;74;2;06;276;Taninges;3411;71;3482
84;Auvergne-Rhône-Alpes;74;4;07;279;Thollon-les-Mémises;812;24;836
84;Auvergne-Rhône-Alpes;74;1;08;280;Thônes;6597;293;6890
84;Auvergne-Rhône-Alpes;74;4;17;281;Thonon-les-Bains;35241;1142;36383
84;Auvergne-Rhône-Alpes;74;1;12;283;Thusy;1116;19;1135
84;Auvergne-Rhône-Alpes;74;2;06;278;Thyez;6289;148;6437
84;Auvergne-Rhône-Alpes;74;2;05;284;La Tour;1288;25;1313
84;Auvergne-Rhône-Alpes;74;3;13;285;Usinens;408;9;417
84;Auvergne-Rhône-Alpes;74;4;07;286;Vacheresse;860;17;877
84;Auvergne-Rhône-Alpes;74;4;17;287;Vailly;912;20;932
84;Auvergne-Rhône-Alpes;74;1;08;167;Val de Chaise;1373;24;1397
84;Auvergne-Rhône-Alpes;74;3;13;288;Valleiry;4866;59;4925
84;Auvergne-Rhône-Alpes;74;1;12;289;Vallières-sur-Fier ;2533;58;2591
84;Auvergne-Rhône-Alpes;74;2;10;290;Vallorcine;404;12;416
84;Auvergne-Rhône-Alpes;74;3;13;291;Vanzy;333;4;337
84;Auvergne-Rhône-Alpes;74;1;12;292;Vaulx;1000;30;1030
84;Auvergne-Rhône-Alpes;74;4;15;293;Veigy-Foncenex;3802;43;3845
84;Auvergne-Rhône-Alpes;74;2;06;294;Verchaix;755;21;776
84;Auvergne-Rhône-Alpes;74;4;07;295;La Vernaz;340;5;345
84;Auvergne-Rhône-Alpes;74;3;13;296;Vers;894;17;911
84;Auvergne-Rhône-Alpes;74;1;12;297;Versonnex;615;24;639
84;Auvergne-Rhône-Alpes;74;3;09;298;Vétraz-Monthoux;8969;265;9234
84;Auvergne-Rhône-Alpes;74;1;08;299;Veyrier-du-Lac;2263;81;2344
84;Auvergne-Rhône-Alpes;74;4;15;301;Villard;858;18;876
84;Auvergne-Rhône-Alpes;74;1;08;302;Les Villards-sur-Thônes;1066;37;1103
84;Auvergne-Rhône-Alpes;74;1;03;303;Villaz;3387;126;3513
84;Auvergne-Rhône-Alpes;74;2;05;304;Ville-en-Sallaz;922;10;932
84;Auvergne-Rhône-Alpes;74;3;04;305;Ville-la-Grand;8926;118;9044
84;Auvergne-Rhône-Alpes;74;3;11;306;Villy-le-Bouveret;591;17;608
84;Auvergne-Rhône-Alpes;74;1;11;307;Villy-le-Pelloux;963;16;979
84;Auvergne-Rhône-Alpes;74;4;07;308;Vinzier;826;22;848
84;Auvergne-Rhône-Alpes;74;3;13;309;Viry;5299;80;5379
84;Auvergne-Rhône-Alpes;74;2;05;311;Viuz-en-Sallaz;4427;79;4506
84;Auvergne-Rhône-Alpes;74;1;12;310;Viuz-la-Chiésaz;1315;33;1348
84;Auvergne-Rhône-Alpes;74;2;05;312;Vougy;1590;28;1618
84;Auvergne-Rhône-Alpes;74;3;11;313;Vovray-en-Bornes;541;10;551
84;Auvergne-Rhône-Alpes;74;3;13;314;Vulbens;1614;57;1671
84;Auvergne-Rhône-Alpes;74;4;15;315;Yvoire;1015;18;1033
11;Île-de-France;75;1;null;101;Paris 1er Arrondissement;16093;143;16236
11;Île-de-France;75;1;null;102;Paris 2e Arrondissement;21420;141;21561
11;Île-de-France;75;1;null;103;Paris 3e Arrondissement;34020;285;34305
11;Île-de-France;75;1;null;104;Paris 4e Arrondissement;28763;255;29018
11;Île-de-France;75;1;null;105;Paris 5e Arrondissement;58379;671;59050
11;Île-de-France;75;1;null;106;Paris 6e Arrondissement;40525;859;41384
11;Île-de-France;75;1;null;107;Paris 7e Arrondissement;50196;818;51014
11;Île-de-France;75;1;null;108;Paris 8e Arrondissement;36222;605;36827
11;Île-de-France;75;1;null;109;Paris 9e Arrondissement;59835;535;60370
11;Île-de-France;75;1;null;110;Paris 10e Arrondissement;88557;414;88971
11;Île-de-France;75;1;null;111;Paris 11e Arrondissement;145903;832;146735
11;Île-de-France;75;1;null;112;Paris 12e Arrondissement;139665;940;140605
11;Île-de-France;75;1;null;113;Paris 13e Arrondissement;180632;1227;181859
11;Île-de-France;75;1;null;114;Paris 14e Arrondissement;136596;978;137574
11;Île-de-France;75;1;null;115;Paris 15e Arrondissement;232144;1711;233855
11;Île-de-France;75;1;null;116;Paris 16e Arrondissement;166014;2272;168286
11;Île-de-France;75;1;null;117;Paris 17e Arrondissement;165859;1425;167284
11;Île-de-France;75;1;null;118;Paris 18e Arrondissement;193665;826;194491
11;Île-de-France;75;1;null;119;Paris 19e Arrondissement;185513;1017;186530
11;Île-de-France;75;1;null;120;Paris 20e Arrondissement;195600;930;196530
28;Normandie;76;3;35;001;Allouville-Bellefosse;1158;19;1177
28;Normandie;76;2;33;002;Alvimare;625;9;634
28;Normandie;76;1;07;004;Ambrumesnil;470;14;484
28;Normandie;76;3;06;005;Amfreville-la-Mi-Voie;3324;30;3354
28;Normandie;76;3;35;006;Amfreville-les-Champs;168;4;172
28;Normandie;76;3;02;007;Anceaumeville;661;10;671
28;Normandie;76;1;08;008;Ancourt;642;10;652
28;Normandie;76;1;33;009;Ancourteville-sur-Héricourt;338;4;342
28;Normandie;76;3;35;010;Ancretiéville-Saint-Victor;372;6;378
28;Normandie;76;2;11;011;Ancretteville-sur-Mer;161;4;165
28;Normandie;76;2;32;012;Angerville-Bailleul;188;3;191
28;Normandie;76;2;26;014;Angerville-l'Orcher;1415;15;1430
28;Normandie;76;2;11;013;Angerville-la-Martel;1071;30;1101
28;Normandie;76;1;33;015;Angiens;513;11;524
28;Normandie;76;2;26;017;Anglesqueville-l'Esneval;623;6;629
28;Normandie;76;1;33;016;Anglesqueville-la-Bras-Long;119;2;121
28;Normandie;76;3;01;020;Anneville-Ambourville;1193;23;1216
28;Normandie;76;1;20;019;Anneville-sur-Scie;425;10;435
28;Normandie;76;2;32;021;Annouville-Vilmesnil;471;7;478
28;Normandie;76;3;25;022;Anquetierville;336;13;349
28;Normandie;76;3;35;023;Anvéville;295;5;300
28;Normandie;76;1;23;024;Ardouval;159;4;163
28;Normandie;76;3;25;401;Arelaune-en-Seine;2549;45;2594
28;Normandie;76;1;12;025;Argueil;342;8;350
28;Normandie;76;1;08;026;Arques-la-Bataille;2590;52;2642
28;Normandie;76;1;12;028;Aubéguimont;192;1;193
28;Normandie;76;1;10;029;Aubermesnil-aux-Érables;201;3;204
28;Normandie;76;1;07;030;Aubermesnil-Beaumais;486;3;489
28;Normandie;76;1;33;032;Auberville-la-Manuel;133;1;134
28;Normandie;76;2;32;033;Auberville-la-Renault;460;6;466
28;Normandie;76;1;12;035;Aumale;2013;53;2066
28;Normandie;76;1;20;036;Auppegard;704;19;723
28;Normandie;76;3;02;038;Authieux-Ratiéville;403;3;406
28;Normandie;76;3;06;039;Les Authieux-sur-le-Port-Saint-Ouen;1268;26;1294
28;Normandie;76;1;33;040;Autigny;310;0;310
28;Normandie;76;1;23;042;Auvilliers;102;0;102
28;Normandie;76;3;35;043;Auzebosc;1125;361;1486
28;Normandie;76;3;35;045;Auzouville-l'Esneval;358;9;367
28;Normandie;76;3;21;046;Auzouville-sur-Ry;715;12;727
28;Normandie;76;1;20;047;Auzouville-sur-Saâne;151;1;152
28;Normandie;76;1;12;048;Avesnes-en-Bray;296;6;302
28;Normandie;76;1;23;049;Avesnes-en-Val;279;6;285
28;Normandie;76;1;20;050;Avremesnil;1013;27;1040
28;Normandie;76;1;20;051;Bacqueville-en-Caux;1906;38;1944
28;Normandie;76;1;23;052;Bailleul-Neuville;218;1;219
28;Normandie;76;1;23;053;Baillolet;108;1;109
28;Normandie;76;1;08;054;Bailly-en-Rivière;523;4;527
28;Normandie;76;3;35;055;Baons-le-Comte;343;17;360
28;Normandie;76;3;01;056;Bardouville;637;6;643
28;Normandie;76;3;01;057;Barentin;12211;227;12438
28;Normandie;76;1;10;058;Baromesnil;223;5;228
28;Normandie;76;1;10;059;Bazinval;414;11;425
28;Normandie;76;1;12;060;Beaubec-la-Rosière;499;13;512
28;Normandie;76;3;23;062;Beaumont-le-Hareng;263;3;266
28;Normandie;76;2;26;064;Beaurepaire;494;13;507
28;Normandie;76;1;12;065;Beaussault;410;4;414
28;Normandie;76;1;20;066;Beautot;148;4;152
28;Normandie;76;1;20;063;Beauval-en-Caux;482;10;492
28;Normandie;76;1;12;067;Beauvoir-en-Lyons;607;14;621
28;Normandie;76;2;32;068;Bec-de-Mortagne;648;17;665
28;Normandie;76;3;06;069;Belbeuf;2217;51;2268
28;Normandie;76;1;23;070;Bellencombre;652;11;663
28;Normandie;76;1;08;071;Bellengreville;474;8;482
28;Normandie;76;1;20;072;Belleville-en-Caux;728;12;740
28;Normandie;76;1;12;074;La Bellière;56;0;56
28;Normandie;76;1;20;075;Belmesnil;455;2;457
28;Normandie;76;2;32;076;Bénarville;267;5;272
28;Normandie;76;3;35;077;Bénesville;187;5;192
28;Normandie;76;2;26;079;Bénouville;183;1;184
28;Normandie;76;2;03;082;Bernières;638;6;644
28;Normandie;76;1;33;083;Bertheauville;102;1;103
28;Normandie;76;1;33;084;Bertreville;120;1;121
28;Normandie;76;1;20;085;Bertreville-Saint-Ouen;337;10;347
28;Normandie;76;1;20;086;Bertrimont;216;5;221
28;Normandie;76;3;35;087;Berville-en-Caux;665;10;675
28;Normandie;76;3;01;088;Berville-sur-Seine;552;9;561
28;Normandie;76;2;03;090;Beuzeville-la-Grenier;1236;17;1253
28;Normandie;76;1;33;091;Beuzeville-la-Guérard;227;2;229
28;Normandie;76;2;03;092;Beuzevillette;637;10;647
28;Normandie;76;1;12;093;Bézancourt;354;13;367
28;Normandie;76;3;21;094;Bierville;320;3;323
28;Normandie;76;3;02;095;Bihorel;8331;167;8498
28;Normandie;76;1;20;096;Biville-la-Baignarde;662;12;674
28;Normandie;76;1;20;097;Biville-la-Rivière;107;0;107
28;Normandie;76;3;01;099;Blacqueville;712;9;721
28;Normandie;76;3;21;100;Blainville-Crevon;1207;17;1224
28;Normandie;76;1;10;101;Blangy-sur-Bresle;2932;34;2966
28;Normandie;76;1;33;104;Blosseville;253;14;267
28;Normandie;76;3;02;105;Le Bocasse;665;7;672
28;Normandie;76;3;21;106;Bois-d'Ennebourg;559;7;566
28;Normandie;76;3;21;107;Bois-Guilbert;307;4;311
28;Normandie;76;3;02;108;Bois-Guillaume;14309;400;14709
28;Normandie;76;3;21;109;Bois-Héroult;191;4;195
28;Normandie;76;3;35;110;Bois-Himont;470;5;475
28;Normandie;76;3;21;111;Bois-l'Évêque;578;10;588
28;Normandie;76;1;20;112;Le Bois-Robert;351;8;359
28;Normandie;76;3;21;113;Boissay;406;6;412
28;Normandie;76;2;03;114;Bolbec;11605;135;11740
28;Normandie;76;2;25;115;Bolleville;578;3;581
28;Normandie;76;3;06;103;Bonsecours;6429;104;6533
28;Normandie;76;3;21;116;Boos;3867;45;3912
28;Normandie;76;2;26;117;Bordeaux-Saint-Clair;659;20;679
28;Normandie;76;2;32;118;Bornambusc;256;8;264
28;Normandie;76;1;23;119;Bosc-Bérenger;198;2;200
28;Normandie;76;3;21;120;Bosc-Bordel;451;10;461
28;Normandie;76;3;21;121;Bosc-Édeline;362;3;365
28;Normandie;76;3;02;123;Bosc-Guérard-Saint-Adrien;973;26;999
28;Normandie;76;1;12;124;Bosc-Hyons;420;8;428
28;Normandie;76;3;23;125;Bosc-le-Hard;1497;18;1515
28;Normandie;76;1;23;126;Bosc-Mesnil;315;6;321
28;Normandie;76;1;33;128;Bosville;579;15;594
28;Normandie;76;3;35;129;Boudeville;207;6;213
28;Normandie;76;1;23;130;Bouelles;282;3;285
28;Normandie;76;3;09;131;La Bouille;738;10;748
28;Normandie;76;3;35;132;Bourdainville;464;2;466
28;Normandie;76;1;33;133;Le Bourg-Dun;430;9;439
28;Normandie;76;1;33;134;Bourville;302;4;306
28;Normandie;76;3;01;135;Bouville;989;13;1002
28;Normandie;76;1;20;136;Brachy;745;12;757
28;Normandie;76;1;23;138;Bracquetuit;330;5;335
28;Normandie;76;1;23;139;Bradiancourt;218;3;221
28;Normandie;76;1;33;140;Brametot;203;2;205
28;Normandie;76;2;32;141;Bréauté;1350;13;1363
28;Normandie;76;1;12;142;Brémontier-Merval;457;126;583
28;Normandie;76;2;32;143;Bretteville-du-Grand-Caux;1353;22;1375
28;Normandie;76;3;35;144;Bretteville-Saint-Laurent;157;2;159
28;Normandie;76;3;21;146;Buchy ;2825;100;2925
28;Normandie;76;1;23;147;Bully;917;22;939
28;Normandie;76;1;23;148;Bures-en-Bray;325;4;329
28;Normandie;76;3;35;149;Butot;282;5;287
28;Normandie;76;1;33;732;Butot-Vénesville;244;4;248
28;Normandie;76;1;33;151;Cailleville;262;10;272
28;Normandie;76;3;21;152;Cailly;776;4;780
28;Normandie;76;1;23;122;Callengeville;510;8;518
28;Normandie;76;1;20;153;Calleville-les-Deux-Églises;328;3;331
28;Normandie;76;1;10;154;Campneuseville;477;12;489
28;Normandie;76;1;10;155;Canehan;368;3;371
28;Normandie;76;1;33;156;Canouville;344;9;353
28;Normandie;76;3;04;157;Canteleu;14244;397;14641
28;Normandie;76;3;35;158;Canville-les-Deux-Églises;327;2;329
28;Normandie;76;1;33;159;Cany-Barville;3051;55;3106
28;Normandie;76;3;24;160;Carville-la-Folletière;415;10;425
28;Normandie;76;3;35;161;Carville-Pot-de-Fer;101;3;104
28;Normandie;76;1;20;162;Le Catelier;266;5;271
28;Normandie;76;3;21;163;Catenay;678;10;688
28;Normandie;76;3;05;165;Caudebec-lès-Elbeuf;10156;69;10225
28;Normandie;76;1;12;166;Le Caule-Sainte-Beuve;485;4;489
28;Normandie;76;2;26;167;Cauville-sur-Mer;1571;27;1598
28;Normandie;76;1;20;168;Les Cent-Acres;64;1;65
28;Normandie;76;2;32;169;La Cerlangue;1282;112;1394
28;Normandie;76;1;20;170;La Chapelle-du-Bourgay;124;1;125
28;Normandie;76;1;12;171;La Chapelle-Saint-Ouen;132;1;133
28;Normandie;76;1;33;172;La Chapelle-sur-Dun;159;3;162
28;Normandie;76;1;20;173;La Chaussée;542;6;548
28;Normandie;76;3;35;174;Cideville;396;5;401
28;Normandie;76;1;23;175;Clais;259;7;266
28;Normandie;76;1;33;176;Clasville;333;7;340
28;Normandie;76;3;02;177;Claville-Motteville;281;6;287
28;Normandie;76;3;05;178;Cléon;4943;25;4968
28;Normandie;76;3;02;179;Clères;1372;16;1388
28;Normandie;76;1;33;180;Cleuville;193;8;201
28;Normandie;76;2;33;181;Cléville;155;2;157
28;Normandie;76;2;33;182;Cliponville;269;2;271
28;Normandie;76;2;11;183;Colleville;761;18;779
28;Normandie;76;1;07;184;Colmesnil-Manneville;108;3;111
28;Normandie;76;1;12;185;Compainville;173;4;177
28;Normandie;76;1;12;186;Conteville;496;3;499
28;Normandie;76;2;11;187;Contremoulins;159;3;162
28;Normandie;76;3;23;188;Cottévrard;473;4;477
28;Normandie;76;1;33;189;Crasville-la-Mallet;153;6;159
28;Normandie;76;1;33;190;Crasville-la-Rocquefort;211;3;214
28;Normandie;76;1;10;192;Criel-sur-Mer;2655;54;2709
28;Normandie;76;1;23;193;La Crique;343;5;348
28;Normandie;76;2;11;194;Criquebeuf-en-Caux;404;3;407
28;Normandie;76;2;26;196;Criquetot-l'Esneval;2561;100;2661
28;Normandie;76;2;11;195;Criquetot-le-Mauconduit;175;1;176
28;Normandie;76;1;20;197;Criquetot-sur-Longueville;225;2;227
28;Normandie;76;3;35;198;Criquetot-sur-Ouville;808;19;827
28;Normandie;76;1;12;199;Criquiers;671;9;680
28;Normandie;76;1;23;200;Critot;459;12;471
28;Normandie;76;1;12;201;Croisy-sur-Andelle;544;4;548
28;Normandie;76;3;24;203;Croix-Mare;781;7;788
28;Normandie;76;1;23;202;Croixdalle;313;4;317
28;Normandie;76;1;23;204;Cropus;251;1;252
28;Normandie;76;1;20;205;Crosville-sur-Scie;248;2;250
28;Normandie;76;2;26;206;Cuverville;348;5;353
28;Normandie;76;1;10;207;Cuverville-sur-Yères;200;6;206
28;Normandie;76;1;12;208;Cuy-Saint-Fiacre;663;17;680
28;Normandie;76;1;12;209;Dampierre-en-Bray;447;8;455
28;Normandie;76;1;08;210;Dampierre-Saint-Nicolas;465;2;467
28;Normandie;76;1;10;211;Dancourt;229;2;231
28;Normandie;76;3;06;212;Darnétal;9773;84;9857
28;Normandie;76;2;32;213;Daubeuf-Serville;402;9;411
28;Normandie;76;1;20;214;Dénestanville;267;1;268
28;Normandie;76;3;22;216;Déville-lès-Rouen;10461;73;10534
28;Normandie;76;1;95;217;Dieppe;28561;478;29039
28;Normandie;76;1;12;218;Doudeauville;93;2;95
28;Normandie;76;3;35;219;Doudeville;2482;44;2526
28;Normandie;76;1;08;220;Douvrend;522;12;534
28;Normandie;76;1;33;221;Drosay;196;5;201
28;Normandie;76;3;01;222;Duclair;4135;53;4188
28;Normandie;76;3;24;223;Écalles-Alix;521;6;527
28;Normandie;76;2;32;224;Écrainville;999;19;1018
28;Normandie;76;3;35;225;Écretteville-lès-Baons;381;12;393
28;Normandie;76;2;11;226;Écretteville-sur-Mer;161;2;163
28;Normandie;76;3;35;227;Ectot-l'Auber;689;11;700
28;Normandie;76;3;35;228;Ectot-lès-Baons;392;7;399
28;Normandie;76;3;09;231;Elbeuf;16205;124;16329
28;Normandie;76;1;12;229;Elbeuf-en-Bray;412;14;426
28;Normandie;76;3;21;230;Elbeuf-sur-Andelle;473;6;479
28;Normandie;76;2;11;232;Életot;648;9;657
28;Normandie;76;1;12;233;Ellecourt;149;4;153
28;Normandie;76;3;24;234;Émanville;709;11;720
28;Normandie;76;1;08;235;Envermeu;2051;178;2229
28;Normandie;76;2;33;236;Envronville;349;1;350
28;Normandie;76;3;01;237;Épinay-sur-Duclair;519;8;527
28;Normandie;76;2;26;238;Épouville;2670;39;2709
28;Normandie;76;2;32;239;Épretot;754;13;767
28;Normandie;76;2;11;240;Épreville;1021;13;1034
28;Normandie;76;1;33;241;Ermenouville;137;6;143
28;Normandie;76;1;12;242;Ernemont-la-Villette;185;4;189
28;Normandie;76;3;21;243;Ernemont-sur-Buchy;298;2;300
28;Normandie;76;1;23;244;Esclavelles;377;6;383
28;Normandie;76;3;24;245;Eslettes;1578;16;1594
28;Normandie;76;3;02;247;Esteville;495;4;499
28;Normandie;76;1;20;249;Étaimpuis;804;11;815
28;Normandie;76;2;32;250;Étainhus;1197;26;1223
28;Normandie;76;3;35;251;Étalleville;448;3;451
28;Normandie;76;1;10;252;Étalondes;1043;28;1071
28;Normandie;76;3;35;253;Étoutteville;814;14;828
28;Normandie;76;2;26;254;Étretat;1242;6;1248
28;Normandie;76;1;10;255;Eu;6771;201;6972
28;Normandie;76;1;10;257;Fallencourt;183;2;185
28;Normandie;76;2;11;259;Fécamp;18251;289;18540
28;Normandie;76;1;12;260;Ferrières-en-Bray;1674;19;1693
28;Normandie;76;1;12;261;La Ferté-Saint-Samson;462;10;472
28;Normandie;76;1;23;262;Fesques;127;2;129
28;Normandie;76;1;12;263;La Feuillie;1293;22;1315
28;Normandie;76;3;35;264;Flamanville;488;11;499
28;Normandie;76;1;23;265;Flamets-Frétils;164;8;172
28;Normandie;76;1;10;266;Flocques;708;15;723
28;Normandie;76;2;26;268;Fongueusemare;187;5;192
28;Normandie;76;1;23;269;Fontaine-en-Bray;175;3;178
28;Normandie;76;2;26;270;Fontaine-la-Mallet;2630;53;2683
28;Normandie;76;3;02;271;Fontaine-le-Bourg;1784;18;1802
28;Normandie;76;1;33;272;Fontaine-le-Dun;901;17;918
28;Normandie;76;3;06;273;Fontaine-sous-Préaux;525;14;539
28;Normandie;76;1;20;274;La Fontelaye;29;0;29
28;Normandie;76;2;26;275;Fontenay;1381;22;1403
28;Normandie;76;1;12;276;Forges-les-Eaux ;3813;198;4011
28;Normandie;76;1;10;278;Foucarmont;806;13;819
28;Normandie;76;2;33;279;Foucart;354;10;364
28;Normandie;76;3;21;475;Franqueville-Saint-Pierre;6111;194;6305
28;Normandie;76;1;23;280;Fréauville;131;1;132
28;Normandie;76;2;25;281;La Frénaye;2114;45;2159
28;Normandie;76;3;05;282;Freneuse;951;10;961
28;Normandie;76;1;23;283;Fresles;238;4;242
28;Normandie;76;1;20;284;Fresnay-le-Long;331;5;336
28;Normandie;76;3;21;285;Fresne-le-Plan;592;8;600
28;Normandie;76;1;23;286;Fresnoy-Folny;686;7;693
28;Normandie;76;3;24;287;Fresquiennes;1021;13;1034
28;Normandie;76;1;08;288;Freulleville;362;4;366
28;Normandie;76;3;02;290;Frichemesnil;405;11;416
28;Normandie;76;2;11;291;Froberville;1219;26;1245
28;Normandie;76;1;12;292;Fry;146;3;149
28;Normandie;76;3;35;293;Fultot;231;0;231
28;Normandie;76;1;33;294;La Gaillarde;382;8;390
28;Normandie;76;1;12;295;Gaillefontaine;1223;9;1232
28;Normandie;76;2;16;296;Gainneville;2553;31;2584
28;Normandie;76;1;12;297;Gancourt-Saint-Étienne;229;7;236
28;Normandie;76;2;11;298;Ganzeville;475;5;480
28;Normandie;76;2;11;299;Gerponville;395;4;399
28;Normandie;76;2;11;300;Gerville;430;4;434
28;Normandie;76;2;32;302;Goderville;2863;41;2904
28;Normandie;76;2;32;303;Gommerville;731;9;740
28;Normandie;76;2;32;304;Gonfreville-Caillot;361;1;362
28;Normandie;76;2;16;305;Gonfreville-l'Orcher;9162;58;9220
28;Normandie;76;1;20;306;Gonnetot;187;2;189
28;Normandie;76;2;26;307;Gonneville-la-Mallet;1348;19;1367
28;Normandie;76;1;20;308;Gonneville-sur-Scie;484;7;491
28;Normandie;76;3;35;309;Gonzeville;120;2;122
28;Normandie;76;3;24;311;Goupillières;417;5;422
28;Normandie;76;1;12;312;Gournay-en-Bray;6051;97;6148
28;Normandie;76;3;06;313;Gouy;879;14;893
28;Normandie;76;2;32;314;Graimbouville;614;9;623
28;Normandie;76;1;33;315;Grainville-la-Teinturière;1081;18;1099
28;Normandie;76;3;21;316;Grainville-sur-Ry;444;4;448
28;Normandie;76;2;32;317;Grainville-Ymauville;436;12;448
28;Normandie;76;2;25;318;Grand-Camp;723;26;749
28;Normandie;76;3;09;319;Grand-Couronne;9716;191;9907
28;Normandie;76;3;13;322;Le Grand-Quevilly;25771;248;26019
28;Normandie;76;1;23;320;Grandcourt;334;4;338
28;Normandie;76;1;23;321;Les Grandes-Ventes;1801;28;1829
28;Normandie;76;1;23;323;Graval;149;2;151
28;Normandie;76;1;08;324;Grèges;843;15;858
28;Normandie;76;3;35;325;Grémonville;438;5;443
28;Normandie;76;1;20;327;Greuville;377;5;382
28;Normandie;76;3;23;328;Grigneuseville;375;5;380
28;Normandie;76;2;03;329;Gruchet-le-Valasse;3163;37;3200
28;Normandie;76;1;20;330;Gruchet-Saint-Siméon;687;20;707
28;Normandie;76;3;02;331;Grugny;1009;5;1014
28;Normandie;76;1;12;332;Grumesnil;432;2;434
28;Normandie;76;1;10;333;Guerville;468;5;473
28;Normandie;76;1;20;334;Gueures;525;19;544
28;Normandie;76;1;20;335;Gueutteville;86;0;86
28;Normandie;76;1;33;336;Gueutteville-les-Grès;375;11;386
28;Normandie;76;1;12;338;La Hallotière;223;1;224
28;Normandie;76;1;33;339;Le Hanouard;253;3;256
28;Normandie;76;3;35;340;Harcanville;511;7;518
28;Normandie;76;2;15;341;Harfleur;8395;65;8460
28;Normandie;76;2;33;342;Hattenville;721;17;738
28;Normandie;76;1;12;343;Haucourt;200;4;204
28;Normandie;76;1;12;344;Haudricourt;411;10;421
28;Normandie;76;1;12;345;Haussez;281;2;283
28;Normandie;76;1;33;346;Hautot-l'Auvray;319;8;327
28;Normandie;76;3;35;347;Hautot-le-Vatois;355;6;361
28;Normandie;76;3;35;348;Hautot-Saint-Sulpice;685;8;693
28;Normandie;76;1;07;349;Hautot-sur-Mer;1904;71;1975
28;Normandie;76;3;04;350;Hautot-sur-Seine;406;7;413
28;Normandie;76;3;35;041;Hauts-de-Caux ;1363;36;1399
28;Normandie;76;2;96;351;Le Havre;169733;1854;171587
28;Normandie;76;1;12;352;La Haye;377;3;380
28;Normandie;76;1;33;353;Héberville;112;6;118
28;Normandie;76;3;01;354;Hénouville;1307;14;1321
28;Normandie;76;3;35;355;Héricourt-en-Caux;945;13;958
28;Normandie;76;1;20;356;Hermanville;116;2;118
28;Normandie;76;2;26;357;Hermeville;360;16;376
28;Normandie;76;1;12;358;Le Héron;250;1;251
28;Normandie;76;3;21;359;Héronchelles;141;2;143
28;Normandie;76;1;20;360;Heugleville-sur-Scie;636;7;643
28;Normandie;76;2;26;361;Heuqueville;716;10;726
28;Normandie;76;3;25;362;Heurteauville;304;7;311
28;Normandie;76;1;10;363;Hodeng-au-Bosc;571;8;579
28;Normandie;76;1;12;364;Hodeng-Hodenger;277;5;282
28;Normandie;76;1;33;365;Houdetot;184;0;184
28;Normandie;76;3;24;366;Le Houlme;4033;29;4062
28;Normandie;76;3;24;367;Houppeville;2815;46;2861
28;Normandie;76;2;32;368;Houquetot;346;6;352
28;Normandie;76;3;02;369;La Houssaye-Béranger;534;7;541
28;Normandie;76;3;35;370;Hugleville-en-Caux;425;3;428
28;Normandie;76;1;08;371;Les Ifs;73;0;73
28;Normandie;76;1;12;372;Illois;406;3;409
28;Normandie;76;1;20;373;Imbleville;305;6;311
28;Normandie;76;1;10;374;Incheville;1238;15;1253
28;Normandie;76;1;33;375;Ingouville;272;14;286
28;Normandie;76;3;02;377;Isneauville;3315;68;3383
28;Normandie;76;3;01;378;Jumièges;1715;34;1749
28;Normandie;76;1;20;379;Lamberville;194;2;196
28;Normandie;76;1;20;380;Lammerville;326;8;334
28;Normandie;76;1;12;381;Landes-Vieilles-et-Neuves;134;1;135
28;Normandie;76;2;03;382;Lanquetot;1156;13;1169
28;Normandie;76;1;20;383;Lestanville;95;0;95
28;Normandie;76;2;03;384;Lillebonne;8845;146;8991
28;Normandie;76;3;24;385;Limésy;1510;53;1563
28;Normandie;76;2;11;386;Limpiville;376;6;382
28;Normandie;76;3;35;387;Lindebeuf;393;7;400
28;Normandie;76;2;25;388;Lintot;460;3;463
28;Normandie;76;1;20;389;Lintot-les-Bois;184;7;191
28;Normandie;76;2;11;390;Les Loges;1132;22;1154
28;Normandie;76;3;09;391;La Londe;2346;66;2412
28;Normandie;76;1;23;392;Londinières;1265;14;1279
28;Normandie;76;1;12;393;Longmesnil;50;0;50
28;Normandie;76;1;10;394;Longroy;632;5;637
28;Normandie;76;1;07;395;Longueil;561;11;572
28;Normandie;76;3;21;396;Longuerue;330;2;332
28;Normandie;76;1;20;397;Longueville-sur-Scie;988;25;1013
28;Normandie;76;3;25;398;Louvetot;741;6;747
28;Normandie;76;1;23;399;Lucy;192;1;193
28;Normandie;76;1;20;400;Luneray;2190;36;2226
28;Normandie;76;3;24;402;Malaunay;6126;48;6174
28;Normandie;76;1;33;403;Malleville-les-Grès;203;3;206
28;Normandie;76;2;26;404;Manéglise;1244;22;1266
28;Normandie;76;1;20;405;Manéhouville;225;1;226
28;Normandie;76;2;11;406;Maniquerville;417;6;423
28;Normandie;76;1;33;407;Manneville-ès-Plains;292;8;300
28;Normandie;76;2;32;408;Manneville-la-Goupil;1028;14;1042
28;Normandie;76;2;26;409;Mannevillette;869;12;881
28;Normandie;76;3;04;410;Maromme;10730;138;10868
28;Normandie;76;1;12;411;Marques;233;1;234
28;Normandie;76;3;21;412;Martainville-Épreville;693;11;704
28;Normandie;76;1;07;413;Martigny;432;6;438
28;Normandie;76;1;08;414;Martin-Église;1600;51;1651
28;Normandie;76;1;23;415;Massy;336;5;341
28;Normandie;76;1;23;416;Mathonville;319;5;324
28;Normandie;76;1;23;417;Maucomble;414;3;417
28;Normandie;76;3;25;418;Maulévrier-Sainte-Gertrude;1004;20;1024
28;Normandie;76;3;01;419;Mauny;168;6;174
28;Normandie;76;1;12;420;Mauquenchy;355;6;361
28;Normandie;76;2;03;421;Mélamare;905;14;919
28;Normandie;76;1;10;422;Melleville;264;8;272
28;Normandie;76;1;12;423;Ménerval;168;2;170
28;Normandie;76;1;23;424;Ménonval;224;1;225
28;Normandie;76;2;32;425;Mentheville;294;5;299
28;Normandie;76;1;12;426;Mésangueville;162;1;163
28;Normandie;76;1;23;427;Mesnières-en-Bray;920;249;1169
28;Normandie;76;1;33;428;Le Mesnil-Durdent;18;3;21
28;Normandie;76;3;21;429;Le Mesnil-Esnard;7927;344;8271
28;Normandie;76;1;23;430;Mesnil-Follemprise;124;3;127
28;Normandie;76;1;12;431;Le Mesnil-Lieubray;97;3;100
28;Normandie;76;1;12;432;Mesnil-Mauger;246;4;250
28;Normandie;76;3;24;433;Mesnil-Panneville;727;7;734
28;Normandie;76;3;21;434;Mesnil-Raoul;1058;7;1065
28;Normandie;76;1;10;435;Le Mesnil-Réaume;793;16;809
28;Normandie;76;3;01;436;Le Mesnil-sous-Jumièges;629;4;633
28;Normandie;76;1;08;437;Meulers;554;5;559
28;Normandie;76;1;10;438;Millebosc;244;5;249
28;Normandie;76;2;03;439;Mirville;339;9;348
28;Normandie;76;1;12;440;Molagnies;186;4;190
28;Normandie;76;1;10;441;Monchaux-Soreng;643;11;654
28;Normandie;76;1;10;442;Monchy-sur-Eu;590;9;599
28;Normandie;76;3;02;443;Mont-Cauvaire;790;15;805
28;Normandie;76;3;22;451;Mont-Saint-Aignan;19262;373;19635
28;Normandie;76;1;23;445;Montérolier;596;7;603
28;Normandie;76;3;24;446;Montigny;1252;17;1269
28;Normandie;76;2;15;447;Montivilliers;15564;238;15802
28;Normandie;76;3;21;448;Montmain;1292;28;1320
28;Normandie;76;1;20;449;Montreuil-en-Caux;505;8;513
28;Normandie;76;1;12;450;Montroty;273;26;299
28;Normandie;76;3;02;452;Montville;4661;52;4713
28;Normandie;76;3;21;453;Morgny-la-Pommeraye;1030;20;1050
28;Normandie;76;1;12;606;Morienne;184;26;210
28;Normandie;76;1;23;454;Mortemer;84;0;84
28;Normandie;76;1;12;455;Morville-sur-Andelle;331;5;336
28;Normandie;76;3;35;456;Motteville;778;11;789
28;Normandie;76;3;09;457;Moulineaux;935;17;952
28;Normandie;76;1;20;458;Muchedent;129;3;132
28;Normandie;76;1;23;459;Nesle-Hodeng;348;5;353
28;Normandie;76;1;10;460;Nesle-Normandeuse;523;8;531
28;Normandie;76;1;12;463;Neuf-Marché;667;22;689
28;Normandie;76;1;23;461;Neufbosc;401;5;406
28;Normandie;76;1;23;462;Neufchâtel-en-Bray;4711;209;4920
28;Normandie;76;3;21;464;La Neuville-Chant-d'Oisel;2282;36;2318
28;Normandie;76;1;23;465;Neuville-Ferrières;576;6;582
28;Normandie;76;1;33;467;Néville;1318;19;1337
28;Normandie;76;2;03;468;Nointot;1355;33;1388
28;Normandie;76;1;12;469;Nolléval;439;5;444
28;Normandie;76;1;33;470;Normanville;663;24;687
28;Normandie;76;2;25;471;Norville;993;26;1019
28;Normandie;76;1;08;472;Notre-Dame-d'Aliermont;769;2;771
28;Normandie;76;3;25;473;Notre-Dame-de-Bliquetuit;772;10;782
28;Normandie;76;3;24;474;Notre-Dame-de-Bondeville;6990;83;7073
28;Normandie;76;2;26;477;Notre-Dame-du-Bec;453;7;460
28;Normandie;76;1;20;478;Notre-Dame-du-Parc;182;1;183
28;Normandie;76;1;12;479;Nullemont;133;1;134
28;Normandie;76;1;33;480;Ocqueville;450;11;461
28;Normandie;76;2;26;481;Octeville-sur-Mer;5987;121;6108
28;Normandie;76;1;07;482;Offranville;3124;242;3366
28;Normandie;76;1;33;483;Oherville;228;2;230
28;Normandie;76;3;31;484;Oissel;12102;55;12157
28;Normandie;76;1;20;485;Omonville;265;49;314
28;Normandie;76;3;09;486;Orival;904;4;908
28;Normandie;76;1;23;487;Osmoy-Saint-Valery;320;6;326
28;Normandie;76;1;33;488;Ouainville;516;16;532
28;Normandie;76;2;32;489;Oudalle;429;10;439
28;Normandie;76;1;33;490;Ourville-en-Caux;1136;13;1149
28;Normandie;76;3;35;491;Ouville-l'Abbaye;667;6;673
28;Normandie;76;1;07;492;Ouville-la-Rivière;480;16;496
28;Normandie;76;1;33;493;Paluel;420;12;432
28;Normandie;76;2;03;494;Parc-d'Anxtot;567;7;574
28;Normandie;76;3;24;495;Pavilly;6260;51;6311
28;Normandie;76;1;08;618;Petit-Caux;9590;202;9792
28;Normandie;76;3;13;497;Petit-Couronne;8655;175;8830
28;Normandie;76;3;27;498;Le Petit-Quevilly;22291;270;22561
28;Normandie;76;2;25;499;Petiville;1122;29;1151
28;Normandie;76;1;10;500;Pierrecourt;477;4;481
28;Normandie;76;2;26;501;Pierrefiques;134;7;141
28;Normandie;76;3;21;502;Pierreval;553;9;562
28;Normandie;76;3;24;503;Pissy-Pôville;1275;19;1294
28;Normandie;76;1;33;504;Pleine-Sève;128;2;130
28;Normandie;76;1;12;505;Pommereux;95;1;96
28;Normandie;76;1;23;506;Pommeréval;475;4;479
28;Normandie;76;1;10;507;Ponts-et-Marais;814;15;829
28;Normandie;76;2;25;476;Port-Jérôme-sur-Seine;10157;183;10340
28;Normandie;76;2;26;508;La Poterie-Cap-d'Antifer;453;15;468
28;Normandie;76;3;21;509;Préaux;1816;31;1847
28;Normandie;76;3;35;510;Prétot-Vicquemare;230;3;233
28;Normandie;76;1;23;511;Preuseville;145;1;146
28;Normandie;76;1;23;512;Puisenval;24;0;24
28;Normandie;76;3;01;513;Quevillon;593;15;608
28;Normandie;76;3;06;514;Quévreville-la-Poterie;1008;13;1021
28;Normandie;76;1;07;515;Quiberville;547;14;561
28;Normandie;76;1;23;516;Quièvrecourt;436;19;455
28;Normandie;76;3;02;517;Quincampoix;3007;85;3092
28;Normandie;76;2;03;518;Raffetot;503;9;512
28;Normandie;76;1;20;519;Rainfreville;71;4;75
28;Normandie;76;1;10;520;Réalcamp;616;13;629
28;Normandie;76;3;21;521;Rebets;148;1;149
28;Normandie;76;2;32;522;La Remuée;1281;24;1305
28;Normandie;76;1;10;523;Rétonval;190;3;193
28;Normandie;76;3;35;524;Reuville;129;2;131
28;Normandie;76;1;08;526;Ricarville-du-Val;174;7;181
28;Normandie;76;1;12;527;Richemont;445;3;448
28;Normandie;76;1;10;528;Rieux;609;11;620
28;Normandie;76;3;25;164;Rives-en-Seine;4203;66;4269
28;Normandie;76;2;11;529;Riville;292;12;304
28;Normandie;76;3;35;530;Robertot;218;5;223
28;Normandie;76;3;33;531;Rocquefort;319;8;327
28;Normandie;76;1;23;532;Rocquemont;795;18;813
28;Normandie;76;2;16;533;Rogerville;1501;16;1517
28;Normandie;76;2;26;534;Rolleville;1189;18;1207
28;Normandie;76;1;12;535;Roncherolles-en-Bray;470;8;478
28;Normandie;76;3;06;536;Roncherolles-sur-le-Vivier;1161;21;1182
28;Normandie;76;1;12;537;Ronchois;183;6;189
28;Normandie;76;1;23;538;Rosay;266;5;271
28;Normandie;76;3;97;540;Rouen;111360;1605;112965
28;Normandie;76;3;24;541;Roumare;1527;26;1553
28;Normandie;76;3;35;542;Routes;275;4;279
28;Normandie;76;2;03;543;Rouville;607;11;618
28;Normandie;76;1;12;544;Rouvray-Catillon;227;8;235
28;Normandie;76;1;07;545;Rouxmesnil-Bouteilles;1832;43;1875
28;Normandie;76;1;20;546;Royville;290;7;297
28;Normandie;76;3;21;547;La Rue-Saint-Pierre;779;9;788
28;Normandie;76;3;21;548;Ry;728;15;743
28;Normandie;76;1;20;549;Saâne-Saint-Just;153;7;160
28;Normandie;76;3;04;550;Sahurs;1217;24;1241
28;Normandie;76;2;32;551;Sainneville;848;11;859
28;Normandie;76;3;21;554;Saint-Aignan-sur-Ry;350;2;352
28;Normandie;76;3;21;555;Saint-André-sur-Cailly;845;21;866
28;Normandie;76;2;03;556;Saint-Antoine-la-Forêt;1089;21;1110
28;Normandie;76;3;25;557;Saint-Arnoult;1414;21;1435
28;Normandie;76;3;06;558;Saint-Aubin-Celloville;1117;6;1123
28;Normandie;76;3;25;559;Saint-Aubin-de-Crétot;518;8;526
28;Normandie;76;3;06;560;Saint-Aubin-Épinay;1028;16;1044
28;Normandie;76;1;08;562;Saint-Aubin-le-Cauf;850;18;868
28;Normandie;76;3;05;561;Saint-Aubin-lès-Elbeuf;8277;76;8353
28;Normandie;76;2;32;563;Saint-Aubin-Routot;1907;14;1921
28;Normandie;76;1;33;564;Saint-Aubin-sur-Mer;167;3;170
28;Normandie;76;1;07;565;Saint-Aubin-sur-Scie;1120;96;1216
28;Normandie;76;3;35;568;Saint-Clair-sur-les-Monts;600;12;612
28;Normandie;76;1;20;570;Saint-Crespin;302;4;306
28;Normandie;76;1;07;572;Saint-Denis-d'Aclon;129;5;134
28;Normandie;76;3;21;573;Saint-Denis-le-Thiboult;503;14;517
28;Normandie;76;1;20;574;Saint-Denis-sur-Scie;685;4;689
28;Normandie;76;3;98;575;Saint-Étienne-du-Rouvray;28500;250;28750
28;Normandie;76;2;03;576;Saint-Eustache-la-Forêt;1195;17;1212
28;Normandie;76;3;02;580;Saint-Georges-sur-Fontaine;906;18;924
28;Normandie;76;1;20;582;Saint-Germain-d'Étables;255;5;260
28;Normandie;76;3;21;581;Saint-Germain-des-Essourts;399;9;408
28;Normandie;76;3;21;583;Saint-Germain-sous-Cailly;343;5;348
28;Normandie;76;1;23;584;Saint-Germain-sur-Eaulne;217;5;222
28;Normandie;76;3;25;585;Saint-Gilles-de-Crétot;423;16;439
28;Normandie;76;2;32;586;Saint-Gilles-de-la-Neuville;645;5;650
28;Normandie;76;1;23;588;Saint-Hellier;475;11;486
28;Normandie;76;1;20;589;Saint-Honoré;204;5;209
28;Normandie;76;1;08;590;Saint-Jacques-d'Aliermont;344;2;346
28;Normandie;76;3;06;591;Saint-Jacques-sur-Darnétal;2961;43;3004
28;Normandie;76;2;03;592;Saint-Jean-de-Folleville;822;27;849
28;Normandie;76;2;03;593;Saint-Jean-de-la-Neuville;610;11;621
28;Normandie;76;3;24;594;Saint-Jean-du-Cardonnay;1364;26;1390
28;Normandie;76;2;26;595;Saint-Jouin-Bruneval;1858;38;1896
28;Normandie;76;2;32;596;Saint-Laurent-de-Brèvedent;1489;38;1527
28;Normandie;76;3;35;597;Saint-Laurent-en-Caux;763;9;772
28;Normandie;76;1;10;598;Saint-Léger-aux-Bois;493;9;502
28;Normandie;76;3;06;599;Saint-Léger-du-Bourg-Denis;3577;48;3625
28;Normandie;76;2;11;600;Saint-Léonard;1717;34;1751
28;Normandie;76;1;12;601;Saint-Lucien;239;3;242
28;Normandie;76;1;20;602;Saint-Maclou-de-Folleville;626;12;638
28;Normandie;76;2;32;603;Saint-Maclou-la-Brière;470;6;476
28;Normandie;76;1;20;604;Saint-Mards;186;6;192
28;Normandie;76;1;10;612;Saint-Martin-au-Bosc;256;5;261
28;Normandie;76;3;35;611;Saint-Martin-aux-Arbres;319;9;328
28;Normandie;76;1;33;613;Saint-Martin-aux-Buneaux;655;12;667
28;Normandie;76;3;01;614;Saint-Martin-de-Boscherville;1529;30;1559
28;Normandie;76;3;24;289;Saint Martin de l'If;1713;24;1737
28;Normandie;76;2;26;615;Saint-Martin-du-Bec;613;24;637
28;Normandie;76;2;26;616;Saint-Martin-du-Manoir;1490;34;1524
28;Normandie;76;3;06;617;Saint-Martin-du-Vivier;1644;62;1706
28;Normandie;76;1;23;620;Saint-Martin-l'Hortier;274;7;281
28;Normandie;76;1;10;619;Saint-Martin-le-Gaillard;293;5;298
28;Normandie;76;1;23;621;Saint-Martin-Osmonville;1178;22;1200
28;Normandie;76;2;25;622;Saint-Maurice-d'Ételan;303;10;313
28;Normandie;76;1;12;623;Saint-Michel-d'Halescourt;121;4;125
28;Normandie;76;1;08;624;Saint-Nicolas-d'Aliermont;3715;60;3775
28;Normandie;76;3;25;626;Saint-Nicolas-de-la-Haie;419;6;425
28;Normandie;76;2;03;627;Saint-Nicolas-de-la-Taille;1615;18;1633
28;Normandie;76;1;20;628;Saint-Ouen-du-Breuil;777;13;790
28;Normandie;76;1;20;629;Saint-Ouen-le-Mauger;290;6;296
28;Normandie;76;1;08;630;Saint-Ouen-sous-Bailly;222;7;229
28;Normandie;76;3;01;631;Saint-Paër;1329;15;1344
28;Normandie;76;1;20;632;Saint-Pierre-Bénouville;391;3;394
28;Normandie;76;3;04;634;Saint-Pierre-de-Manneville;909;15;924
28;Normandie;76;3;01;636;Saint-Pierre-de-Varengeville;2323;33;2356
28;Normandie;76;1;23;635;Saint-Pierre-des-Jonquières;73;0;73
28;Normandie;76;2;11;637;Saint-Pierre-en-Port;829;12;841
28;Normandie;76;1;10;638;Saint-Pierre-en-Val;1096;16;1112
28;Normandie;76;1;33;641;Saint-Pierre-le-Vieux;192;5;197
28;Normandie;76;1;33;642;Saint-Pierre-le-Viger;260;3;263
28;Normandie;76;3;05;640;Saint-Pierre-lès-Elbeuf;8305;71;8376
28;Normandie;76;1;10;644;Saint-Rémy-Boscrocourt;801;17;818
28;Normandie;76;1;10;645;Saint-Riquier-en-Rivière;147;5;152
28;Normandie;76;1;33;646;Saint-Riquier-ès-Plains;595;14;609
28;Normandie;76;2;32;647;Saint-Romain-de-Colbosc;4172;39;4211
28;Normandie;76;1;23;648;Saint-Saëns;2362;23;2385
28;Normandie;76;1;23;649;Saint-Saire;593;11;604
28;Normandie;76;2;32;650;Saint-Sauveur-d'Émalleville;1226;26;1252
28;Normandie;76;1;33;651;Saint-Sylvain;166;4;170
28;Normandie;76;1;08;652;Saint-Vaast-d'Équiqueville;760;5;765
28;Normandie;76;1;33;653;Saint-Vaast-Dieppedalle;369;3;372
28;Normandie;76;1;20;654;Saint-Vaast-du-Val;469;10;479
28;Normandie;76;1;33;655;Saint-Valery-en-Caux;3907;162;4069
28;Normandie;76;1;20;656;Saint-Victor-l'Abbaye;772;7;779
28;Normandie;76;2;32;657;Saint-Vigor-d'Ymonville;1134;23;1157
28;Normandie;76;2;32;658;Saint-Vincent-Cramesnil;669;20;689
28;Normandie;76;2;19;552;Sainte-Adresse;7349;260;7609
28;Normandie;76;1;23;553;Sainte-Agathe-d'Aliermont;306;5;311
28;Normandie;76;3;24;566;Sainte-Austreberthe;606;5;611
28;Normandie;76;1;23;567;Sainte-Beuve-en-Rivière;181;5;186
28;Normandie;76;1;33;569;Sainte-Colombe;218;4;222
28;Normandie;76;3;21;571;Sainte-Croix-sur-Buchy;700;4;704
28;Normandie;76;1;20;577;Sainte-Foy;606;13;619
28;Normandie;76;1;23;578;Sainte-Geneviève;270;4;274
28;Normandie;76;2;11;587;Sainte-Hélène-Bondeville;716;9;725
28;Normandie;76;3;01;608;Sainte-Marguerite-sur-Duclair;2028;33;2061
28;Normandie;76;1;07;605;Sainte-Marguerite-sur-Mer;472;13;485
28;Normandie;76;2;26;609;Sainte-Marie-au-Bosc;365;11;376
28;Normandie;76;3;35;610;Sainte-Marie-des-Champs;1581;13;1594
28;Normandie;76;2;32;660;Sandouville;800;11;811
28;Normandie;76;1;20;662;Sassetot-le-Malgardé;114;1;115
28;Normandie;76;2;11;663;Sassetot-le-Mauconduit;1067;18;1085
28;Normandie;76;1;33;664;Sasseville;279;5;284
28;Normandie;76;1;08;665;Sauchay;417;5;422
28;Normandie;76;1;12;666;Saumont-la-Poterie;412;16;428
28;Normandie;76;1;07;667;Sauqueville;350;6;356
28;Normandie;76;3;35;668;Saussay;370;7;377
28;Normandie;76;2;32;669;Sausseuzemare-en-Caux;432;7;439
28;Normandie;76;2;11;670;Senneville-sur-Fécamp;884;11;895
28;Normandie;76;1;10;671;Sept-Meules;186;1;187
28;Normandie;76;1;12;672;Serqueux;985;20;1005
28;Normandie;76;3;21;673;Servaville-Salmonville;1130;15;1145
28;Normandie;76;3;02;675;Sierville;1051;11;1062
28;Normandie;76;1;12;676;Sigy-en-Bray;505;11;516
28;Normandie;76;1;23;677;Smermesnil;399;9;408
28;Normandie;76;1;23;678;Sommery;819;13;832
28;Normandie;76;1;33;679;Sommesnil;107;1;108
28;Normandie;76;2;11;680;Sorquainville;184;4;188
28;Normandie;76;3;99;681;Sotteville-lès-Rouen;28958;444;29402
28;Normandie;76;3;05;682;Sotteville-sous-le-Val;774;4;778
28;Normandie;76;1;33;683;Sotteville-sur-Mer;393;10;403
28;Normandie;76;2;03;684;Tancarville;1267;23;1290
28;Normandie;76;2;33;258;Terres-de-Caux;4167;111;4278
28;Normandie;76;2;11;685;Thérouldeville;664;3;667
28;Normandie;76;2;11;686;Theuville-aux-Maillots;548;8;556
28;Normandie;76;2;11;688;Thiergeville;406;14;420
28;Normandie;76;2;11;689;Thiétreville;371;38;409
28;Normandie;76;1;20;690;Thil-Manneville;623;18;641
28;Normandie;76;1;12;691;Le Thil-Riberpré;224;1;225
28;Normandie;76;1;33;692;Thiouville;301;5;306
28;Normandie;76;2;26;693;Le Tilleul;690;7;697
28;Normandie;76;1;20;694;Tocqueville-en-Caux;129;3;132
28;Normandie;76;2;32;695;Tocqueville-les-Murs;279;5;284
28;Normandie;76;1;20;697;Torcy-le-Grand;784;25;809
28;Normandie;76;1;20;698;Torcy-le-Petit;489;7;496
28;Normandie;76;3;35;699;Le Torp-Mesnil;447;4;451
28;Normandie;76;1;20;700;Tôtes;1549;31;1580
28;Normandie;76;3;35;702;Touffreville-la-Corbeline;834;15;849
28;Normandie;76;1;10;703;Touffreville-sur-Eu;210;8;218
28;Normandie;76;3;05;705;Tourville-la-Rivière;2504;21;2525
28;Normandie;76;2;11;706;Tourville-les-Ifs;655;7;662
28;Normandie;76;1;07;707;Tourville-sur-Arques;1216;39;1255
28;Normandie;76;2;11;708;Toussaint;709;12;721
28;Normandie;76;3;01;709;Le Trait;4900;46;4946
28;Normandie;76;2;33;710;Trémauville;105;2;107
28;Normandie;76;1;10;711;Le Tréport;4723;105;4828
28;Normandie;76;2;03;712;La Trinité-du-Mont;834;26;860
28;Normandie;76;2;32;714;Les Trois-Pierres;765;14;779
28;Normandie;76;2;25;715;Trouville;625;8;633
28;Normandie;76;2;26;716;Turretot;1472;24;1496
28;Normandie;76;3;04;717;Val-de-la-Haye;715;3;718
28;Normandie;76;1;20;018;Val-de-Saâne;1497;33;1530
28;Normandie;76;1;89;034;Val-de-Scie;2545;22;2567
28;Normandie;76;3;35;718;Valliquerville;1420;37;1457
28;Normandie;76;2;11;719;Valmont;852;15;867
28;Normandie;76;1;07;720;Varengeville-sur-Mer;943;33;976
28;Normandie;76;1;20;721;Varneville-Bretteville;329;9;338
28;Normandie;76;1;20;723;Vassonville;446;7;453
28;Normandie;76;1;23;724;Vatierville;134;2;136
28;Normandie;76;2;32;725;Vattetot-sous-Beaumont;575;5;580
28;Normandie;76;2;11;726;Vattetot-sur-Mer;319;6;325
28;Normandie;76;3;25;727;Vatteville-la-Rue;1136;26;1162
28;Normandie;76;3;24;728;La Vaupalière;1113;20;1133
28;Normandie;76;1;33;730;Veauville-lès-Quelles;130;2;132
28;Normandie;76;1;20;731;Vénestanville;207;2;209
28;Normandie;76;1;23;733;Ventes-Saint-Rémy;227;4;231
28;Normandie;76;2;26;734;Vergetot;444;12;456
28;Normandie;76;1;33;735;Veules-les-Roses;578;14;592
28;Normandie;76;1;33;736;Veulettes-sur-Mer;273;6;279
28;Normandie;76;3;35;737;Vibeuf;603;19;622
28;Normandie;76;3;21;738;Vieux-Manoir;746;11;757
28;Normandie;76;1;12;739;Vieux-Rouen-sur-Bresle;559;6;565
28;Normandie;76;3;21;740;La Vieux-Rue;572;10;582
28;Normandie;76;2;26;741;Villainville;289;12;301
28;Normandie;76;3;01;743;Villers-Écalles;1769;19;1788
28;Normandie;76;1;10;744;Villers-sous-Foucarmont;190;2;192
28;Normandie;76;1;10;745;Villy-sur-Yères;197;2;199
28;Normandie;76;2;11;746;Vinnemerville;217;2;219
28;Normandie;76;2;32;747;Virville;355;3;358
28;Normandie;76;1;33;748;Vittefleur;654;7;661
28;Normandie;76;1;23;749;Wanchy-Capval;349;8;357
28;Normandie;76;3;01;750;Yainville;1046;13;1059
28;Normandie;76;2;33;751;Yébleron;1279;18;1297
28;Normandie;76;3;35;752;Yerville;2400;20;2420
28;Normandie;76;3;06;753;Ymare;1152;22;1174
28;Normandie;76;2;11;754;Yport;762;16;778
28;Normandie;76;2;11;755;Ypreville-Biville;579;9;588
28;Normandie;76;3;21;756;Yquebeuf;239;8;247
28;Normandie;76;3;35;757;Yvecrique;643;7;650
28;Normandie;76;3;35;758;Yvetot;11627;239;11866
28;Normandie;76;3;01;759;Yville-sur-Seine;450;6;456
11;Île-de-France;77;4;07;001;Achères-la-Forêt;1134;29;1163
11;Île-de-France;77;1;05;002;Amillis;830;5;835
11;Île-de-France;77;4;07;003;Amponville;344;17;361
11;Île-de-France;77;2;14;004;Andrezel;287;5;292
11;Île-de-France;77;1;03;005;Annet-sur-Marne;3274;44;3318
11;Île-de-France;77;4;07;006;Arbonne-la-Forêt;982;20;1002
11;Île-de-France;77;2;14;007;Argentières;366;7;373
11;Île-de-France;77;1;06;008;Armentières-en-Brie;1234;24;1258
11;Île-de-France;77;4;15;009;Arville;124;0;124
11;Île-de-France;77;3;14;010;Aubepierre-Ozouer-le-Repos;921;10;931
11;Île-de-France;77;4;15;011;Aufferville;506;6;512
11;Île-de-France;77;3;18;012;Augers-en-Brie;297;7;304
11;Île-de-France;77;1;05;013;Aulnoy;358;9;367
11;Île-de-France;77;4;07;014;Avon;13662;225;13887
11;Île-de-France;77;3;18;015;Baby;95;2;97
11;Île-de-France;77;4;15;016;Bagneaux-sur-Loing;1645;15;1660
11;Île-de-France;77;5;21;018;Bailly-Romainvilliers;7411;60;7471
11;Île-de-France;77;3;18;019;Balloy;329;3;332
11;Île-de-France;77;3;18;020;Bannost-Villegagnon;648;12;660
11;Île-de-France;77;3;13;021;Barbey;150;2;152
11;Île-de-France;77;4;07;022;Barbizon;1169;38;1207
11;Île-de-France;77;1;03;023;Barcy;310;7;317
11;Île-de-France;77;1;06;024;Bassevelle;377;2;379
11;Île-de-France;77;3;18;025;Bazoches-lès-Bray;862;8;870
11;Île-de-France;77;3;18;026;Beauchery-Saint-Martin;363;15;378
11;Île-de-France;77;4;15;027;Beaumont-du-Gâtinais;1188;15;1203
11;Île-de-France;77;1;05;433;Beautheil-Saints ;1992;34;2026
11;Île-de-France;77;2;14;029;Beauvoir;198;3;201
11;Île-de-France;77;3;05;030;Bellot;769;5;774
11;Île-de-France;77;3;08;031;Bernay-Vilbert;864;10;874
11;Île-de-France;77;3;18;032;Beton-Bazoches;917;16;933
11;Île-de-France;77;3;18;033;Bezalles;235;8;243
11;Île-de-France;77;2;14;034;Blandy;741;7;748
11;Île-de-France;77;3;15;035;Blennes;556;7;563
11;Île-de-France;77;4;14;037;Bois-le-Roi;5882;147;6029
11;Île-de-France;77;3;18;036;Boisdon;136;3;139
11;Île-de-France;77;2;20;038;Boissettes;404;7;411
11;Île-de-France;77;2;20;039;Boissise-la-Bertrand;1149;11;1160
11;Île-de-France;77;2;19;040;Boissise-le-Roi;3768;41;3809
11;Île-de-France;77;4;07;041;Boissy-aux-Cailles;285;5;290
11;Île-de-France;77;1;05;042;Boissy-le-Châtel;3182;42;3224
11;Île-de-France;77;3;05;043;Boitron;362;8;370
11;Île-de-France;77;2;14;044;Bombon;965;8;973
11;Île-de-France;77;4;15;045;Bougligny;719;11;730
11;Île-de-France;77;4;07;046;Boulancourt;341;10;351
11;Île-de-France;77;1;21;047;Bouleurs;1663;14;1677
11;Île-de-France;77;4;07;048;Bourron-Marlotte;2759;85;2844
11;Île-de-France;77;1;21;049;Boutigny;854;14;868
11;Île-de-France;77;4;15;050;Bransles;553;10;563
11;Île-de-France;77;3;18;051;Bray-sur-Seine;2276;18;2294
11;Île-de-France;77;3;14;052;Bréau;336;5;341
11;Île-de-France;77;5;04;053;Brie-Comte-Robert;18237;313;18550
11;Île-de-France;77;3;13;054;La Brosse-Montceaux;752;14;766
11;Île-de-France;77;5;23;055;Brou-sur-Chantereine;4440;9;4449
11;Île-de-France;77;4;07;056;Burcy;149;6;155
11;Île-de-France;77;1;06;057;Bussières;521;3;524
11;Île-de-France;77;5;22;058;Bussy-Saint-Georges;26806;349;27155
11;Île-de-France;77;5;22;059;Bussy-Saint-Martin;657;14;671
11;Île-de-France;77;4;07;060;Buthiers;726;16;742
11;Île-de-France;77;3;13;061;Cannes-Écluse;2472;35;2507
11;Île-de-France;77;5;09;062;Carnetin;455;10;465
11;Île-de-France;77;1;05;063;La Celle-sur-Morin;1284;15;1299
11;Île-de-France;77;4;07;065;Cély;1210;23;1233
11;Île-de-France;77;3;18;066;Cerneux;325;8;333
11;Île-de-France;77;2;20;067;Cesson;10625;142;10767
11;Île-de-France;77;3;18;068;Cessoy-en-Montois;215;4;219
11;Île-de-France;77;4;07;069;Chailly-en-Bière;2064;32;2096
11;Île-de-France;77;1;05;070;Chailly-en-Brie;1437;105;1542
11;Île-de-France;77;4;15;071;Chaintreaux;887;12;899
11;Île-de-France;77;3;18;072;Chalautre-la-Grande;692;10;702
11;Île-de-France;77;3;18;073;Chalautre-la-Petite;565;17;582
11;Île-de-France;77;5;09;075;Chalifert;1281;15;1296
11;Île-de-France;77;3;18;076;Chalmaison;754;54;808
11;Île-de-France;77;1;03;077;Chambry;986;12;998
11;Île-de-France;77;1;06;078;Chamigny;1331;51;1382
11;Île-de-France;77;4;13;079;Champagne-sur-Seine;6292;141;6433
11;Île-de-France;77;3;18;080;Champcenest;202;1;203
11;Île-de-France;77;2;14;081;Champdeuil;727;8;735
11;Île-de-France;77;2;14;082;Champeaux;819;13;832
11;Île-de-France;77;5;01;083;Champs-sur-Marne;25610;153;25763
11;Île-de-France;77;1;06;084;Changis-sur-Marne;1320;11;1331
11;Île-de-France;77;5;09;085;Chanteloup-en-Brie;3966;50;4016
11;Île-de-France;77;3;14;086;La Chapelle-Gauthier;1447;5;1452
11;Île-de-France;77;3;08;087;La Chapelle-Iger;170;0;170
11;Île-de-France;77;4;07;088;La Chapelle-la-Reine;2400;30;2430
11;Île-de-France;77;3;05;093;La Chapelle-Moutils;443;3;446
11;Île-de-France;77;3;14;089;La Chapelle-Rablais;928;6;934
11;Île-de-France;77;3;18;090;La Chapelle-Saint-Sulpice;242;4;246
11;Île-de-France;77;3;08;091;Les Chapelles-Bourbon;473;3;476
11;Île-de-France;77;1;03;094;Charmentray;293;1;294
11;Île-de-France;77;1;03;095;Charny;1347;16;1363
11;Île-de-France;77;4;14;096;Chartrettes;2544;56;2600
11;Île-de-France;77;3;05;097;Chartronges;295;2;297
11;Île-de-France;77;4;15;099;Château-Landon;2945;56;3001
11;Île-de-France;77;3;14;098;Châteaubleau;361;2;363
11;Île-de-France;77;2;14;100;Le Châtelet-en-Brie;4396;67;4463
11;Île-de-France;77;3;18;101;Châtenay-sur-Seine;1046;11;1057
11;Île-de-France;77;4;15;102;Châtenoy;165;1;166
11;Île-de-France;77;2;14;103;Châtillon-la-Borde;217;2;219
11;Île-de-France;77;3;08;104;Châtres;689;7;696
11;Île-de-France;77;1;03;335;Chauconin-Neufmontiers;3422;27;3449
11;Île-de-France;77;1;05;106;Chauffry;1023;17;1040
11;Île-de-France;77;2;08;107;Chaumes-en-Brie;3304;26;3330
11;Île-de-France;77;5;02;108;Chelles;55148;293;55441
11;Île-de-France;77;3;18;109;Chenoise-Cucharmoy ;1633;26;1659
11;Île-de-France;77;4;15;110;Chenou;320;8;328
11;Île-de-France;77;5;21;111;Chessy;5969;51;6020
11;Île-de-France;77;4;15;112;Chevrainvilliers;250;4;254
11;Île-de-France;77;1;05;113;Chevru;1102;14;1116
11;Île-de-France;77;5;16;114;Chevry-Cossigny;3939;40;3979
11;Île-de-France;77;3;15;115;Chevry-en-Sereine;518;17;535
11;Île-de-France;77;3;05;116;Choisy-en-Brie;1320;18;1338
11;Île-de-France;77;1;06;117;Citry;937;9;946
11;Île-de-France;77;1;03;118;Claye-Souilly;12264;136;12400
11;Île-de-France;77;3;14;119;Clos-Fontaine;255;3;258
11;Île-de-France;77;1;06;120;Cocherel;630;4;634
11;Île-de-France;77;5;22;121;Collégien;3380;43;3423
11;Île-de-France;77;2;04;122;Combs-la-Ville;21811;156;21967
11;Île-de-France;77;1;12;123;Compans;811;2;813
11;Île-de-France;77;5;09;124;Conches-sur-Gondoire;1756;28;1784
11;Île-de-France;77;1;21;125;Condé-Sainte-Libiaire;1425;17;1442
11;Île-de-France;77;1;06;126;Congis-sur-Thérouanne;1762;193;1955
11;Île-de-France;77;2;08;127;Coubert;1881;13;1894
11;Île-de-France;77;1;21;128;Couilly-Pont-aux-Dames;2125;29;2154
11;Île-de-France;77;1;06;129;Coulombs-en-Valois;565;9;574
11;Île-de-France;77;1;21;130;Coulommes;459;4;463
11;Île-de-France;77;1;05;131;Coulommiers;14757;243;15000
11;Île-de-France;77;5;21;132;Coupvray;2860;28;2888
11;Île-de-France;77;3;13;133;Courcelles-en-Bassée;201;3;204
11;Île-de-France;77;3;18;134;Courchamp;147;3;150
11;Île-de-France;77;3;08;135;Courpalay;1305;14;1319
11;Île-de-France;77;2;08;136;Courquetaine;192;7;199
11;Île-de-France;77;3;18;137;Courtacon;235;10;245
11;Île-de-France;77;3;14;138;Courtomer;537;5;542
11;Île-de-France;77;5;23;139;Courtry;6658;49;6707
11;Île-de-France;77;3;18;140;Coutençon;290;3;293
11;Île-de-France;77;1;21;141;Coutevroult;1138;11;1149
11;Île-de-France;77;1;21;142;Crécy-la-Chapelle;4669;66;4735
11;Île-de-France;77;1;03;143;Crégy-lès-Meaux;5145;51;5196
11;Île-de-France;77;3;08;144;Crèvecœur-en-Brie;417;1;418
11;Île-de-France;77;2;14;145;Crisenoy;640;12;652
11;Île-de-France;77;5;01;146;Croissy-Beaubourg;2007;21;2028
11;Île-de-France;77;3;14;147;La Croix-en-Brie;669;8;677
11;Île-de-France;77;1;06;148;Crouy-sur-Ourcq;1869;24;1893
11;Île-de-France;77;1;03;150;Cuisy;447;2;449
11;Île-de-France;77;1;05;151;Dagny;285;4;289
11;Île-de-France;77;2;19;152;Dammarie-les-Lys;22177;143;22320
11;Île-de-France;77;1;12;153;Dammartin-en-Goële;10196;87;10283
11;Île-de-France;77;1;08;154;Dammartin-sur-Tigeaux;1101;15;1116
11;Île-de-France;77;5;09;155;Dampmart;3404;36;3440
11;Île-de-France;77;4;15;156;Darvault;890;14;904
11;Île-de-France;77;1;06;157;Dhuisy;305;6;311
11;Île-de-France;77;3;15;158;Diant;198;2;200
11;Île-de-France;77;3;18;159;Donnemarie-Dontilly;2790;48;2838
11;Île-de-France;77;4;15;161;Dormelles;805;18;823
11;Île-de-France;77;3;05;162;Doue;1045;8;1053
11;Île-de-France;77;1;06;163;Douy-la-Ramée;347;5;352
11;Île-de-France;77;2;14;164;Échouboulains;557;6;563
11;Île-de-France;77;2;14;165;Les Écrennes;606;5;611
11;Île-de-France;77;3;18;167;Égligny;327;6;333
11;Île-de-France;77;4;15;168;Égreville;2148;38;2186
11;Île-de-France;77;5;17;169;Émerainville;7689;31;7720
11;Île-de-France;77;5;21;171;Esbly;6339;46;6385
11;Île-de-France;77;3;13;172;Esmans;893;9;902
11;Île-de-France;77;1;06;173;Étrépilly;864;7;871
11;Île-de-France;77;3;18;174;Everly;586;11;597
11;Île-de-France;77;2;08;175;Évry-Grégy-sur-Yerre;2942;29;2971
11;Île-de-France;77;1;08;176;Faremoutiers;2885;27;2912
11;Île-de-France;77;3;16;177;Favières;1125;13;1138
11;Île-de-France;77;4;15;178;Faÿ-lès-Nemours;491;11;502
11;Île-de-France;77;2;14;179;Féricy;586;15;601
11;Île-de-France;77;5;16;180;Férolles-Attilly;1260;27;1287
11;Île-de-France;77;5;16;181;Ferrières-en-Brie;3483;33;3516
11;Île-de-France;77;3;05;182;La Ferté-Gaucher;4902;48;4950
11;Île-de-France;77;1;06;183;La Ferté-sous-Jouarre;9586;85;9671
11;Île-de-France;77;4;15;184;Flagy;635;10;645
11;Île-de-France;77;4;07;185;Fleury-en-Bière;652;17;669
11;Île-de-France;77;3;18;187;Fontaine-Fourches;595;3;598
11;Île-de-France;77;2;14;188;Fontaine-le-Port;1010;18;1028
11;Île-de-France;77;4;07;186;Fontainebleau;15407;455;15862
11;Île-de-France;77;3;14;190;Fontains;255;5;260
11;Île-de-France;77;3;14;191;Fontenailles;1058;13;1071
11;Île-de-France;77;3;08;192;Fontenay-Trésigny;5678;57;5735
11;Île-de-France;77;1;03;193;Forfry;226;1;227
11;Île-de-France;77;3;13;194;Forges;408;17;425
11;Île-de-France;77;2;14;195;Fouju;573;10;583
11;Île-de-France;77;1;03;196;Fresnes-sur-Marne;931;3;934
11;Île-de-France;77;3;18;197;Frétoy;167;3;170
11;Île-de-France;77;4;07;198;Fromont;242;4;246
11;Île-de-France;77;1;06;199;Fublaines;1386;11;1397
11;Île-de-France;77;4;15;200;Garentreville;116;2;118
11;Île-de-France;77;3;14;201;Gastins;682;4;686
11;Île-de-France;77;4;15;202;La Genevraye;796;6;802
11;Île-de-France;77;1;06;203;Germigny-l'Évêque;1316;21;1337
11;Île-de-France;77;1;06;204;Germigny-sous-Coulombs;210;3;213
11;Île-de-France;77;1;03;205;Gesvres-le-Chapitre;149;1;150
11;Île-de-France;77;1;05;206;Giremoutiers;179;4;183
11;Île-de-France;77;4;15;207;Gironville;153;5;158
11;Île-de-France;77;3;18;208;Gouaix;1440;29;1469
11;Île-de-France;77;5;09;209;Gouvernes;1183;22;1205
11;Île-de-France;77;3;13;210;La Grande-Paroisse;2809;35;2844
11;Île-de-France;77;3;14;211;Grandpuits-Bailly-Carrois;1025;9;1034
11;Île-de-France;77;3;18;212;Gravon;164;3;167
11;Île-de-France;77;1;03;214;Gressy;821;13;834
11;Île-de-France;77;5;16;215;Gretz-Armainvilliers;8566;70;8636
11;Île-de-France;77;4;15;216;Grez-sur-Loing;1413;35;1448
11;Île-de-France;77;2;08;217;Grisy-Suisnes;2505;30;2535
11;Île-de-France;77;3;18;218;Grisy-sur-Seine;110;1;111
11;Île-de-France;77;1;08;219;Guérard;2551;32;2583
11;Île-de-France;77;4;07;220;Guercheville;268;5;273
11;Île-de-France;77;5;09;221;Guermantes;1151;24;1175
11;Île-de-France;77;2;14;222;Guignes;4253;29;4282
11;Île-de-France;77;3;18;223;Gurcy-le-Châtel;568;6;574
11;Île-de-France;77;1;21;225;La Haute-Maison;309;7;316
11;Île-de-France;77;1;05;224;Hautefeuille;256;2;258
11;Île-de-France;77;4;07;226;Héricy;2572;103;2675
11;Île-de-France;77;3;18;227;Hermé;633;17;650
11;Île-de-France;77;3;05;228;Hondevilliers;254;4;258
11;Île-de-France;77;3;08;229;La Houssaye-en-Brie;1633;18;1651
11;Île-de-France;77;4;15;230;Ichy;163;2;165
11;Île-de-France;77;1;06;231;Isles-les-Meldeuses;813;2;815
11;Île-de-France;77;1;03;232;Isles-lès-Villenoy;1082;16;1098
11;Île-de-France;77;1;03;233;Iverny;586;3;589
11;Île-de-France;77;5;09;234;Jablines;691;7;698
11;Île-de-France;77;1;06;235;Jaignes;311;5;316
11;Île-de-France;77;3;18;236;Jaulnes;353;4;357
11;Île-de-France;77;5;22;237;Jossigny;671;9;680
11;Île-de-France;77;1;06;238;Jouarre;4350;41;4391
11;Île-de-France;77;3;18;239;Jouy-le-Châtel;1504;20;1524
11;Île-de-France;77;3;05;240;Jouy-sur-Morin;2129;28;2157
11;Île-de-France;77;1;12;241;Juilly;1989;15;2004
11;Île-de-France;77;3;18;242;Jutigny;542;7;549
11;Île-de-France;77;5;09;243;Lagny-sur-Marne;21354;226;21580
11;Île-de-France;77;4;15;244;Larchant;686;42;728
11;Île-de-France;77;3;13;245;Laval-en-Brie;429;4;433
11;Île-de-France;77;3;18;246;Léchelle;592;15;607
11;Île-de-France;77;3;05;247;Lescherolles;453;11;464
11;Île-de-France;77;5;09;248;Lesches;758;8;766
11;Île-de-France;77;5;16;249;Lésigny;7157;118;7275
11;Île-de-France;77;3;05;250;Leudon-en-Brie;163;7;170
11;Île-de-France;77;2;04;251;Lieusaint;13410;92;13502
11;Île-de-France;77;2;08;252;Limoges-Fourches;508;6;514
11;Île-de-France;77;2;08;253;Lissy;259;1;260
11;Île-de-France;77;3;08;254;Liverdy-en-Brie;1300;22;1322
11;Île-de-France;77;2;11;255;Livry-sur-Seine;2081;34;2115
11;Île-de-France;77;3;18;256;Lizines;186;1;187
11;Île-de-France;77;1;06;257;Lizy-sur-Ourcq;3535;21;3556
11;Île-de-France;77;5;01;258;Lognes;14268;65;14333
11;Île-de-France;77;1;12;259;Longperrier;2344;11;2355
11;Île-de-France;77;3;18;260;Longueville;1785;25;1810
11;Île-de-France;77;4;15;261;Lorrez-le-Bocage-Préaux;1199;20;1219
11;Île-de-France;77;3;18;262;Louan-Villegruis-Fontaine;484;18;502
11;Île-de-France;77;3;18;263;Luisetaines;240;7;247
11;Île-de-France;77;3;08;264;Lumigny-Nesles-Ormeaux;1527;17;1544
11;Île-de-France;77;1;06;265;Luzancy;1112;48;1160
11;Île-de-France;77;2;14;266;Machault;781;12;793
11;Île-de-France;77;4;15;267;La Madeleine-sur-Loing;357;3;360
11;Île-de-France;77;5;21;268;Magny-le-Hongre;8876;146;9022
11;Île-de-France;77;2;11;269;Maincy;1798;55;1853
11;Île-de-France;77;3;18;272;Maison-Rouge;870;8;878
11;Île-de-France;77;1;05;270;Maisoncelles-en-Brie;917;11;928
11;Île-de-France;77;4;15;271;Maisoncelles-en-Gâtinais;134;1;135
11;Île-de-France;77;1;12;273;Marchémoret;568;4;572
11;Île-de-France;77;1;06;274;Marcilly;457;2;459
11;Île-de-France;77;3;18;275;Les Marêts;149;4;153
11;Île-de-France;77;1;03;276;Mareuil-lès-Meaux;3155;40;3195
11;Île-de-France;77;3;08;277;Marles-en-Brie;1730;22;1752
11;Île-de-France;77;1;05;278;Marolles-en-Brie;406;6;412
11;Île-de-France;77;3;13;279;Marolles-sur-Seine;1784;32;1816
11;Île-de-France;77;1;06;280;Mary-sur-Marne;1132;11;1143
11;Île-de-France;77;1;05;281;Mauperthuis;479;4;483
11;Île-de-France;77;1;12;282;Mauregard;357;4;361
11;Île-de-France;77;1;06;283;May-en-Multien;926;4;930
11;Île-de-France;77;1;10;284;Meaux;55416;477;55893
11;Île-de-France;77;2;20;285;Le Mée-sur-Seine;21071;137;21208
11;Île-de-France;77;3;18;286;Meigneux;229;6;235
11;Île-de-France;77;3;05;287;Meilleray;499;11;510
11;Île-de-France;77;2;11;288;Melun;39947;302;40249
11;Île-de-France;77;3;18;289;Melz-sur-Seine;349;3;352
11;Île-de-France;77;1;06;290;Méry-sur-Marne;668;58;726
11;Île-de-France;77;1;12;291;Le Mesnil-Amelot;1043;5;1048
11;Île-de-France;77;1;03;292;Messy;1174;11;1185
11;Île-de-France;77;3;13;293;Misy-sur-Yonne;953;18;971
11;Île-de-France;77;1;12;294;Mitry-Mory;20353;83;20436
11;Île-de-France;77;2;14;295;Moisenay;1383;13;1396
11;Île-de-France;77;2;04;296;Moissy-Cramayel;17882;136;18018
11;Île-de-France;77;4;15;297;Mondreville;329;4;333
11;Île-de-France;77;3;18;298;Mons-en-Montois;449;10;459
11;Île-de-France;77;1;06;300;Montceaux-lès-Meaux;602;12;614
11;Île-de-France;77;3;18;301;Montceaux-lès-Provins;324;1;325
11;Île-de-France;77;4;15;302;Montcourt-Fromonville;1970;34;2004
11;Île-de-France;77;3;05;303;Montdauphin;243;3;246
11;Île-de-France;77;3;05;304;Montenils;25;0;25
11;Île-de-France;77;3;13;305;Montereau-Fault-Yonne;20712;196;20908
11;Île-de-France;77;2;11;306;Montereau-sur-le-Jard;510;6;516
11;Île-de-France;77;5;09;307;Montévrain;12764;106;12870
11;Île-de-France;77;1;12;308;Montgé-en-Goële;757;7;764
11;Île-de-France;77;1;03;309;Monthyon;1730;10;1740
11;Île-de-France;77;3;18;310;Montigny-le-Guesdier;303;6;309
11;Île-de-France;77;3;18;311;Montigny-Lencoup;1403;15;1418
11;Île-de-France;77;4;15;312;Montigny-sur-Loing;2680;75;2755
11;Île-de-France;77;3;15;313;Montmachoux;250;2;252
11;Île-de-France;77;3;05;314;Montolivet;237;2;239
11;Île-de-France;77;5;21;315;Montry;3688;31;3719
11;Île-de-France;77;4;13;316;Moret-Loing-et-Orvanne ;12110;329;12439
11;Île-de-France;77;3;14;317;Mormant;4924;35;4959
11;Île-de-France;77;3;08;318;Mortcerf;1438;22;1460
11;Île-de-France;77;3;18;319;Mortery;147;3;150
11;Île-de-France;77;1;05;320;Mouroux;5557;58;5615
11;Île-de-France;77;3;18;321;Mousseaux-lès-Bray;674;4;678
11;Île-de-France;77;1;12;322;Moussy-le-Neuf;3108;26;3134
11;Île-de-France;77;1;12;323;Moussy-le-Vieux;1460;5;1465
11;Île-de-France;77;3;18;325;Mouy-sur-Seine;357;4;361
11;Île-de-France;77;2;19;326;Nandy;6179;69;6248
11;Île-de-France;77;3;14;327;Nangis;8775;85;8860
11;Île-de-France;77;4;07;328;Nanteau-sur-Essonne;431;8;439
11;Île-de-France;77;4;15;329;Nanteau-sur-Lunain;691;3;694
11;Île-de-France;77;1;06;330;Nanteuil-lès-Meaux;6218;74;6292
11;Île-de-France;77;1;06;331;Nanteuil-sur-Marne;431;6;437
11;Île-de-France;77;1;12;332;Nantouillet;279;1;280
11;Île-de-France;77;4;15;333;Nemours;13165;123;13288
11;Île-de-France;77;3;08;336;Neufmoutiers-en-Brie;1162;11;1173
11;Île-de-France;77;5;01;337;Noisiel;15676;105;15781
11;Île-de-France;77;3;15;338;Noisy-Rudignon;603;8;611
11;Île-de-France;77;4;07;339;Noisy-sur-École;1829;58;1887
11;Île-de-France;77;4;15;340;Nonville;612;11;623
11;Île-de-France;77;3;18;341;Noyen-sur-Seine;378;10;388
11;Île-de-France;77;4;15;342;Obsonville;114;1;115
11;Île-de-France;77;1;06;343;Ocquerre;410;22;432
11;Île-de-France;77;1;03;344;Oissery;2354;22;2376
11;Île-de-France;77;3;05;345;Orly-sur-Morin;671;9;680
11;Île-de-France;77;3;18;347;Les Ormes-sur-Voulzie;857;10;867
11;Île-de-France;77;4;15;348;Ormesson;240;6;246
11;Île-de-France;77;1;12;349;Othis;6739;76;6815
11;Île-de-France;77;5;16;350;Ozoir-la-Ferrière;20191;192;20383
11;Île-de-France;77;2;08;352;Ozouer-le-Voulgis;1912;22;1934
11;Île-de-France;77;4;15;353;Paley;423;7;430
11;Île-de-France;77;2;14;354;Pamfou;939;8;947
11;Île-de-France;77;3;18;355;Paroy;163;1;164
11;Île-de-France;77;3;18;356;Passy-sur-Seine;46;1;47
11;Île-de-France;77;3;08;357;Pécy;857;10;867
11;Île-de-France;77;1;03;358;Penchard;1291;12;1303
11;Île-de-France;77;4;07;359;Perthes;1986;24;2010
11;Île-de-France;77;1;05;360;Pézarches;388;4;392
11;Île-de-France;77;1;06;361;Pierre-Levée;468;7;475
11;Île-de-France;77;1;23;363;Le Pin;1517;11;1528
11;Île-de-France;77;1;03;364;Le Plessis-aux-Bois;270;2;272
11;Île-de-France;77;3;08;365;Le Plessis-Feu-Aussoux;601;5;606
11;Île-de-France;77;1;03;366;Le Plessis-l'Évêque;295;1;296
11;Île-de-France;77;1;06;367;Le Plessis-Placy;271;4;275
11;Île-de-France;77;3;18;368;Poigny;521;13;534
11;Île-de-France;77;1;06;369;Poincy;708;12;720
11;Île-de-France;77;4;15;370;Poligny;789;12;801
11;Île-de-France;77;1;08;371;Pommeuse;2953;21;2974
11;Île-de-France;77;5;09;372;Pomponne;4108;37;4145
11;Île-de-France;77;5;17;373;Pontault-Combault;37867;209;38076
11;Île-de-France;77;5;16;374;Pontcarré;2219;18;2237
11;Île-de-France;77;1;03;376;Précy-sur-Marne;811;3;814
11;Île-de-France;77;3;08;377;Presles-en-Brie;2313;29;2342
11;Île-de-France;77;2;19;378;Pringy;2894;20;2914
11;Île-de-France;77;3;18;379;Provins;12000;293;12293
11;Île-de-France;77;1;06;380;Puisieux;320;6;326
11;Île-de-France;77;3;14;381;Quiers;667;5;672
11;Île-de-France;77;1;21;382;Quincy-Voisins;5439;54;5493
11;Île-de-France;77;3;14;383;Rampillon;828;7;835
11;Île-de-France;77;2;04;384;Réau;1855;3;1858
11;Île-de-France;77;3;05;385;Rebais;2290;24;2314
11;Île-de-France;77;4;07;386;Recloses;623;23;646
11;Île-de-France;77;4;15;387;Remauville;463;8;471
11;Île-de-France;77;1;06;388;Reuil-en-Brie;830;7;837
11;Île-de-France;77;2;11;389;La Rochette;3749;104;3853
11;Île-de-France;77;5;17;390;Roissy-en-Brie;22836;80;22916
11;Île-de-France;77;3;18;391;Rouilly;488;6;494
11;Île-de-France;77;1;12;392;Rouvres;905;11;916
11;Île-de-France;77;3;08;393;Rozay-en-Brie;2807;36;2843
11;Île-de-France;77;2;11;394;Rubelles;2554;21;2575
11;Île-de-France;77;4;07;395;Rumont;122;4;126
11;Île-de-France;77;3;18;396;Rupéreux;99;0;99
11;Île-de-France;77;1;06;397;Saâcy-sur-Marne;1828;25;1853
11;Île-de-France;77;3;05;398;Sablonnières;721;8;729
11;Île-de-France;77;1;05;400;Saint-Augustin;1742;27;1769
11;Île-de-France;77;3;05;402;Saint-Barthélemy;334;5;339
11;Île-de-France;77;3;18;403;Saint-Brice;793;17;810
11;Île-de-France;77;3;05;405;Saint-Cyr-sur-Morin;1960;44;2004
11;Île-de-France;77;3;05;406;Saint-Denis-lès-Rebais;994;19;1013
11;Île-de-France;77;2;19;407;Saint-Fargeau-Ponthierry;14109;124;14233
11;Île-de-France;77;1;21;408;Saint-Fiacre;403;2;405
11;Île-de-France;77;3;13;409;Saint-Germain-Laval;2732;101;2833
11;Île-de-France;77;2;11;410;Saint-Germain-Laxis;741;26;767
11;Île-de-France;77;3;05;411;Saint-Germain-sous-Doue;544;11;555
11;Île-de-France;77;4;07;412;Saint-Germain-sur-École;379;5;384
11;Île-de-France;77;5;21;413;Saint-Germain-sur-Morin;3755;47;3802
11;Île-de-France;77;3;18;414;Saint-Hilliers;477;7;484
11;Île-de-France;77;1;06;415;Saint-Jean-les-Deux-Jumeaux;1273;18;1291
11;Île-de-France;77;3;14;416;Saint-Just-en-Brie;241;5;246
11;Île-de-France;77;3;05;417;Saint-Léger;260;1;261
11;Île-de-France;77;3;18;418;Saint-Loup-de-Naud;879;11;890
11;Île-de-France;77;4;13;419;Saint-Mammès;3376;117;3493
11;Île-de-France;77;1;12;420;Saint-Mard;3905;26;3931
11;Île-de-France;77;3;05;421;Saint-Mars-Vieux-Maisons;274;6;280
11;Île-de-France;77;3;05;423;Saint-Martin-des-Champs;653;9;662
11;Île-de-France;77;3;18;424;Saint-Martin-du-Boschet;282;4;286
11;Île-de-France;77;4;07;425;Saint-Martin-en-Bière;744;21;765
11;Île-de-France;77;2;14;426;Saint-Méry;343;9;352
11;Île-de-France;77;1;03;427;Saint-Mesmes;612;5;617
11;Île-de-France;77;3;14;428;Saint-Ouen-en-Brie;838;12;850
11;Île-de-France;77;3;05;429;Saint-Ouen-sur-Morin;540;5;545
11;Île-de-France;77;1;12;430;Saint-Pathus;6094;52;6146
11;Île-de-France;77;4;15;431;Saint-Pierre-lès-Nemours;5444;89;5533
11;Île-de-France;77;3;05;432;Saint-Rémy-la-Vanne;987;9;996
11;Île-de-France;77;3;18;434;Saint-Sauveur-lès-Bray;361;5;366
11;Île-de-France;77;4;07;435;Saint-Sauveur-sur-École;1113;31;1144
11;Île-de-France;77;3;05;436;Saint-Siméon;894;5;899
11;Île-de-France;77;1;03;437;Saint-Soupplets;3233;29;3262
11;Île-de-France;77;5;09;438;Saint-Thibault-des-Vignes;6400;74;6474
11;Île-de-France;77;1;06;401;Sainte-Aulde;668;7;675
11;Île-de-France;77;3;18;404;Sainte-Colombe;1820;32;1852
11;Île-de-France;77;3;13;439;Salins;1138;23;1161
11;Île-de-France;77;1;06;440;Sammeron;1127;13;1140
11;Île-de-France;77;4;07;441;Samois-sur-Seine;2047;47;2094
11;Île-de-France;77;4;07;442;Samoreau;2351;59;2410
11;Île-de-France;77;1;21;443;Sancy;386;8;394
11;Île-de-France;77;3;18;444;Sancy-lès-Provins;317;2;319
11;Île-de-France;77;2;20;445;Savigny-le-Temple;29792;224;30016
11;Île-de-France;77;3;18;446;Savins;607;9;616
11;Île-de-France;77;2;19;447;Seine-Port;1870;48;1918
11;Île-de-France;77;1;06;448;Sept-Sorts;512;7;519
11;Île-de-France;77;5;21;449;Serris;9236;88;9324
11;Île-de-France;77;5;16;450;Servon;3269;52;3321
11;Île-de-France;77;1;06;451;Signy-Signets;584;6;590
11;Île-de-France;77;3;18;452;Sigy;61;0;61
11;Île-de-France;77;2;14;453;Sivry-Courtry;1184;14;1198
11;Île-de-France;77;3;18;454;Sognolles-en-Montois;384;6;390
11;Île-de-France;77;2;08;455;Soignolles-en-Brie;1981;31;2012
11;Île-de-France;77;3;18;456;Soisy-Bouy;817;19;836
11;Île-de-France;77;2;08;457;Solers;1186;22;1208
11;Île-de-France;77;4;15;458;Souppes-sur-Loing;5387;102;5489
11;Île-de-France;77;3;18;459;Sourdun;1494;399;1893
11;Île-de-France;77;1;06;460;Tancrou;353;4;357
11;Île-de-France;77;3;18;461;Thénisy;293;6;299
11;Île-de-France;77;1;12;462;Thieux;892;2;894
11;Île-de-France;77;4;13;463;Thomery;3444;115;3559
11;Île-de-France;77;5;09;464;Thorigny-sur-Marne;10263;115;10378
11;Île-de-France;77;3;15;465;Thoury-Férottes;664;9;673
11;Île-de-France;77;1;21;466;Tigeaux;383;3;386
11;Île-de-France;77;3;18;467;La Tombe;216;0;216
11;Île-de-France;77;5;22;468;Torcy;22361;106;22467
11;Île-de-France;77;1;05;469;Touquin;1213;11;1224
11;Île-de-France;77;5;16;470;Tournan-en-Brie;8613;114;8727
11;Île-de-France;77;4;07;471;Tousson;377;9;386
11;Île-de-France;77;3;05;472;La Trétoire;498;10;508
11;Île-de-France;77;4;15;473;Treuzy-Levelay;418;7;425
11;Île-de-France;77;1;03;474;Trilbardou;651;5;656
11;Île-de-France;77;1;06;475;Trilport;5061;32;5093
11;Île-de-France;77;1;06;476;Trocy-en-Multien;236;2;238
11;Île-de-France;77;4;07;477;Ury;848;30;878
11;Île-de-France;77;1;06;478;Ussy-sur-Marne;1077;10;1087
11;Île-de-France;77;5;23;479;Vaires-sur-Marne;13383;130;13513
11;Île-de-France;77;2;14;480;Valence-en-Brie;1016;8;1024
11;Île-de-France;77;3;14;481;Vanvillé;186;1;187
11;Île-de-France;77;3;13;482;Varennes-sur-Seine;3542;70;3612
11;Île-de-France;77;1;03;483;Varreddes;2021;22;2043
11;Île-de-France;77;1;21;484;Vaucourtois;266;6;272
11;Île-de-France;77;4;07;485;Le Vaudoué;729;14;743
11;Île-de-France;77;3;08;486;Vaudoy-en-Brie;900;8;908
11;Île-de-France;77;2;11;487;Vaux-le-Pénil;10985;156;11141
11;Île-de-France;77;4;15;489;Vaux-sur-Lunain;228;4;232
11;Île-de-France;77;1;06;490;Vendrest;713;9;722
11;Île-de-France;77;3;05;492;Verdelot;674;4;678
11;Île-de-France;77;3;14;493;Verneuil-l'Étang;3223;21;3244
11;Île-de-France;77;4;13;494;Vernou-la-Celle-sur-Seine;2662;37;2699
11;Île-de-France;77;2;20;495;Vert-Saint-Denis;7874;79;7953
11;Île-de-France;77;3;14;496;Vieux-Champagne;190;4;194
11;Île-de-France;77;1;03;498;Vignely;308;0;308
11;Île-de-France;77;4;13;516;Ville-Saint-Jacques;842;25;867
11;Île-de-France;77;4;15;500;Villebéon;473;9;482
11;Île-de-France;77;4;13;501;Villecerf;719;17;736
11;Île-de-France;77;4;15;504;Villemaréchal ;1105;17;1122
11;Île-de-France;77;1;21;505;Villemareuil;395;5;400
11;Île-de-France;77;4;15;506;Villemer;745;10;755
11;Île-de-France;77;3;18;507;Villenauxe-la-Petite;419;6;425
11;Île-de-France;77;5;16;508;Villeneuve-le-Comte;1833;36;1869
11;Île-de-France;77;3;18;509;Villeneuve-les-Bordes;611;7;618
11;Île-de-France;77;5;16;510;Villeneuve-Saint-Denis;955;4;959
11;Île-de-France;77;1;12;511;Villeneuve-sous-Dammartin;643;0;643
11;Île-de-France;77;3;05;512;Villeneuve-sur-Bellot;1130;12;1142
11;Île-de-France;77;1;03;513;Villenoy;4941;33;4974
11;Île-de-France;77;1;23;514;Villeparisis;26471;95;26566
11;Île-de-France;77;1;03;515;Villeroy;713;5;718
11;Île-de-France;77;1;23;517;Villevaudé;2134;13;2147
11;Île-de-France;77;2;07;518;Villiers-en-Bière;210;3;213
11;Île-de-France;77;3;18;519;Villiers-Saint-Georges;1210;26;1236
11;Île-de-France;77;4;07;520;Villiers-sous-Grez;651;20;671
11;Île-de-France;77;1;21;521;Villiers-sur-Morin;1941;46;1987
11;Île-de-France;77;3;18;522;Villiers-sur-Seine;299;6;305
11;Île-de-France;77;3;18;523;Villuis;260;3;263
11;Île-de-France;77;3;18;524;Vimpelles;521;6;527
11;Île-de-France;77;1;12;525;Vinantes;384;2;386
11;Île-de-France;77;1;06;526;Vincy-Manœuvre;283;5;288
11;Île-de-France;77;3;08;527;Voinsles;586;17;603
11;Île-de-France;77;2;11;528;Voisenon;1140;16;1156
11;Île-de-France;77;1;21;529;Voulangis;1508;30;1538
11;Île-de-France;77;3;18;530;Voulton;316;12;328
11;Île-de-France;77;3;15;531;Voulx;1697;23;1720
11;Île-de-France;77;3;18;532;Vulaines-lès-Provins;66;0;66
11;Île-de-France;77;4;07;533;Vulaines-sur-Seine;2732;62;2794
11;Île-de-France;77;2;14;534;Yèbles;956;1;957
11;Île-de-France;78;2;14;003;Ablis;3443;47;3490
11;Île-de-France;78;3;13;005;Achères;21098;154;21252
11;Île-de-France;78;1;02;006;Adainville;696;17;713
11;Île-de-France;78;3;16;007;Aigremont;1080;48;1128
11;Île-de-France;78;2;14;009;Allainville;299;6;305
11;Île-de-France;78;3;19;010;Les Alluets-le-Roi;1207;36;1243
11;Île-de-France;78;3;01;013;Andelu;477;4;481
11;Île-de-France;78;3;05;015;Andrésy;13078;148;13226
11;Île-de-France;78;1;02;020;Arnouville-lès-Mantes;941;12;953
11;Île-de-France;78;1;01;029;Aubergenville;11974;63;12037
11;Île-de-France;78;2;14;030;Auffargis;1973;47;2020
11;Île-de-France;78;1;02;031;Auffreville-Brasseuil;649;10;659
11;Île-de-France;78;1;01;033;Aulnay-sur-Mauldre;1137;24;1161
11;Île-de-France;78;2;01;034;Auteuil;969;19;988
11;Île-de-France;78;2;01;036;Autouillet;547;7;554
11;Île-de-France;78;4;04;043;Bailly;3615;136;3751
11;Île-de-France;78;1;02;048;Bazainville;1455;41;1496
11;Île-de-France;78;3;01;049;Bazemont;1615;45;1660
11;Île-de-France;78;2;01;050;Bazoches-sur-Guyonne;627;9;636
11;Île-de-France;78;2;01;053;Béhoust;469;12;481
11;Île-de-France;78;1;02;057;Bennecourt;1892;21;1913
11;Île-de-France;78;2;12;062;Beynes;7651;112;7763
11;Île-de-France;78;1;02;068;Blaru;893;20;913
11;Île-de-France;78;1;02;070;Boinville-en-Mantois;292;2;294
11;Île-de-France;78;2;14;071;Boinville-le-Gaillard;607;9;616
11;Île-de-France;78;1;02;072;Boinvilliers;277;2;279
11;Île-de-France;78;4;15;073;Bois-d'Arcy;15220;146;15366
11;Île-de-France;78;1;02;076;Boissets;275;4;279
11;Île-de-France;78;2;14;077;La Boissière-École;759;65;824
11;Île-de-France;78;1;02;082;Boissy-Mauvoisin;619;11;630
11;Île-de-France;78;2;01;084;Boissy-sans-Avoir;652;11;663
11;Île-de-France;78;2;14;087;Bonnelles;2021;50;2071
11;Île-de-France;78;1;02;089;Bonnières-sur-Seine;4700;38;4738
11;Île-de-France;78;1;01;090;Bouafle;2177;28;2205
11;Île-de-France;78;4;04;092;Bougival;8795;143;8938
11;Île-de-France;78;1;02;096;Bourdonné;492;8;500
11;Île-de-France;78;1;02;104;Breuil-Bois-Robert;741;12;753
11;Île-de-France;78;1;02;107;Bréval;1801;26;1827
11;Île-de-France;78;2;14;108;Les Bréviaires;1275;28;1303
11;Île-de-France;78;1;07;113;Brueil-en-Vexin;696;12;708
11;Île-de-France;78;4;21;117;Buc;5858;161;6019
11;Île-de-France;78;1;08;118;Buchelay;3111;22;3133
11;Île-de-France;78;2;14;120;Bullion;1910;62;1972
11;Île-de-France;78;3;13;123;Carrières-sous-Poissy;16248;115;16363
11;Île-de-France;78;3;06;124;Carrières-sur-Seine;15003;203;15206
11;Île-de-France;78;2;14;125;La Celle-les-Bordes;838;31;869
11;Île-de-France;78;4;04;126;La Celle-Saint-Cloud;20830;407;21237
11;Île-de-France;78;2;14;128;Cernay-la-Ville;1570;38;1608
11;Île-de-France;78;3;16;133;Chambourcy;5607;141;5748
11;Île-de-France;78;3;05;138;Chanteloup-les-Vignes;10341;73;10414
11;Île-de-France;78;1;11;140;Chapet;1339;25;1364
11;Île-de-France;78;4;09;143;Châteaufort;1408;39;1447
11;Île-de-France;78;3;03;146;Chatou;30330;520;30850
11;Île-de-France;78;1;02;147;Chaufour-lès-Bonnières;475;7;482
11;Île-de-France;78;3;15;152;Chavenay;1791;78;1869
11;Île-de-France;78;4;04;158;Chesnay-Rocquencourt ;31306;641;31947
11;Île-de-France;78;2;09;160;Chevreuse;5647;136;5783
11;Île-de-France;78;2;09;162;Choisel;551;27;578
11;Île-de-France;78;1;02;163;Civry-la-Forêt;335;4;339
11;Île-de-France;78;2;14;164;Clairefontaine-en-Yvelines;825;64;889
11;Île-de-France;78;4;12;165;Les Clayes-sous-Bois;17560;234;17794
11;Île-de-France;78;2;09;168;Coignières;4334;31;4365
11;Île-de-France;78;1;02;171;Condé-sur-Vesgre;1222;26;1248
11;Île-de-France;78;3;05;172;Conflans-Sainte-Honorine;35656;412;36068
11;Île-de-France;78;1;02;185;Courgent;369;11;380
11;Île-de-France;78;1;02;188;Cravent;422;6;428
11;Île-de-France;78;3;19;189;Crespières;1641;62;1703
11;Île-de-France;78;3;03;190;Croissy-sur-Seine;9602;331;9933
11;Île-de-France;78;1;02;192;Dammartin-en-Serve;1341;16;1357
11;Île-de-France;78;2;09;193;Dampierre-en-Yvelines;1030;15;1045
11;Île-de-France;78;1;02;194;Dannemarie;202;3;205
11;Île-de-France;78;3;19;196;Davron;299;14;313
11;Île-de-France;78;1;07;202;Drocourt;562;8;570
11;Île-de-France;78;1;11;206;Ecquevilly;4205;44;4249
11;Île-de-France;78;2;18;208;Élancourt;25575;245;25820
11;Île-de-France;78;2;14;209;Émancé;880;13;893
11;Île-de-France;78;1;07;217;Épône;6500;93;6593
11;Île-de-France;78;2;14;220;Les Essarts-le-Roi;6688;137;6825
11;Île-de-France;78;3;16;224;L' Étang-la-Ville;4459;185;4644
11;Île-de-France;78;1;11;227;Évecquemont;788;14;802
11;Île-de-France;78;1;07;230;La Falaise;590;8;598
11;Île-de-France;78;1;02;231;Favrieux;149;6;155
11;Île-de-France;78;3;19;233;Feucherolles;2951;139;3090
11;Île-de-France;78;1;02;234;Flacourt;178;0;178
11;Île-de-France;78;2;01;236;Flexanville;589;14;603
11;Île-de-France;78;1;02;237;Flins-Neuve-Église;155;2;157
11;Île-de-France;78;1;01;238;Flins-sur-Seine;2419;30;2449
11;Île-de-France;78;1;07;239;Follainville-Dennemont;2131;30;2161
11;Île-de-France;78;4;15;242;Fontenay-le-Fleury;13494;143;13637
11;Île-de-France;78;1;02;245;Fontenay-Mauvoisin;387;14;401
11;Île-de-France;78;1;07;246;Fontenay-Saint-Père;968;19;987
11;Île-de-France;78;1;02;255;Freneuse;4339;58;4397
11;Île-de-France;78;1;11;261;Gaillon-sur-Montcient;671;13;684
11;Île-de-France;78;2;01;262;Galluis;1218;17;1235
11;Île-de-France;78;2;01;263;Gambais;2479;63;2542
11;Île-de-France;78;2;14;264;Gambaiseuil;60;1;61
11;Île-de-France;78;2;01;265;Garancières;2387;53;2440
11;Île-de-France;78;1;07;267;Gargenville;7490;65;7555
11;Île-de-France;78;2;14;269;Gazeran;1285;30;1315
11;Île-de-France;78;1;02;276;Gommecourt;673;5;678
11;Île-de-France;78;2;01;278;Goupillières;512;9;521
11;Île-de-France;78;1;02;281;Goussonville;625;10;635
11;Île-de-France;78;1;02;283;Grandchamp;314;11;325
11;Île-de-France;78;1;02;285;Gressey;544;14;558
11;Île-de-France;78;2;01;289;Grosrouvre;908;40;948
11;Île-de-France;78;1;07;290;Guernes;1078;15;1093
11;Île-de-France;78;1;02;291;Guerville;2162;38;2200
11;Île-de-France;78;1;07;296;Guitrancourt;619;11;630
11;Île-de-France;78;4;10;297;Guyancourt;29332;429;29761
11;Île-de-France;78;1;11;299;Hardricourt;2392;20;2412
11;Île-de-France;78;1;02;300;Hargeville;446;5;451
11;Île-de-France;78;1;02;302;La Hauteville;170;5;175
11;Île-de-France;78;3;01;305;Herbeville;251;6;257
11;Île-de-France;78;2;14;307;Hermeray;952;25;977
11;Île-de-France;78;1;02;310;Houdan;3655;41;3696
11;Île-de-France;78;3;06;311;Houilles;32449;343;32792
11;Île-de-France;78;1;07;314;Issou;3997;47;4044
11;Île-de-France;78;1;07;317;Jambville;815;13;828
11;Île-de-France;78;2;01;321;Jouars-Pontchartrain;5715;116;5831
11;Île-de-France;78;4;21;322;Jouy-en-Josas;8124;168;8292
11;Île-de-France;78;1;02;324;Jouy-Mauvoisin;556;3;559
11;Île-de-France;78;1;02;325;Jumeauville;609;7;616
11;Île-de-France;78;1;07;327;Juziers;3873;46;3919
11;Île-de-France;78;1;07;329;Lainville-en-Vexin;782;12;794
11;Île-de-France;78;2;09;334;Lévis-Saint-Nom;1601;46;1647
11;Île-de-France;78;1;07;335;Limay;17147;104;17251
11;Île-de-France;78;1;02;337;Limetz-Villez;1936;32;1968
11;Île-de-France;78;4;21;343;Les Loges-en-Josas;1596;63;1659
11;Île-de-France;78;1;02;344;Lommoye;665;9;674
11;Île-de-France;78;1;02;346;Longnes;1475;23;1498
11;Île-de-France;78;2;14;349;Longvilliers;504;12;516
11;Île-de-France;78;3;04;350;Louveciennes;7055;161;7216
11;Île-de-France;78;1;08;354;Magnanville;6104;133;6237
11;Île-de-France;78;2;09;356;Magny-les-Hameaux;9337;168;9505
11;Île-de-France;78;3;17;358;Maisons-Laffitte;23611;513;24124
11;Île-de-France;78;1;08;361;Mantes-la-Jolie;44227;196;44423
11;Île-de-France;78;1;08;362;Mantes-la-Ville;20499;155;20654
11;Île-de-France;78;2;01;364;Marcq;766;9;775
11;Île-de-France;78;2;01;366;Mareil-le-Guyon;385;11;396
11;Île-de-France;78;3;16;367;Mareil-Marly;3447;157;3604
11;Île-de-France;78;3;01;368;Mareil-sur-Mauldre;1685;36;1721
11;Île-de-France;78;3;03;372;Marly-le-Roi;16335;498;16833
11;Île-de-France;78;3;01;380;Maule;5878;221;6099
11;Île-de-France;78;1;02;381;Maulette;992;14;1006
11;Île-de-France;78;3;05;382;Maurecourt;4327;52;4379
11;Île-de-France;78;2;09;383;Maurepas;18019;248;18267
11;Île-de-France;78;3;19;384;Médan;1356;45;1401
11;Île-de-France;78;1;02;385;Ménerville;210;1;211
11;Île-de-France;78;2;01;389;Méré;1673;50;1723
11;Île-de-France;78;1;02;391;Méricourt;408;7;415
11;Île-de-France;78;3;17;396;Le Mesnil-le-Roi;6292;151;6443
11;Île-de-France;78;2;09;397;Le Mesnil-Saint-Denis;6814;117;6931
11;Île-de-France;78;2;01;398;Les Mesnuls;853;22;875
11;Île-de-France;78;1;11;401;Meulan-en-Yvelines;9005;76;9081
11;Île-de-France;78;1;07;402;Mézières-sur-Seine;3707;41;3748
11;Île-de-France;78;1;11;403;Mézy-sur-Seine;2282;35;2317
11;Île-de-France;78;2;01;404;Millemont;266;4;270
11;Île-de-France;78;2;09;406;Milon-la-Chapelle;286;12;298
11;Île-de-France;78;2;14;407;Mittainville;617;15;632
11;Île-de-France;78;1;02;410;Moisson;978;7;985
11;Île-de-France;78;1;02;413;Mondreville;408;3;411
11;Île-de-France;78;3;01;415;Montainville;501;20;521
11;Île-de-France;78;1;07;416;Montalet-le-Bois;312;5;317
11;Île-de-France;78;1;02;417;Montchauvet;291;7;298
11;Île-de-France;78;3;06;418;Montesson;15013;277;15290
11;Île-de-France;78;2;01;420;Montfort-l'Amaury;2938;78;3016
11;Île-de-France;78;4;10;423;Montigny-le-Bretonneux;32575;471;33046
11;Île-de-France;78;3;19;431;Morainvilliers;3027;82;3109
11;Île-de-France;78;1;02;437;Mousseaux-sur-Seine;680;9;689
11;Île-de-France;78;1;02;439;Mulcent;111;1;112
11;Île-de-France;78;1;11;440;Les Mureaux;32949;156;33105
11;Île-de-France;78;2;01;442;Neauphle-le-Château;3385;54;3439
11;Île-de-France;78;2;01;443;Neauphle-le-Vieux;919;19;938
11;Île-de-France;78;1;02;444;Neauphlette;817;15;832
11;Île-de-France;78;1;01;451;Nézel;1041;15;1056
11;Île-de-France;78;4;19;455;Noisy-le-Roi;7577;285;7862
11;Île-de-France;78;1;02;320;Notre-Dame-de-la-Mer;670;14;684
11;Île-de-France;78;1;07;460;Oinville-sur-Montcient;1069;20;1089
11;Île-de-France;78;2;14;464;Orcemont;1008;22;1030
11;Île-de-France;78;1;02;465;Orgerus;2409;67;2476
11;Île-de-France;78;3;19;466;Orgeval;6479;193;6672
11;Île-de-France;78;2;14;470;Orphin;895;26;921
11;Île-de-France;78;2;14;472;Orsonville;332;6;338
11;Île-de-France;78;1;02;474;Orvilliers;924;9;933
11;Île-de-France;78;1;02;475;Osmoy;372;9;381
11;Île-de-France;78;2;14;478;Paray-Douaville;262;7;269
11;Île-de-France;78;3;16;481;Le Pecq;15949;347;16296
11;Île-de-France;78;1;02;484;Perdreauville;635;16;651
11;Île-de-France;78;2;14;486;Le Perray-en-Yvelines;6656;114;6770
11;Île-de-France;78;4;12;490;Plaisir;31013;352;31365
11;Île-de-France;78;2;14;497;Poigny-la-Forêt;919;41;960
11;Île-de-France;78;3;13;498;Poissy;38313;293;38606
11;Île-de-France;78;2;14;499;Ponthévrard;650;19;669
11;Île-de-France;78;1;07;501;Porcheville;3193;83;3276
11;Île-de-France;78;3;03;502;Le Port-Marly;5509;57;5566
11;Île-de-France;78;2;14;506;Prunay-en-Yvelines;878;9;887
11;Île-de-France;78;1;02;505;Prunay-le-Temple;415;17;432
11;Île-de-France;78;2;01;513;La Queue-les-Yvelines;2175;31;2206
11;Île-de-France;78;2;14;516;Raizeux;966;16;982
11;Île-de-France;78;2;14;517;Rambouillet;26933;498;27431
11;Île-de-France;78;4;15;518;Rennemoulin;109;4;113
11;Île-de-France;78;1;02;520;Richebourg;1454;25;1479
11;Île-de-France;78;2;14;522;Rochefort-en-Yvelines;916;38;954
11;Île-de-France;78;1;02;528;Rolleboise;386;3;389
11;Île-de-France;78;1;02;530;Rosay;371;6;377
11;Île-de-France;78;1;08;531;Rosny-sur-Seine;6658;45;6703
11;Île-de-France;78;1;07;536;Sailly;367;11;378
11;Île-de-France;78;2;14;537;Saint-Arnoult-en-Yvelines;5910;137;6047
11;Île-de-France;78;4;15;545;Saint-Cyr-l'École;19011;643;19654
11;Île-de-France;78;2;09;548;Saint-Forget;495;13;508
11;Île-de-France;78;2;01;550;Saint-Germain-de-la-Grange;1859;37;1896
11;Île-de-France;78;3;16;551;Saint-Germain-en-Laye ;44750;1849;46599
11;Île-de-France;78;2;14;557;Saint-Hilarion;941;17;958
11;Île-de-France;78;1;02;558;Saint-Illiers-la-Ville;396;8;404
11;Île-de-France;78;1;02;559;Saint-Illiers-le-Bois;427;5;432
11;Île-de-France;78;2;09;561;Saint-Lambert;449;37;486
11;Île-de-France;78;2;14;562;Saint-Léger-en-Yvelines;1385;32;1417
11;Île-de-France;78;2;14;564;Saint-Martin-de-Bréthencourt;655;9;664
11;Île-de-France;78;1;02;565;Saint-Martin-des-Champs;303;9;312
11;Île-de-France;78;1;07;567;Saint-Martin-la-Garenne;952;11;963
11;Île-de-France;78;3;19;571;Saint-Nom-la-Bretèche;4915;210;5125
11;Île-de-France;78;2;01;576;Saint-Rémy-l'Honoré;1578;29;1607
11;Île-de-France;78;2;09;575;Saint-Rémy-lès-Chevreuse;7810;158;7968
11;Île-de-France;78;2;14;569;Sainte-Mesme;930;19;949
11;Île-de-France;78;3;17;586;Sartrouville;52269;447;52716
11;Île-de-France;78;2;01;588;Saulx-Marchais;946;27;973
11;Île-de-France;78;2;09;590;Senlisse;495;11;506
11;Île-de-France;78;1;02;591;Septeuil;2343;24;2367
11;Île-de-France;78;1;02;597;Soindres;682;8;690
11;Île-de-France;78;2;14;601;Sonchamp;1619;64;1683
11;Île-de-France;78;1;02;605;Tacoignières;1037;17;1054
11;Île-de-France;78;1;02;606;Le Tartre-Gaudran;36;1;37
11;Île-de-France;78;1;02;608;Le Tertre-Saint-Denis;125;1;126
11;Île-de-France;78;1;11;609;Tessancourt-sur-Aubette;1041;6;1047
11;Île-de-France;78;2;12;615;Thiverval-Grignon;1030;18;1048
11;Île-de-France;78;2;01;616;Thoiry;1419;28;1447
11;Île-de-France;78;1;02;618;Tilly;522;14;536
11;Île-de-France;78;4;09;620;Toussus-le-Noble;1168;39;1207
11;Île-de-France;78;4;18;621;Trappes;32120;116;32236
11;Île-de-France;78;2;01;623;Le Tremblay-sur-Mauldre;940;137;1077
11;Île-de-France;78;3;19;624;Triel-sur-Seine;12081;215;12296
11;Île-de-France;78;1;11;638;Vaux-sur-Seine;4929;66;4995
11;Île-de-France;78;4;21;640;Vélizy-Villacoublay;22649;187;22836
11;Île-de-France;78;3;19;642;Verneuil-sur-Seine;15982;371;16353
11;Île-de-France;78;3;19;643;Vernouillet;10077;186;10263
11;Île-de-France;78;2;18;644;La Verrière;6551;85;6636
11;Île-de-France;78;4;99;646;Versailles;85205;2048;87253
11;Île-de-France;78;1;02;647;Vert;835;12;847
11;Île-de-France;78;3;03;650;Le Vésinet;15865;556;16421
11;Île-de-France;78;2;01;653;Vicq;387;10;397
11;Île-de-France;78;2;14;655;Vieille-Église-en-Yvelines;659;27;686
11;Île-de-France;78;1;02;668;La Villeneuve-en-Chevrie;649;10;659
11;Île-de-France;78;3;19;672;Villennes-sur-Seine;5331;167;5498
11;Île-de-France;78;4;15;674;Villepreux;10975;203;11178
11;Île-de-France;78;1;02;677;Villette;516;17;533
11;Île-de-France;78;2;01;681;Villiers-le-Mahieu;812;16;828
11;Île-de-France;78;2;01;683;Villiers-Saint-Frédéric;2908;161;3069
11;Île-de-France;78;4;21;686;Viroflay;16406;341;16747
11;Île-de-France;78;2;09;688;Voisins-le-Bretonneux;10921;381;11302
75;Nouvelle-Aquitaine;79;1;04;001;L' Absie;1016;14;1030
75;Nouvelle-Aquitaine;79;3;13;002;Adilly;306;5;311
75;Nouvelle-Aquitaine;79;2;14;003;Aiffres;5432;171;5603
75;Nouvelle-Aquitaine;79;2;03;185;Aigondigné ;4703;144;4847
75;Nouvelle-Aquitaine;79;3;17;005;Airvault ;3291;47;3338
75;Nouvelle-Aquitaine;79;2;08;136;Alloinay;881;17;898
75;Nouvelle-Aquitaine;79;3;06;007;Allonne;667;19;686
75;Nouvelle-Aquitaine;79;3;13;008;Amailloux;822;7;829
75;Nouvelle-Aquitaine;79;2;05;009;Amuré;430;9;439
75;Nouvelle-Aquitaine;79;3;01;012;Ardin;1237;32;1269
75;Nouvelle-Aquitaine;79;1;07;013;Argentonnay ;3189;89;3278
75;Nouvelle-Aquitaine;79;2;05;010;Arçais;612;6;618
75;Nouvelle-Aquitaine;79;2;09;015;Asnières-en-Poitou;200;5;205
75;Nouvelle-Aquitaine;79;3;17;016;Assais-les-Jumeaux;767;12;779
75;Nouvelle-Aquitaine;79;2;08;018;Aubigné;197;5;202
75;Nouvelle-Aquitaine;79;3;06;019;Aubigny;166;1;167
75;Nouvelle-Aquitaine;79;2;15;020;Augé;898;22;920
75;Nouvelle-Aquitaine;79;3;17;022;Availles-Thouarsais;195;1;196
75;Nouvelle-Aquitaine;79;2;03;023;Avon;65;1;66
75;Nouvelle-Aquitaine;79;2;15;024;Azay-le-Brûlé;1964;94;2058
75;Nouvelle-Aquitaine;79;3;06;025;Azay-sur-Thouet;1136;29;1165
75;Nouvelle-Aquitaine;79;3;06;029;Beaulieu-sous-Parthenay;669;14;683
75;Nouvelle-Aquitaine;79;2;03;030;Beaussais-Vitré;976;55;1031
75;Nouvelle-Aquitaine;79;2;09;031;Beauvoir-sur-Niort;1761;37;1798
75;Nouvelle-Aquitaine;79;3;01;032;Béceleuf;765;14;779
75;Nouvelle-Aquitaine;79;2;05;034;Bessines;1688;64;1752
75;Nouvelle-Aquitaine;79;3;01;077;Beugnon-Thireuil ;730;10;740
75;Nouvelle-Aquitaine;79;1;02;038;Boismé;1190;28;1218
75;Nouvelle-Aquitaine;79;3;06;040;La Boissière-en-Gâtine;241;2;243
75;Nouvelle-Aquitaine;79;2;03;042;Bougon;177;6;183
75;Nouvelle-Aquitaine;79;2;09;046;Le Bourdet;575;6;581
75;Nouvelle-Aquitaine;79;3;17;047;Boussais;455;10;465
75;Nouvelle-Aquitaine;79;1;02;049;Bressuire;19733;993;20726
75;Nouvelle-Aquitaine;79;1;04;050;Bretignolles;592;16;608
75;Nouvelle-Aquitaine;79;2;09;055;Brieuil-sur-Chizé;123;3;126
75;Nouvelle-Aquitaine;79;1;17;056;Brion-près-Thouet;735;11;746
75;Nouvelle-Aquitaine;79;2;09;057;Brioux-sur-Boutonne;1459;51;1510
75;Nouvelle-Aquitaine;79;2;14;058;Brûlain;762;17;779
75;Nouvelle-Aquitaine;79;3;01;059;Le Busseau;732;8;740
75;Nouvelle-Aquitaine;79;2;08;060;Caunay;180;3;183
75;Nouvelle-Aquitaine;79;2;03;061;Celles-sur-Belle ;3906;57;3963
75;Nouvelle-Aquitaine;79;1;04;062;Cerizay;4762;73;4835
75;Nouvelle-Aquitaine;79;3;01;066;Champdeniers;1700;39;1739
75;Nouvelle-Aquitaine;79;1;04;069;Chanteloup;1012;23;1035
75;Nouvelle-Aquitaine;79;3;01;070;La Chapelle-Bâton;398;10;408
75;Nouvelle-Aquitaine;79;3;13;071;La Chapelle-Bertrand;474;14;488
75;Nouvelle-Aquitaine;79;2;08;074;La Chapelle-Pouilloux;183;5;188
75;Nouvelle-Aquitaine;79;1;04;076;La Chapelle-Saint-Laurent;2018;25;2043
75;Nouvelle-Aquitaine;79;3;06;105;Châteliers ;475;9;484
75;Nouvelle-Aquitaine;79;3;13;080;Châtillon-sur-Thouet;2681;55;2736
75;Nouvelle-Aquitaine;79;2;14;081;Chauray;7044;206;7250
75;Nouvelle-Aquitaine;79;2;08;083;Chef-Boutonne;2508;119;2627
75;Nouvelle-Aquitaine;79;2;03;084;Chenay;454;3;457
75;Nouvelle-Aquitaine;79;2;09;085;Chérigné;138;5;143
75;Nouvelle-Aquitaine;79;2;01;086;Cherveux;1934;42;1976
75;Nouvelle-Aquitaine;79;2;03;087;Chey;563;9;572
75;Nouvelle-Aquitaine;79;1;02;088;Chiché;1693;44;1737
75;Nouvelle-Aquitaine;79;3;17;089;Le Chillou;163;1;164
75;Nouvelle-Aquitaine;79;2;09;090;Chizé;854;22;876
75;Nouvelle-Aquitaine;79;1;04;091;Cirières;944;24;968
75;Nouvelle-Aquitaine;79;3;06;092;Clavé;362;4;366
75;Nouvelle-Aquitaine;79;1;04;094;Clessé;952;9;961
75;Nouvelle-Aquitaine;79;2;08;095;Clussais-la-Pommeraie;588;12;600
75;Nouvelle-Aquitaine;79;1;04;096;Combrand;1159;34;1193
75;Nouvelle-Aquitaine;79;2;05;100;Coulon;2262;55;2317
75;Nouvelle-Aquitaine;79;3;01;101;Coulonges-sur-l'Autize;2349;49;2398
75;Nouvelle-Aquitaine;79;1;17;102;Coulonges-Thouarsais;433;3;436
75;Nouvelle-Aquitaine;79;1;04;103;Courlay;2429;49;2478
75;Nouvelle-Aquitaine;79;3;01;104;Cours;555;13;568
75;Nouvelle-Aquitaine;79;2;08;106;Couture-d'Argenson;390;2;392
75;Nouvelle-Aquitaine;79;2;15;048;La Crèche;5786;132;5918
75;Nouvelle-Aquitaine;79;3;06;108;Doux;229;1;230
75;Nouvelle-Aquitaine;79;2;14;109;Échiré;3406;98;3504
75;Nouvelle-Aquitaine;79;2;09;111;Ensigné;287;4;291
75;Nouvelle-Aquitaine;79;2;05;112;Épannes;864;24;888
75;Nouvelle-Aquitaine;79;2;15;114;Exireuil;1580;31;1611
75;Nouvelle-Aquitaine;79;2;03;115;Exoudun;572;10;582
75;Nouvelle-Aquitaine;79;1;02;116;Faye-l'Abbesse;1090;17;1107
75;Nouvelle-Aquitaine;79;3;01;117;Faye-sur-Ardin;640;8;648
75;Nouvelle-Aquitaine;79;3;13;118;Fénery;287;6;293
75;Nouvelle-Aquitaine;79;3;01;119;Fenioux;637;11;648
75;Nouvelle-Aquitaine;79;3;06;120;La Ferrière-en-Parthenay;768;13;781
75;Nouvelle-Aquitaine;79;3;06;121;Fomperron;412;11;423
75;Nouvelle-Aquitaine;79;2;08;122;Fontenille-Saint-Martin-d'Entraigues;541;5;546
75;Nouvelle-Aquitaine;79;2;08;064;Fontivillié ;854;24;878
75;Nouvelle-Aquitaine;79;1;04;123;La Forêt-sur-Sèvre;2338;49;2387
75;Nouvelle-Aquitaine;79;3;06;124;Les Forges;121;5;126
75;Nouvelle-Aquitaine;79;2;05;125;Fors;1802;55;1857
75;Nouvelle-Aquitaine;79;2;09;126;Les Fosses;444;10;454
75;Nouvelle-Aquitaine;79;2;09;127;La Foye-Monjault;847;7;854
75;Nouvelle-Aquitaine;79;2;15;128;François;948;26;974
75;Nouvelle-Aquitaine;79;2;03;129;Fressines;1687;30;1717
75;Nouvelle-Aquitaine;79;2;05;130;Frontenay-Rohan-Rohan;2833;98;2931
75;Nouvelle-Aquitaine;79;1;02;131;Geay;318;7;325
75;Nouvelle-Aquitaine;79;1;07;132;Genneton;322;6;328
75;Nouvelle-Aquitaine;79;2;01;133;Germond-Rouvre;1178;23;1201
75;Nouvelle-Aquitaine;79;1;17;134;Glénay;569;14;583
75;Nouvelle-Aquitaine;79;3;06;135;Gourgé;965;23;988
75;Nouvelle-Aquitaine;79;2;05;137;Granzay-Gript;903;18;921
75;Nouvelle-Aquitaine;79;3;06;139;Les Groseillers;57;2;59
75;Nouvelle-Aquitaine;79;3;17;141;Irais;207;4;211
75;Nouvelle-Aquitaine;79;2;09;142;Juillé;100;2;102
75;Nouvelle-Aquitaine;79;2;14;144;Juscorps;366;7;373
75;Nouvelle-Aquitaine;79;3;13;145;Lageon;367;5;372
75;Nouvelle-Aquitaine;79;1;04;147;Largeasse;741;9;750
75;Nouvelle-Aquitaine;79;2;03;148;Lezay;1993;27;2020
75;Nouvelle-Aquitaine;79;3;06;149;Lhoumois;141;2;143
75;Nouvelle-Aquitaine;79;2;08;150;Limalonges;827;16;843
75;Nouvelle-Aquitaine;79;1;17;014;Loretz-d'Argenton ;2637;36;2673
75;Nouvelle-Aquitaine;79;2;08;152;Lorigné;301;6;307
75;Nouvelle-Aquitaine;79;2;08;153;Loubigné;159;3;162
75;Nouvelle-Aquitaine;79;2;08;154;Loubillé;396;6;402
75;Nouvelle-Aquitaine;79;3;17;156;Louin;685;25;710
75;Nouvelle-Aquitaine;79;1;16;157;Louzy;1340;41;1381
75;Nouvelle-Aquitaine;79;2;09;158;Luché-sur-Brioux;137;3;140
75;Nouvelle-Aquitaine;79;1;17;159;Luché-Thouarsais;514;4;518
75;Nouvelle-Aquitaine;79;2;09;160;Lusseray;160;3;163
75;Nouvelle-Aquitaine;79;1;17;161;Luzay;643;12;655
75;Nouvelle-Aquitaine;79;2;05;162;Magné;2685;64;2749
75;Nouvelle-Aquitaine;79;2;08;163;Mairé-Levescault;524;10;534
75;Nouvelle-Aquitaine;79;2;08;164;Maisonnay;258;4;262
75;Nouvelle-Aquitaine;79;3;17;165;Maisontiers;147;5;152
75;Nouvelle-Aquitaine;79;2;08;251;Marcillé ;753;29;782
75;Nouvelle-Aquitaine;79;2;09;166;Marigny;875;14;889
75;Nouvelle-Aquitaine;79;1;17;167;Marnes;247;11;258
75;Nouvelle-Aquitaine;79;1;07;079;Mauléon;8533;225;8758
75;Nouvelle-Aquitaine;79;2;09;170;Mauzé-sur-le-Mignon;2848;54;2902
75;Nouvelle-Aquitaine;79;3;06;172;Mazières-en-Gâtine;1018;23;1041
75;Nouvelle-Aquitaine;79;2;08;174;Melle ;6200;329;6529
75;Nouvelle-Aquitaine;79;2;08;175;Melleran;498;12;510
75;Nouvelle-Aquitaine;79;3;06;176;Ménigoute;858;23;881
75;Nouvelle-Aquitaine;79;2;03;177;Messé;192;4;196
75;Nouvelle-Aquitaine;79;1;04;179;Moncoutant-sur-Sèvre ;5046;176;5222
75;Nouvelle-Aquitaine;79;2;08;180;Montalembert;308;3;311
75;Nouvelle-Aquitaine;79;1;04;183;Montravers;378;10;388
75;Nouvelle-Aquitaine;79;2;03;184;La Mothe-Saint-Héray;1684;24;1708
75;Nouvelle-Aquitaine;79;2;15;189;Nanteuil;1708;31;1739
75;Nouvelle-Aquitaine;79;1;04;190;Neuvy-Bouin;502;3;505
75;Nouvelle-Aquitaine;79;2;99;191;Niort;59059;1817;60876
75;Nouvelle-Aquitaine;79;1;07;195;Nueil-les-Aubiers;5513;118;5631
75;Nouvelle-Aquitaine;79;3;06;197;Oroux;93;2;95
75;Nouvelle-Aquitaine;79;2;09;198;Paizay-le-Chapt;261;3;264
75;Nouvelle-Aquitaine;79;3;01;200;Pamplie;269;3;272
75;Nouvelle-Aquitaine;79;2;03;201;Pamproux;1726;20;1746
75;Nouvelle-Aquitaine;79;3;13;202;Parthenay;10235;403;10638
75;Nouvelle-Aquitaine;79;1;17;203;Pas-de-Jeu;367;8;375
75;Nouvelle-Aquitaine;79;2;09;204;Périgné;1007;38;1045
75;Nouvelle-Aquitaine;79;2;08;205;Pers;74;3;77
75;Nouvelle-Aquitaine;79;1;07;207;La Petite-Boissière;629;17;646
75;Nouvelle-Aquitaine;79;3;06;208;La Peyratte;1154;47;1201
75;Nouvelle-Aquitaine;79;1;17;209;Pierrefitte;329;8;337
75;Nouvelle-Aquitaine;79;1;04;210;Le Pin;1052;23;1075
75;Nouvelle-Aquitaine;79;2;09;078;Plaine-d'Argenson ;970;15;985
75;Nouvelle-Aquitaine;79;1;17;196;Plaine-et-Vallées ;2399;53;2452
75;Nouvelle-Aquitaine;79;2;08;212;Pliboux;207;3;210
75;Nouvelle-Aquitaine;79;3;13;213;Pompaire;1997;54;2051
75;Nouvelle-Aquitaine;79;3;06;215;Pougne-Hérisson;369;7;376
75;Nouvelle-Aquitaine;79;2;14;216;Prahecq;2200;40;2240
75;Nouvelle-Aquitaine;79;2;03;217;Prailles-La Couarde;950;22;972
75;Nouvelle-Aquitaine;79;3;06;218;Pressigny;189;6;195
75;Nouvelle-Aquitaine;79;2;09;220;Prin-Deyrançon;604;15;619
75;Nouvelle-Aquitaine;79;3;01;223;Puihardy;61;1;62
75;Nouvelle-Aquitaine;79;3;06;225;Reffannes;375;6;381
75;Nouvelle-Aquitaine;79;3;06;226;Le Retail;277;5;282
75;Nouvelle-Aquitaine;79;2;09;229;La Rochénard;568;15;583
75;Nouvelle-Aquitaine;79;2;03;230;Rom;865;11;876
75;Nouvelle-Aquitaine;79;2;15;231;Romans;709;15;724
75;Nouvelle-Aquitaine;79;1;07;235;Saint-Amand-sur-Sèvre;1408;42;1450
75;Nouvelle-Aquitaine;79;1;04;236;Saint-André-sur-Sèvre;652;12;664
75;Nouvelle-Aquitaine;79;1;07;238;Saint-Aubin-du-Plain;544;21;565
75;Nouvelle-Aquitaine;79;3;06;239;Saint-Aubin-le-Cloud;1739;119;1858
75;Nouvelle-Aquitaine;79;3;01;241;Saint-Christophe-sur-Roc;565;11;576
75;Nouvelle-Aquitaine;79;2;03;243;Saint-Coutant;280;0;280
75;Nouvelle-Aquitaine;79;1;17;244;Saint-Cyr-la-Lande;361;4;365
75;Nouvelle-Aquitaine;79;2;14;249;Saint-Gelais;2116;62;2178
75;Nouvelle-Aquitaine;79;1;17;252;Saint-Généroux;355;13;368
75;Nouvelle-Aquitaine;79;3;06;253;Saint-Georges-de-Noisné;700;14;714
75;Nouvelle-Aquitaine;79;2;09;254;Saint-Georges-de-Rex;446;13;459
75;Nouvelle-Aquitaine;79;3;13;255;Saint-Germain-de-Longue-Chaume;402;3;405
75;Nouvelle-Aquitaine;79;3;06;256;Saint-Germier;228;6;234
75;Nouvelle-Aquitaine;79;2;09;257;Saint-Hilaire-la-Palud;1536;23;1559
75;Nouvelle-Aquitaine;79;1;16;258;Saint-Jacques-de-Thouars;435;13;448
75;Nouvelle-Aquitaine;79;1;16;259;Saint-Jean-de-Thouars;1365;35;1400
75;Nouvelle-Aquitaine;79;3;01;263;Saint-Laurs;582;11;593
75;Nouvelle-Aquitaine;79;1;17;265;Saint-Léger-de-Montbrun;1262;24;1286
75;Nouvelle-Aquitaine;79;3;06;267;Saint-Lin;329;4;333
75;Nouvelle-Aquitaine;79;3;17;268;Saint-Loup-Lamairé;987;40;1027
75;Nouvelle-Aquitaine;79;3;01;269;Saint-Maixent-de-Beugné;409;5;414
75;Nouvelle-Aquitaine;79;2;15;270;Saint-Maixent-l'École;7209;140;7349
75;Nouvelle-Aquitaine;79;3;06;271;Saint-Marc-la-Lande;365;2;367
75;Nouvelle-Aquitaine;79;2;14;273;Saint-Martin-de-Bernegoue;789;20;809
75;Nouvelle-Aquitaine;79;1;17;274;Saint-Martin-de-Mâcon;299;6;305
75;Nouvelle-Aquitaine;79;2;15;276;Saint-Martin-de-Saint-Maixent;1094;31;1125
75;Nouvelle-Aquitaine;79;1;17;277;Saint-Martin-de-Sanzay;1083;18;1101
75;Nouvelle-Aquitaine;79;3;06;278;Saint-Martin-du-Fouilloux;237;6;243
75;Nouvelle-Aquitaine;79;1;07;280;Saint Maurice Étusson;877;14;891
75;Nouvelle-Aquitaine;79;2;01;281;Saint-Maxire;1304;36;1340
75;Nouvelle-Aquitaine;79;3;06;285;Saint-Pardoux-Soutiers;1869;42;1911
75;Nouvelle-Aquitaine;79;1;04;286;Saint-Paul-en-Gâtine;447;7;454
75;Nouvelle-Aquitaine;79;1;07;289;Saint-Pierre-des-Échaubrognes;1425;25;1450
75;Nouvelle-Aquitaine;79;3;01;290;Saint-Pompain;943;15;958
75;Nouvelle-Aquitaine;79;2;01;293;Saint-Rémy;1114;24;1138
75;Nouvelle-Aquitaine;79;2;14;294;Saint-Romans-des-Champs;168;5;173
75;Nouvelle-Aquitaine;79;2;08;295;Saint-Romans-lès-Melle;713;18;731
75;Nouvelle-Aquitaine;79;2;05;298;Saint-Symphorien;1942;56;1998
75;Nouvelle-Aquitaine;79;1;17;299;Saint-Varent;2404;49;2453
75;Nouvelle-Aquitaine;79;2;08;301;Saint-Vincent-la-Châtre;634;20;654
75;Nouvelle-Aquitaine;79;2;15;246;Sainte-Eanne;608;13;621
75;Nouvelle-Aquitaine;79;1;17;250;Sainte-Gemme;399;4;403
75;Nouvelle-Aquitaine;79;2;15;283;Sainte-Néomaye;1324;31;1355
75;Nouvelle-Aquitaine;79;3;01;284;Sainte-Ouenne;794;12;806
75;Nouvelle-Aquitaine;79;2;03;297;Sainte-Soline;355;7;362
75;Nouvelle-Aquitaine;79;1;16;300;Sainte-Verge;1383;30;1413
75;Nouvelle-Aquitaine;79;2;15;302;Saivres;1428;35;1463
75;Nouvelle-Aquitaine;79;2;03;303;Salles;328;12;340
75;Nouvelle-Aquitaine;79;2;05;304;Sansais;756;51;807
75;Nouvelle-Aquitaine;79;3;06;306;Saurais;190;2;192
75;Nouvelle-Aquitaine;79;2;08;307;Sauzé-Vaussais;1555;29;1584
75;Nouvelle-Aquitaine;79;2;01;308;Sciecq;638;10;648
75;Nouvelle-Aquitaine;79;3;01;309;Scillé;352;7;359
75;Nouvelle-Aquitaine;79;2;09;310;Secondigné-sur-Belle;501;15;516
75;Nouvelle-Aquitaine;79;3;06;311;Secondigny;1823;82;1905
75;Nouvelle-Aquitaine;79;2;09;312;Séligné;117;3;120
75;Nouvelle-Aquitaine;79;2;03;313;Sepvret;620;15;635
75;Nouvelle-Aquitaine;79;2;03;316;Soudan;430;14;444
75;Nouvelle-Aquitaine;79;2;15;319;Souvigné;887;28;915
75;Nouvelle-Aquitaine;79;3;01;320;Surin;650;12;662
75;Nouvelle-Aquitaine;79;3;13;322;Le Tallud;2010;56;2066
75;Nouvelle-Aquitaine;79;3;06;326;Thénezay;1403;27;1430
75;Nouvelle-Aquitaine;79;1;16;329;Thouars ;13932;343;14275
75;Nouvelle-Aquitaine;79;1;17;331;Tourtenay;120;6;126
75;Nouvelle-Aquitaine;79;1;04;332;Trayes;121;4;125
75;Nouvelle-Aquitaine;79;2;09;334;Val-du-Mignon ;1081;22;1103
75;Nouvelle-Aquitaine;79;1;17;063;Val en Vignes;2054;101;2155
75;Nouvelle-Aquitaine;79;2;08;140;Valdelaume ;840;10;850
75;Nouvelle-Aquitaine;79;2;05;335;Vallans;791;21;812
75;Nouvelle-Aquitaine;79;2;05;337;Le Vanneau-Irleau;868;26;894
75;Nouvelle-Aquitaine;79;2;03;338;Vanzay;246;0;246
75;Nouvelle-Aquitaine;79;2;03;336;Vançais;223;2;225
75;Nouvelle-Aquitaine;79;3;06;339;Vasles;1667;29;1696
75;Nouvelle-Aquitaine;79;3;06;340;Vausseroux;324;6;330
75;Nouvelle-Aquitaine;79;3;06;341;Vautebis;113;1;114
75;Nouvelle-Aquitaine;79;3;06;342;Vernoux-en-Gâtine;573;13;586
75;Nouvelle-Aquitaine;79;2;09;343;Vernoux-sur-Boutonne;211;2;213
75;Nouvelle-Aquitaine;79;3;06;345;Verruyes;900;32;932
75;Nouvelle-Aquitaine;79;2;09;346;Le Vert;128;3;131
75;Nouvelle-Aquitaine;79;3;13;347;Viennay;1108;21;1129
75;Nouvelle-Aquitaine;79;2;09;348;Villefollet;220;5;225
75;Nouvelle-Aquitaine;79;2;08;349;Villemain;149;2;151
75;Nouvelle-Aquitaine;79;2;09;350;Villiers-en-Bois;122;3;125
75;Nouvelle-Aquitaine;79;2;01;351;Villiers-en-Plaine;1779;31;1810
75;Nouvelle-Aquitaine;79;2;09;352;Villiers-sur-Chizé;158;6;164
75;Nouvelle-Aquitaine;79;3;06;354;Vouhé;374;10;384
75;Nouvelle-Aquitaine;79;2;14;355;Vouillé;3318;100;3418
75;Nouvelle-Aquitaine;79;1;07;242;Voulmentin;1114;20;1134
75;Nouvelle-Aquitaine;79;3;01;357;Xaintray;228;3;231
32;Hauts-de-France;80;1;98;001;Abbeville;22837;409;23246
32;Hauts-de-France;80;4;18;002;Ablaincourt-Pressoir;263;5;268
32;Hauts-de-France;80;4;05;003;Acheux-en-Amiénois;589;11;600
32;Hauts-de-France;80;1;02;004;Acheux-en-Vimeu;519;4;523
32;Hauts-de-France;80;2;14;005;Agenville;88;2;90
32;Hauts-de-France;80;1;01;006;Agenvillers;242;4;246
32;Hauts-de-France;80;1;17;008;Aigneville;892;18;910
32;Hauts-de-France;80;1;23;009;Ailly-le-Haut-Clocher;982;24;1006
32;Hauts-de-France;80;3;03;010;Ailly-sur-Noye;2835;31;2866
32;Hauts-de-France;80;2;04;011;Ailly-sur-Somme;2985;26;3011
32;Hauts-de-France;80;2;04;013;Airaines;2379;32;2411
32;Hauts-de-France;80;4;20;014;Aizecourt-le-Bas;55;0;55
32;Hauts-de-France;80;4;20;015;Aizecourt-le-Haut;66;3;69
32;Hauts-de-France;80;4;05;016;Albert;9810;163;9973
32;Hauts-de-France;80;4;20;017;Allaines;454;6;460
32;Hauts-de-France;80;1;16;018;Allenay;249;5;254
32;Hauts-de-France;80;1;17;019;Allery;793;14;807
32;Hauts-de-France;80;2;07;020;Allonville;750;18;768
32;Hauts-de-France;80;2;99;021;Amiens;133891;2654;136545
32;Hauts-de-France;80;2;21;022;Andainville;260;3;263
32;Hauts-de-France;80;3;22;023;Andechy;274;4;278
32;Hauts-de-France;80;1;23;025;Argoules;325;3;328
32;Hauts-de-France;80;2;21;026;Arguel;29;0;29
32;Hauts-de-France;80;2;04;024;Argœuves;543;6;549
32;Hauts-de-France;80;3;22;027;Armancourt;32;0;32
32;Hauts-de-France;80;4;05;028;Arquèves;161;1;162
32;Hauts-de-France;80;1;02;029;Arrest;855;26;881
32;Hauts-de-France;80;1;23;030;Arry;215;8;223
32;Hauts-de-France;80;3;19;031;Arvillers;770;9;779
32;Hauts-de-France;80;3;22;032;Assainvillers;106;0;106
32;Hauts-de-France;80;4;18;033;Assevillers;300;3;303
32;Hauts-de-France;80;4;18;034;Athies;591;6;597
32;Hauts-de-France;80;3;19;035;Aubercourt;80;1;81
32;Hauts-de-France;80;2;08;036;Aubigny;534;4;538
32;Hauts-de-France;80;3;03;037;Aubvillers;148;1;149
32;Hauts-de-France;80;4;05;038;Auchonvillers;144;3;147
32;Hauts-de-France;80;1;16;039;Ault;1431;17;1448
32;Hauts-de-France;80;2;21;040;Aumâtre;179;4;183
32;Hauts-de-France;80;2;21;041;Aumont;146;4;150
32;Hauts-de-France;80;2;14;042;Autheux;121;2;123
32;Hauts-de-France;80;4;05;043;Authie;275;11;286
32;Hauts-de-France;80;2;14;044;Authieule;409;6;415
32;Hauts-de-France;80;4;05;045;Authuille;162;2;164
32;Hauts-de-France;80;2;04;046;Avelesges;56;0;56
32;Hauts-de-France;80;4;05;047;Aveluy;522;5;527
32;Hauts-de-France;80;2;21;048;Avesnes-Chaussoy;63;3;66
32;Hauts-de-France;80;3;22;049;Ayencourt;179;14;193
32;Hauts-de-France;80;2;03;050;Bacouel-sur-Selle;493;10;503
32;Hauts-de-France;80;1;17;051;Bailleul;259;3;262
32;Hauts-de-France;80;2;13;052;Baizieux;206;5;211
32;Hauts-de-France;80;3;22;053;Balâtre;70;1;71
32;Hauts-de-France;80;4;20;054;Barleux;233;5;238
32;Hauts-de-France;80;2;14;055;Barly;173;1;174
32;Hauts-de-France;80;2;13;056;Bavelincourt;99;1;100
32;Hauts-de-France;80;4;05;057;Bayencourt;78;3;81
32;Hauts-de-France;80;4;19;058;Bayonvillers;337;4;341
32;Hauts-de-France;80;4;05;059;Bazentin;78;1;79
32;Hauts-de-France;80;2;14;060;Béalcourt;104;0;104
32;Hauts-de-France;80;2;21;061;Beaucamps-le-Jeune;192;3;195
32;Hauts-de-France;80;2;21;062;Beaucamps-le-Vieux;1424;17;1441
32;Hauts-de-France;80;1;17;063;Beauchamps;991;22;1013
32;Hauts-de-France;80;3;19;064;Beaucourt-en-Santerre;171;3;174
32;Hauts-de-France;80;4;05;065;Beaucourt-sur-l'Ancre;92;3;95
32;Hauts-de-France;80;2;13;066;Beaucourt-sur-l'Hallue;289;6;295
32;Hauts-de-France;80;4;19;067;Beaufort-en-Santerre;197;2;199
32;Hauts-de-France;80;2;14;068;Beaumetz;224;1;225
32;Hauts-de-France;80;4;05;069;Beaumont-Hamel;211;0;211
32;Hauts-de-France;80;2;14;070;Beauquesne;1318;52;1370
32;Hauts-de-France;80;2;14;071;Beauval;2066;23;2089
32;Hauts-de-France;80;4;05;073;Bécordel-Bécourt;158;2;160
32;Hauts-de-France;80;3;22;074;Becquigny;130;1;131
32;Hauts-de-France;80;1;02;076;Béhen;515;4;519
32;Hauts-de-France;80;2;13;077;Béhencourt;324;3;327
32;Hauts-de-France;80;1;01;078;Bellancourt;512;9;521
32;Hauts-de-France;80;2;03;079;Belleuse;341;4;345
32;Hauts-de-France;80;4;18;080;Belloy-en-Santerre;149;5;154
32;Hauts-de-France;80;2;21;081;Belloy-Saint-Léonard;91;2;93
32;Hauts-de-France;80;2;04;082;Belloy-sur-Somme;746;8;754
32;Hauts-de-France;80;2;21;083;Bergicourt;143;4;147
32;Hauts-de-France;80;2;21;084;Bermesnil;218;1;219
32;Hauts-de-France;80;2;14;085;Bernâtre;35;2;37
32;Hauts-de-France;80;2;14;086;Bernaville;1062;17;1079
32;Hauts-de-France;80;1;23;087;Bernay-en-Ponthieu;232;6;238
32;Hauts-de-France;80;4;20;088;Bernes;352;2;354
32;Hauts-de-France;80;2;14;089;Berneuil;265;1;266
32;Hauts-de-France;80;4;18;090;Berny-en-Santerre;153;3;156
32;Hauts-de-France;80;2;07;092;Bertangles;656;6;662
32;Hauts-de-France;80;2;15;093;Berteaucourt-les-Dames;1133;13;1146
32;Hauts-de-France;80;3;19;094;Berteaucourt-lès-Thennes;435;11;446
32;Hauts-de-France;80;4;05;095;Bertrancourt;218;3;221
32;Hauts-de-France;80;1;16;096;Béthencourt-sur-Mer;958;9;967
32;Hauts-de-France;80;4;18;097;Béthencourt-sur-Somme;129;3;132
32;Hauts-de-France;80;2;21;098;Bettembos;105;3;108
32;Hauts-de-France;80;1;17;099;Bettencourt-Rivière;224;4;228
32;Hauts-de-France;80;2;15;100;Bettencourt-Saint-Ouen;619;4;623
32;Hauts-de-France;80;3;22;101;Beuvraignes;859;5;864
32;Hauts-de-France;80;4;20;102;Biaches;384;7;391
32;Hauts-de-France;80;3;22;103;Biarre;66;0;66
32;Hauts-de-France;80;1;17;104;Biencourt;134;2;136
32;Hauts-de-France;80;4;18;105;Billancourt;171;2;173
32;Hauts-de-France;80;2;21;106;Blangy-sous-Poix;178;3;181
32;Hauts-de-France;80;2;09;107;Blangy-Tronville;573;10;583
32;Hauts-de-France;80;2;14;108;Boisbergues;75;1;76
32;Hauts-de-France;80;1;23;109;Le Boisle;354;3;357
32;Hauts-de-France;80;1;02;110;Boismont;471;16;487
32;Hauts-de-France;80;2;13;112;Bonnay;238;1;239
32;Hauts-de-France;80;2;14;113;Bonneville;333;7;340
32;Hauts-de-France;80;2;03;114;Bosquel;335;6;341
32;Hauts-de-France;80;4;20;115;Bouchavesnes-Bergen;287;4;291
32;Hauts-de-France;80;4;19;116;Bouchoir;280;3;283
32;Hauts-de-France;80;2;15;117;Bouchon;156;5;161
32;Hauts-de-France;80;1;23;118;Boufflers;119;1;120
32;Hauts-de-France;80;2;04;119;Bougainville;435;9;444
32;Hauts-de-France;80;1;17;120;Bouillancourt-en-Séry;544;11;555
32;Hauts-de-France;80;3;22;121;Bouillancourt-la-Bataille;156;0;156
32;Hauts-de-France;80;2;14;122;Bouquemaison;495;15;510
32;Hauts-de-France;80;2;04;123;Bourdon;374;8;382
32;Hauts-de-France;80;1;16;124;Bourseville;701;14;715
32;Hauts-de-France;80;3;22;125;Boussicourt;87;0;87
32;Hauts-de-France;80;1;17;126;Bouttencourt;932;17;949
32;Hauts-de-France;80;1;17;127;Bouvaincourt-sur-Bresle;850;11;861
32;Hauts-de-France;80;4;20;128;Bouvincourt-en-Vermandois;148;3;151
32;Hauts-de-France;80;4;05;129;Bouzincourt;546;13;559
32;Hauts-de-France;80;2;04;130;Bovelles;431;6;437
32;Hauts-de-France;80;2;10;131;Boves;3228;62;3290
32;Hauts-de-France;80;3;19;132;Braches;247;3;250
32;Hauts-de-France;80;1;23;133;Brailly-Cornehotte;239;1;240
32;Hauts-de-France;80;2;03;134;Brassy;76;2;78
32;Hauts-de-France;80;1;02;135;Bray-lès-Mareuil;242;4;246
32;Hauts-de-France;80;4;05;136;Bray-sur-Somme;1274;7;1281
32;Hauts-de-France;80;2;04;137;Breilly;715;4;719
32;Hauts-de-France;80;2;13;138;Bresle;126;1;127
32;Hauts-de-France;80;4;18;139;Breuil;44;0;44
32;Hauts-de-France;80;2;14;140;Brévillers;108;3;111
32;Hauts-de-France;80;4;20;141;Brie;331;1;332
32;Hauts-de-France;80;2;04;142;Briquemesnil-Floxicourt;293;4;297
32;Hauts-de-France;80;2;21;143;Brocourt;99;1;100
32;Hauts-de-France;80;4;18;144;Brouchy;504;9;513
32;Hauts-de-France;80;1;23;145;Brucamps;140;0;140
32;Hauts-de-France;80;1;16;146;Brutelles;206;5;211
32;Hauts-de-France;80;1;23;147;Buigny-l'Abbé;318;7;325
32;Hauts-de-France;80;1;17;148;Buigny-lès-Gamaches;407;5;412
32;Hauts-de-France;80;1;01;149;Buigny-Saint-Maclou;520;11;531
32;Hauts-de-France;80;4;20;150;Buire-Courcelles;227;7;234
32;Hauts-de-France;80;4;05;151;Buire-sur-l'Ancre;308;4;312
32;Hauts-de-France;80;3;22;152;Bus-la-Mésière;158;1;159
32;Hauts-de-France;80;4;05;153;Bus-lès-Artois;133;0;133
32;Hauts-de-France;80;4;20;154;Bussu;213;7;220
32;Hauts-de-France;80;1;23;155;Bussus-Bussuel;297;8;305
32;Hauts-de-France;80;2;08;156;Bussy-lès-Daours;391;3;394
32;Hauts-de-France;80;2;21;157;Bussy-lès-Poix;99;5;104
32;Hauts-de-France;80;4;18;158;Buverchy;50;0;50
32;Hauts-de-France;80;2;09;159;Cachy;281;6;287
32;Hauts-de-France;80;2;10;160;Cagny;1205;21;1226
32;Hauts-de-France;80;1;02;161;Cahon;202;7;209
32;Hauts-de-France;80;4;19;162;Caix;719;11;730
32;Hauts-de-France;80;1;02;163;Cambron;723;11;734
32;Hauts-de-France;80;2;08;164;Camon;4424;54;4478
32;Hauts-de-France;80;2;04;165;Camps-en-Amiénois;189;1;190
32;Hauts-de-France;80;2;15;166;Canaples;704;7;711
32;Hauts-de-France;80;1;01;167;Canchy;326;11;337
32;Hauts-de-France;80;2;14;168;Candas;1104;9;1113
32;Hauts-de-France;80;2;21;169;Cannessières;68;0;68
32;Hauts-de-France;80;3;22;170;Cantigny;112;1;113
32;Hauts-de-France;80;1;01;171;Caours;600;19;619
32;Hauts-de-France;80;4;05;172;Cappy;544;7;551
32;Hauts-de-France;80;2;07;173;Cardonnette;522;7;529
32;Hauts-de-France;80;3;22;174;Le Cardonnois;81;3;84
32;Hauts-de-France;80;4;05;505;Carnoy-Mametz ;287;4;291
32;Hauts-de-France;80;3;22;176;Carrépuis;270;4;274
32;Hauts-de-France;80;4;20;177;Cartigny;730;23;753
32;Hauts-de-France;80;2;21;179;Caulières;212;4;216
32;Hauts-de-France;80;2;04;180;Cavillon;104;1;105
32;Hauts-de-France;80;3;19;181;Cayeux-en-Santerre;122;0;122
32;Hauts-de-France;80;1;16;182;Cayeux-sur-Mer;2462;32;2494
32;Hauts-de-France;80;2;13;184;Cerisy;532;5;537
32;Hauts-de-France;80;2;21;183;Cerisy-Buleux;265;5;270
32;Hauts-de-France;80;3;22;185;Champien;283;10;293
32;Hauts-de-France;80;4;18;186;Chaulnes;2054;23;2077
32;Hauts-de-France;80;2;04;187;La Chaussée-Tirancourt;652;11;663
32;Hauts-de-France;80;3;03;188;Chaussoy-Epagny;585;7;592
32;Hauts-de-France;80;4;19;189;La Chavatte;73;1;74
32;Hauts-de-France;80;1;17;190;Chépy;1237;17;1254
32;Hauts-de-France;80;4;19;191;Chilly;178;5;183
32;Hauts-de-France;80;2;13;192;Chipilly;169;2;171
32;Hauts-de-France;80;3;03;193;Chirmont;126;3;129
32;Hauts-de-France;80;4;18;194;Chuignes;136;1;137
32;Hauts-de-France;80;4;05;195;Chuignolles;153;1;154
32;Hauts-de-France;80;1;17;196;Citerne;238;8;246
32;Hauts-de-France;80;4;18;197;Cizancourt;32;0;32
32;Hauts-de-France;80;2;04;198;Clairy-Saulchoix;374;4;378
32;Hauts-de-France;80;4;20;199;Cléry-sur-Somme;534;11;545
32;Hauts-de-France;80;1;23;200;Cocquerel;227;2;229
32;Hauts-de-France;80;4;05;201;Coigneux;49;2;51
32;Hauts-de-France;80;2;07;202;Coisy;348;3;351
32;Hauts-de-France;80;4;05;203;Colincamps;89;2;91
32;Hauts-de-France;80;4;20;204;Combles;756;12;768
32;Hauts-de-France;80;1;15;205;Condé-Folie;917;10;927
32;Hauts-de-France;80;4;05;206;Contalmaison;117;0;117
32;Hauts-de-France;80;2;13;207;Contay;364;2;366
32;Hauts-de-France;80;2;14;208;Conteville;216;4;220
32;Hauts-de-France;80;2;03;210;Contre;147;7;154
32;Hauts-de-France;80;2;03;211;Conty;1773;48;1821
32;Hauts-de-France;80;2;13;212;Corbie;6307;79;6386
32;Hauts-de-France;80;3;03;213;Cottenchy;573;170;743
32;Hauts-de-France;80;3;03;214;Coullemelle;326;1;327
32;Hauts-de-France;80;1;23;215;Coulonvillers;225;8;233
32;Hauts-de-France;80;4;05;216;Courcelette;154;1;155
32;Hauts-de-France;80;4;05;217;Courcelles-au-Bois;79;0;79
32;Hauts-de-France;80;2;21;218;Courcelles-sous-Moyencourt;144;3;147
32;Hauts-de-France;80;2;03;219;Courcelles-sous-Thoix;69;1;70
32;Hauts-de-France;80;3;22;220;Courtemanche;103;2;105
32;Hauts-de-France;80;1;23;221;Cramont;303;5;308
32;Hauts-de-France;80;1;23;222;Crécy-en-Ponthieu;1403;29;1432
32;Hauts-de-France;80;3;22;223;Crémery;129;0;129
32;Hauts-de-France;80;3;22;224;Cressy-Omencourt;123;1;124
32;Hauts-de-France;80;2;04;225;Creuse;191;4;195
32;Hauts-de-France;80;4;18;226;Croix-Moligneaux;275;5;280
32;Hauts-de-France;80;2;21;227;Croixrault;441;9;450
32;Hauts-de-France;80;1;23;228;Le Crotoy;2002;33;2035
32;Hauts-de-France;80;2;04;229;Crouy-Saint-Pierre;343;2;345
32;Hauts-de-France;80;4;18;230;Curchy;301;8;309
32;Hauts-de-France;80;4;05;231;Curlu;170;2;172
32;Hauts-de-France;80;3;22;232;Damery;230;5;235
32;Hauts-de-France;80;3;22;233;Dancourt-Popincourt;155;1;156
32;Hauts-de-France;80;2;08;234;Daours;780;16;796
32;Hauts-de-France;80;1;17;235;Dargnies;1221;19;1240
32;Hauts-de-France;80;3;22;236;Davenescourt;568;4;572
32;Hauts-de-France;80;3;19;237;Démuin;508;11;519
32;Hauts-de-France;80;4;05;238;Dernancourt;558;9;567
32;Hauts-de-France;80;4;20;239;Devise;52;2;54
32;Hauts-de-France;80;4;20;240;Doingt;1415;45;1460
32;Hauts-de-France;80;2;15;241;Domart-en-Ponthieu;1074;11;1085
32;Hauts-de-France;80;3;19;242;Domart-sur-la-Luce;410;9;419
32;Hauts-de-France;80;2;14;243;Domesmont;42;0;42
32;Hauts-de-France;80;1;23;244;Dominois;176;3;179
32;Hauts-de-France;80;2;14;245;Domléger-Longvillers;302;3;305
32;Hauts-de-France;80;3;03;246;Dommartin;349;5;354
32;Hauts-de-France;80;4;18;247;Dompierre-Becquincourt;708;8;716
32;Hauts-de-France;80;1;23;248;Dompierre-sur-Authie;410;6;416
32;Hauts-de-France;80;1;23;249;Domqueur;312;7;319
32;Hauts-de-France;80;1;01;250;Domvast;350;4;354
32;Hauts-de-France;80;1;17;251;Doudelainville;345;8;353
32;Hauts-de-France;80;4;18;252;Douilly;245;1;246
32;Hauts-de-France;80;2;14;253;Doullens;5998;240;6238
32;Hauts-de-France;80;2;04;256;Dreuil-lès-Amiens;1648;11;1659
32;Hauts-de-France;80;4;20;258;Driencourt;91;3;94
32;Hauts-de-France;80;2;21;259;Dromesnil;88;1;89
32;Hauts-de-France;80;1;01;260;Drucat;926;24;950
32;Hauts-de-France;80;2;11;261;Dury;1459;61;1520
32;Hauts-de-France;80;1;02;262;Eaucourt-sur-Somme;408;14;422
32;Hauts-de-France;80;3;22;263;L' Échelle-Saint-Aurin;51;1;52
32;Hauts-de-France;80;4;05;264;Éclusier-Vaux;83;39;122
32;Hauts-de-France;80;1;17;265;Embreville;574;7;581
32;Hauts-de-France;80;4;05;266;Englebelmer;305;0;305
32;Hauts-de-France;80;4;18;267;Ennemain;273;2;275
32;Hauts-de-France;80;1;02;268;Épagne-Épagnette;537;14;551
32;Hauts-de-France;80;2;21;269;Épaumesnil;126;2;128
32;Hauts-de-France;80;2;14;270;Épécamps;5;0;5
32;Hauts-de-France;80;4;20;271;Épehy;1137;14;1151
32;Hauts-de-France;80;4;18;272;Épénancourt;124;2;126
32;Hauts-de-France;80;2;21;273;Éplessier;353;5;358
32;Hauts-de-France;80;4;18;274;Eppeville;1810;18;1828
32;Hauts-de-France;80;4;20;275;Équancourt;299;2;301
32;Hauts-de-France;80;2;21;276;Équennes-Éramecourt;291;7;298
32;Hauts-de-France;80;3;22;278;Erches;187;3;190
32;Hauts-de-France;80;3;22;279;Ercheu;777;12;789
32;Hauts-de-France;80;1;02;280;Ercourt;122;2;124
32;Hauts-de-France;80;1;23;281;Ergnies;179;1;180
32;Hauts-de-France;80;1;17;282;Érondelle;509;5;514
32;Hauts-de-France;80;3;03;283;Esclainvillers;167;0;167
32;Hauts-de-France;80;4;18;284;Esmery-Hallon;757;36;793
32;Hauts-de-France;80;2;03;285;Essertaux;261;3;264
32;Hauts-de-France;80;1;02;287;Estrébœuf;240;4;244
32;Hauts-de-France;80;4;18;288;Estrées-Deniécourt;326;10;336
32;Hauts-de-France;80;1;23;290;Estrées-lès-Crécy;391;5;396
32;Hauts-de-France;80;4;20;557;Estrées-Mons;600;11;611
32;Hauts-de-France;80;2;03;291;Estrées-sur-Noye;271;3;274
32;Hauts-de-France;80;3;22;292;Étalon;135;1;136
32;Hauts-de-France;80;3;22;293;Ételfay;370;3;373
32;Hauts-de-France;80;4;20;294;Éterpigny;163;3;166
32;Hauts-de-France;80;4;05;295;Étinehem-Méricourt ;596;7;603
32;Hauts-de-France;80;2;15;296;L' Étoile;1190;8;1198
32;Hauts-de-France;80;2;21;297;Étréjust;42;1;43
32;Hauts-de-France;80;4;20;298;Étricourt-Manancourt;532;3;535
32;Hauts-de-France;80;3;03;299;La Faloise;233;1;234
32;Hauts-de-France;80;4;18;300;Falvy;153;1;154
32;Hauts-de-France;80;2;21;301;Famechon;272;2;274
32;Hauts-de-France;80;3;22;302;Faverolles;165;3;168
32;Hauts-de-France;80;1;23;303;Favières;462;7;469
32;Hauts-de-France;80;4;18;304;Fay;101;2;103
32;Hauts-de-France;80;2;04;305;Ferrières;475;12;487
32;Hauts-de-France;80;3;22;306;Fescamps;135;5;140
32;Hauts-de-France;80;4;20;307;Feuillères;150;2;152
32;Hauts-de-France;80;1;17;308;Feuquières-en-Vimeu;2533;43;2576
32;Hauts-de-France;80;2;14;566;Fieffes-Montrelet;334;8;342
32;Hauts-de-France;80;2;14;310;Fienvillers;686;12;698
32;Hauts-de-France;80;3;22;311;Fignières;154;2;156
32;Hauts-de-France;80;4;20;312;Fins;277;1;278
32;Hauts-de-France;80;4;20;313;Flaucourt;290;5;295
32;Hauts-de-France;80;4;20;314;Flers;197;3;200
32;Hauts-de-France;80;3;03;315;Flers-sur-Noye;507;10;517
32;Hauts-de-France;80;2;15;316;Flesselles;2042;24;2066
32;Hauts-de-France;80;2;03;317;Fleury;217;3;220
32;Hauts-de-France;80;2;15;318;Flixecourt;3205;74;3279
32;Hauts-de-France;80;2;04;319;Fluy;337;0;337
32;Hauts-de-France;80;4;19;320;Folies;149;1;150
32;Hauts-de-France;80;3;03;321;Folleville;144;2;146
32;Hauts-de-France;80;3;22;322;Fonches-Fonchette;167;0;167
32;Hauts-de-France;80;2;21;324;Fontaine-le-Sec;149;5;154
32;Hauts-de-France;80;4;18;325;Fontaine-lès-Cappy;51;1;52
32;Hauts-de-France;80;3;22;326;Fontaine-sous-Montdidier;108;2;110
32;Hauts-de-France;80;1;23;327;Fontaine-sur-Maye;159;5;164
32;Hauts-de-France;80;1;17;328;Fontaine-sur-Somme;521;5;526
32;Hauts-de-France;80;4;05;329;Forceville;175;1;176
32;Hauts-de-France;80;2;21;330;Forceville-en-Vimeu;237;6;243
32;Hauts-de-France;80;1;01;331;Forest-l'Abbaye;306;12;318
32;Hauts-de-France;80;1;01;332;Forest-Montiers;398;9;407
32;Hauts-de-France;80;1;23;333;Fort-Mahon-Plage;1300;13;1313
32;Hauts-de-France;80;2;03;334;Fossemanant;95;3;98
32;Hauts-de-France;80;4;18;335;Foucaucourt-en-Santerre;256;3;259
32;Hauts-de-France;80;2;21;336;Foucaucourt-Hors-Nesle;80;1;81
32;Hauts-de-France;80;3;03;337;Fouencamps;206;3;209
32;Hauts-de-France;80;2;13;338;Fouilloy;1828;17;1845
32;Hauts-de-France;80;4;19;339;Fouquescourt;156;4;160
32;Hauts-de-France;80;2;21;340;Fourcigny;198;2;200
32;Hauts-de-France;80;2;04;341;Fourdrinoy;409;9;418
32;Hauts-de-France;80;4;18;342;Framerville-Rainecourt;462;3;465
32;Hauts-de-France;80;2;21;343;Framicourt;175;2;177
32;Hauts-de-France;80;1;23;344;Francières;188;8;196
32;Hauts-de-France;80;1;02;345;Franleu;541;5;546
32;Hauts-de-France;80;2;15;346;Franqueville;172;1;173
32;Hauts-de-France;80;4;19;347;Fransart;153;2;155
32;Hauts-de-France;80;2;15;348;Fransu;178;4;182
32;Hauts-de-France;80;3;03;349;Fransures;131;1;132
32;Hauts-de-France;80;2;13;350;Franvillers;507;7;514
32;Hauts-de-France;80;2;13;351;Fréchencourt;259;2;261
32;Hauts-de-France;80;2;03;352;Frémontiers;156;1;157
32;Hauts-de-France;80;4;18;353;Fresnes-Mazancourt;145;1;146
32;Hauts-de-France;80;2;21;354;Fresnes-Tilloloy;204;3;207
32;Hauts-de-France;80;2;21;355;Fresneville;104;2;106
32;Hauts-de-France;80;2;21;356;Fresnoy-Andainville;88;9;97
32;Hauts-de-France;80;2;04;357;Fresnoy-au-Val;239;6;245
32;Hauts-de-France;80;3;19;358;Fresnoy-en-Chaussée;142;2;144
32;Hauts-de-France;80;3;22;359;Fresnoy-lès-Roye;290;9;299
32;Hauts-de-France;80;1;16;360;Fressenneville;2191;43;2234
32;Hauts-de-France;80;2;21;361;Frettecuisse;75;0;75
32;Hauts-de-France;80;1;17;362;Frettemeule;316;7;323
32;Hauts-de-France;80;1;16;364;Friaucourt;712;11;723
32;Hauts-de-France;80;2;21;365;Fricamps;177;0;177
32;Hauts-de-France;80;4;05;366;Fricourt;490;4;494
32;Hauts-de-France;80;4;05;367;Frise;181;5;186
32;Hauts-de-France;80;1;16;368;Friville-Escarbotin;4501;98;4599
32;Hauts-de-France;80;2;14;369;Frohen-sur-Authie;235;5;240
32;Hauts-de-France;80;1;23;371;Froyelles;100;4;104
32;Hauts-de-France;80;1;17;372;Frucourt;128;4;132
32;Hauts-de-France;80;1;17;373;Gamaches;2501;84;2585
32;Hauts-de-France;80;1;01;374;Gapennes;281;3;284
32;Hauts-de-France;80;2;21;375;Gauville;344;7;351
32;Hauts-de-France;80;2;09;376;Gentelles;646;4;650
32;Hauts-de-France;80;2;14;377;Gézaincourt;418;5;423
32;Hauts-de-France;80;4;20;378;Ginchy;63;1;64
32;Hauts-de-France;80;2;09;379;Glisy;799;1;800
32;Hauts-de-France;80;1;23;380;Gorenflos;249;5;254
32;Hauts-de-France;80;2;14;381;Gorges;39;1;40
32;Hauts-de-France;80;3;22;383;Goyencourt;93;0;93
32;Hauts-de-France;80;1;01;385;Grand-Laviers;446;28;474
32;Hauts-de-France;80;4;05;384;Grandcourt;176;1;177
32;Hauts-de-France;80;3;22;386;Gratibus;180;3;183
32;Hauts-de-France;80;2;03;387;Grattepanche;321;1;322
32;Hauts-de-France;80;1;02;388;Grébault-Mesnil;216;2;218
32;Hauts-de-France;80;3;03;390;Grivesnes;409;6;415
32;Hauts-de-France;80;3;22;391;Grivillers;87;0;87
32;Hauts-de-France;80;2;14;392;Grouches-Luchuel;577;13;590
32;Hauts-de-France;80;3;22;393;Gruny;314;6;320
32;Hauts-de-France;80;3;22;395;Guerbigny;285;5;290
32;Hauts-de-France;80;1;23;396;Gueschart;353;4;357
32;Hauts-de-France;80;4;20;397;Gueudecourt;94;4;98
32;Hauts-de-France;80;2;04;399;Guignemicourt;390;4;394
32;Hauts-de-France;80;4;19;400;Guillaucourt;427;5;432
32;Hauts-de-France;80;4;20;401;Guillemont;134;1;135
32;Hauts-de-France;80;2;21;402;Guizancourt;135;1;136
32;Hauts-de-France;80;4;20;404;Guyencourt-Saulcourt;140;3;143
32;Hauts-de-France;80;3;03;403;Guyencourt-sur-Noye;183;3;186
32;Hauts-de-France;80;3;19;405;Hailles;427;2;429
32;Hauts-de-France;80;1;17;406;Hallencourt;1306;17;1323
32;Hauts-de-France;80;3;03;407;Hallivillers;145;6;151
32;Hauts-de-France;80;2;15;408;Halloy-lès-Pernois;339;1;340
32;Hauts-de-France;80;4;19;409;Hallu;165;5;170
32;Hauts-de-France;80;4;18;410;Ham;4596;98;4694
32;Hauts-de-France;80;2;13;411;Le Hamel;498;6;504
32;Hauts-de-France;80;2;13;412;Hamelet;634;6;640
32;Hauts-de-France;80;4;20;413;Hancourt;90;1;91
32;Hauts-de-France;80;3;19;414;Hangard;124;2;126
32;Hauts-de-France;80;3;19;415;Hangest-en-Santerre;1014;8;1022
32;Hauts-de-France;80;2;04;416;Hangest-sur-Somme;773;9;782
32;Hauts-de-France;80;4;19;417;Harbonnières;1638;11;1649
32;Hauts-de-France;80;4;20;418;Hardecourt-aux-Bois;84;0;84
32;Hauts-de-France;80;4;05;420;Harponville;174;1;175
32;Hauts-de-France;80;3;22;421;Hattencourt;292;4;296
32;Hauts-de-France;80;1;01;422;Hautvillers-Ouville;579;10;589
32;Hauts-de-France;80;2;15;423;Havernas;387;5;392
32;Hauts-de-France;80;2;11;424;Hébécourt;535;18;553
32;Hauts-de-France;80;4;05;425;Hédauville;121;1;122
32;Hauts-de-France;80;2;13;426;Heilly;429;8;437
32;Hauts-de-France;80;2;14;427;Hem-Hardinval;369;9;378
32;Hauts-de-France;80;4;20;428;Hem-Monacu;131;2;133
32;Hauts-de-France;80;2;13;429;Hénencourt;194;1;195
32;Hauts-de-France;80;4;20;430;Herbécourt;211;8;219
32;Hauts-de-France;80;4;05;431;Hérissart;648;10;658
32;Hauts-de-France;80;4;18;432;Herleville;184;1;185
32;Hauts-de-France;80;3;22;433;Herly;44;0;44
32;Hauts-de-France;80;4;20;434;Hervilly;189;4;193
32;Hauts-de-France;80;4;20;435;Hesbécourt;57;0;57
32;Hauts-de-France;80;2;21;436;Hescamps;518;13;531
32;Hauts-de-France;80;2;21;437;Heucourt-Croquoison;112;4;116
32;Hauts-de-France;80;4;20;438;Heudicourt;514;6;520
32;Hauts-de-France;80;2;14;439;Heuzecourt;167;1;168
32;Hauts-de-France;80;2;14;440;Hiermont;151;3;154
32;Hauts-de-France;80;4;18;442;Hombleux ;1177;10;1187
32;Hauts-de-France;80;2;21;443;Hornoy-le-Bourg;1679;29;1708
32;Hauts-de-France;80;1;02;444;Huchenneville;663;13;676
32;Hauts-de-France;80;2;14;445;Humbercourt;269;2;271
32;Hauts-de-France;80;1;17;446;Huppy;764;20;784
32;Hauts-de-France;80;4;18;621;Hypercourt;732;11;743
32;Hauts-de-France;80;3;19;449;Ignaucourt;72;2;74
32;Hauts-de-France;80;2;21;450;Inval-Boiron;113;1;114
32;Hauts-de-France;80;4;05;451;Irles;120;0;120
32;Hauts-de-France;80;3;03;452;Jumel;519;3;522
32;Hauts-de-France;80;3;22;453;Laboissière-en-Santerre;144;0;144
32;Hauts-de-France;80;2;21;455;Lachapelle;88;2;90
32;Hauts-de-France;80;2;21;456;Lafresguimont-Saint-Martin;549;6;555
32;Hauts-de-France;80;2;13;458;Lahoussoye;461;11;472
32;Hauts-de-France;80;2;04;459;Laleu;112;0;112
32;Hauts-de-France;80;2;21;460;Lamaronde;67;1;68
32;Hauts-de-France;80;2;08;461;Lamotte-Brebière;218;4;222
32;Hauts-de-France;80;1;01;462;Lamotte-Buleux;353;11;364
32;Hauts-de-France;80;2;13;463;Lamotte-Warfusée;702;10;712
32;Hauts-de-France;80;1;16;464;Lanchères;922;14;936
32;Hauts-de-France;80;2;15;466;Lanches-Saint-Hilaire;133;1;134
32;Hauts-de-France;80;4;18;465;Languevoisin-Quiquery;200;5;205
32;Hauts-de-France;80;3;22;467;Laucourt;199;1;200
32;Hauts-de-France;80;4;05;468;Laviéville;171;3;174
32;Hauts-de-France;80;3;03;469;Lawarde-Mauger-l'Hortoy;167;1;168
32;Hauts-de-France;80;4;05;470;Léalvillers;166;2;168
32;Hauts-de-France;80;4;20;472;Lesbœufs;177;7;184
32;Hauts-de-France;80;3;22;473;Liancourt-Fosse;298;2;300
32;Hauts-de-France;80;4;18;474;Licourt;399;3;402
32;Hauts-de-France;80;4;20;475;Liéramont;221;7;228
32;Hauts-de-France;80;1;17;476;Liercourt;369;4;373
32;Hauts-de-France;80;1;23;477;Ligescourt;220;4;224
32;Hauts-de-France;80;3;22;478;Lignières;141;2;143
32;Hauts-de-France;80;2;21;479;Lignières-Châtelain;364;6;370
32;Hauts-de-France;80;2;21;480;Lignières-en-Vimeu;112;2;114
32;Hauts-de-France;80;4;18;481;Lihons;448;5;453
32;Hauts-de-France;80;1;17;482;Limeux;141;2;143
32;Hauts-de-France;80;2;21;484;Liomer;393;6;399
32;Hauts-de-France;80;1;23;486;Long;619;8;627
32;Hauts-de-France;80;4;20;487;Longavesnes;82;2;84
32;Hauts-de-France;80;1;17;488;Longpré-les-Corps-Saints;1623;29;1652
32;Hauts-de-France;80;2;09;489;Longueau;5693;45;5738
32;Hauts-de-France;80;4;20;490;Longueval;270;9;279
32;Hauts-de-France;80;2;14;491;Longuevillette;76;1;77
32;Hauts-de-France;80;4;05;493;Louvencourt;285;5;290
32;Hauts-de-France;80;3;03;494;Louvrechy;200;3;203
32;Hauts-de-France;80;2;14;495;Lucheux;528;4;532
32;Hauts-de-France;80;1;23;496;Machiel;156;1;157
32;Hauts-de-France;80;1;23;497;Machy;122;5;127
32;Hauts-de-France;80;4;05;498;Mailly-Maillet;630;5;635
32;Hauts-de-France;80;3;03;499;Mailly-Raineval;299;6;305
32;Hauts-de-France;80;1;17;500;Maisnières;524;7;531
32;Hauts-de-France;80;1;23;501;Maison-Ponthieu;282;3;285
32;Hauts-de-France;80;1;23;502;Maison-Roland;103;3;106
32;Hauts-de-France;80;2;14;503;Maizicourt;189;2;191
32;Hauts-de-France;80;3;22;504;Malpart;76;0;76
32;Hauts-de-France;80;2;13;507;Marcelcave;1251;19;1270
32;Hauts-de-France;80;3;22;508;Marché-Allouarde;52;0;52
32;Hauts-de-France;80;4;18;509;Marchélepot-Misery ;599;6;605
32;Hauts-de-France;80;3;22;511;Marestmontiers;113;1;114
32;Hauts-de-France;80;1;02;512;Mareuil-Caubert;831;11;842
32;Hauts-de-France;80;4;05;513;Maricourt;179;3;182
32;Hauts-de-France;80;4;05;514;Marieux;126;1;127
32;Hauts-de-France;80;2;21;515;Marlers;143;2;145
32;Hauts-de-France;80;4;20;516;Marquaix;197;1;198
32;Hauts-de-France;80;3;22;517;Marquivillers;192;3;195
32;Hauts-de-France;80;1;17;518;Martainneville;416;3;419
32;Hauts-de-France;80;4;18;519;Matigny;505;6;511
32;Hauts-de-France;80;4;19;520;Maucourt;180;3;183
32;Hauts-de-France;80;4;20;521;Maurepas;204;0;204
32;Hauts-de-France;80;2;21;522;Le Mazis;107;0;107
32;Hauts-de-France;80;4;05;523;Méaulte;1257;22;1279
32;Hauts-de-France;80;4;19;524;Méharicourt;591;6;597
32;Hauts-de-France;80;2;21;525;Meigneux;177;3;180
32;Hauts-de-France;80;2;14;526;Le Meillard;155;3;158
32;Hauts-de-France;80;1;16;527;Méneslies;307;7;314
32;Hauts-de-France;80;2;21;528;Méréaucourt;8;0;8
32;Hauts-de-France;80;1;17;529;Mérélessart;197;4;201
32;Hauts-de-France;80;2;21;531;Méricourt-en-Vimeu;103;0;103
32;Hauts-de-France;80;2;13;530;Méricourt-l'Abbé;610;4;614
32;Hauts-de-France;80;1;16;533;Mers-les-Bains;2738;57;2795
32;Hauts-de-France;80;2;04;535;Le Mesge;168;6;174
32;Hauts-de-France;80;4;20;536;Mesnil-Bruntel;288;3;291
32;Hauts-de-France;80;1;23;537;Mesnil-Domqueur;89;0;89
32;Hauts-de-France;80;4;20;538;Mesnil-en-Arrouaise;124;0;124
32;Hauts-de-France;80;4;05;540;Mesnil-Martinsart;237;4;241
32;Hauts-de-France;80;3;22;541;Mesnil-Saint-Georges;193;3;196
32;Hauts-de-France;80;4;18;542;Mesnil-Saint-Nicaise;559;6;565
32;Hauts-de-France;80;2;04;543;Métigny;118;3;121
32;Hauts-de-France;80;2;14;544;Mézerolles;186;3;189
32;Hauts-de-France;80;3;19;545;Mézières-en-Santerre;577;7;584
32;Hauts-de-France;80;1;02;546;Miannay;574;12;586
32;Hauts-de-France;80;4;05;547;Millencourt;209;4;213
32;Hauts-de-France;80;1;01;548;Millencourt-en-Ponthieu;357;2;359
32;Hauts-de-France;80;4;05;549;Miraumont;658;12;670
32;Hauts-de-France;80;2;13;550;Mirvaux;137;4;141
32;Hauts-de-France;80;4;20;552;Moislains;1177;23;1200
32;Hauts-de-France;80;2;13;553;Molliens-au-Bois;321;10;331
32;Hauts-de-France;80;2;04;554;Molliens-Dreuil;971;9;980
32;Hauts-de-France;80;4;18;555;Monchy-Lagache;622;20;642
32;Hauts-de-France;80;1;02;556;Mons-Boubert;556;6;562
32;Hauts-de-France;80;2;03;558;Monsures;225;4;229
32;Hauts-de-France;80;2;04;559;Montagne-Fayel;143;3;146
32;Hauts-de-France;80;4;05;560;Montauban-de-Picardie;212;1;213
32;Hauts-de-France;80;3;22;561;Montdidier;6174;110;6284
32;Hauts-de-France;80;2;14;563;Montigny-les-Jongleurs;95;1;96
32;Hauts-de-France;80;2;13;562;Montigny-sur-l'Hallue;207;2;209
32;Hauts-de-France;80;2;07;565;Montonvillers;81;2;83
32;Hauts-de-France;80;4;18;568;Morchain;350;4;354
32;Hauts-de-France;80;2;13;569;Morcourt;325;3;328
32;Hauts-de-France;80;3;19;570;Moreuil;3968;28;3996
32;Hauts-de-France;80;3;19;571;Morisel;507;9;516
32;Hauts-de-France;80;4;05;572;Morlancourt;367;2;369
32;Hauts-de-France;80;2;21;573;Morvillers-Saint-Saturnin;402;5;407
32;Hauts-de-France;80;1;23;574;Mouflers;95;1;96
32;Hauts-de-France;80;2;21;575;Mouflières;83;8;91
32;Hauts-de-France;80;4;18;576;Moyencourt;319;0;319
32;Hauts-de-France;80;2;21;577;Moyencourt-lès-Poix;182;1;183
32;Hauts-de-France;80;1;02;578;Moyenneville;720;11;731
32;Hauts-de-France;80;4;18;579;Muille-Villette;839;12;851
32;Hauts-de-France;80;1;23;580;Nampont;252;3;255
32;Hauts-de-France;80;2;03;582;Namps-Maisnil;995;15;1010
32;Hauts-de-France;80;2;03;583;Nampty;288;8;296
32;Hauts-de-France;80;2;13;584;Naours;1082;10;1092
32;Hauts-de-France;80;4;18;585;Nesle;2321;30;2351
32;Hauts-de-France;80;2;21;586;Nesle-l'Hôpital;158;1;159
32;Hauts-de-France;80;2;21;587;Neslette;82;2;84
32;Hauts-de-France;80;1;01;588;Neufmoulin;359;7;366
32;Hauts-de-France;80;1;01;590;Neuilly-l'Hôpital;324;12;336
32;Hauts-de-France;80;1;23;589;Neuilly-le-Dien;98;0;98
32;Hauts-de-France;80;2;21;591;Neuville-au-Bois;152;1;153
32;Hauts-de-France;80;2;21;592;Neuville-Coppegueule;514;7;521
32;Hauts-de-France;80;4;05;593;La Neuville-lès-Bray;263;2;265
32;Hauts-de-France;80;3;19;595;La Neuville-Sire-Bernard;295;1;296
32;Hauts-de-France;80;2;14;596;Neuvillette;221;6;227
32;Hauts-de-France;80;1;16;597;Nibas;854;15;869
32;Hauts-de-France;80;1;01;598;Nouvion;1288;37;1325
32;Hauts-de-France;80;1;23;599;Noyelles-en-Chaussée;240;3;243
32;Hauts-de-France;80;1;01;600;Noyelles-sur-Mer;708;11;719
32;Hauts-de-France;80;4;20;601;Nurlu;380;4;384
32;Hauts-de-France;80;2;03;485;Ô-de-Selle ;1191;9;1200
32;Hauts-de-France;80;2;14;602;Occoches;128;3;131
32;Hauts-de-France;80;1;16;603;Ochancourt;325;1;326
32;Hauts-de-France;80;2;21;604;Offignies;77;3;80
32;Hauts-de-France;80;4;18;605;Offoy;212;2;214
32;Hauts-de-France;80;2;21;606;Oisemont;1160;46;1206
32;Hauts-de-France;80;2;04;607;Oissy;217;3;220
32;Hauts-de-France;80;1;23;609;Oneux;398;6;404
32;Hauts-de-France;80;2;03;611;Oresmaux;926;11;937
32;Hauts-de-France;80;1;16;613;Oust-Marest;626;12;638
32;Hauts-de-France;80;2;14;614;Outrebois;314;6;320
32;Hauts-de-France;80;4;05;615;Ovillers-la-Boisselle;442;3;445
32;Hauts-de-France;80;4;18;616;Pargny;202;1;203
32;Hauts-de-France;80;4;19;617;Parvillers-le-Quesnoy;234;3;237
32;Hauts-de-France;80;1;16;618;Pendé;1054;14;1068
32;Hauts-de-France;80;2;15;619;Pernois;735;8;743
32;Hauts-de-France;80;4;20;620;Péronne;7595;207;7802
32;Hauts-de-France;80;2;04;622;Picquigny;1317;16;1333
32;Hauts-de-France;80;3;22;623;Piennes-Onvillers;368;6;374
32;Hauts-de-France;80;2;13;624;Pierregot;282;5;287
32;Hauts-de-France;80;2;04;626;Pissy;287;2;289
32;Hauts-de-France;80;2;03;627;Plachy-Buyon;854;21;875
32;Hauts-de-France;80;3;19;628;Le Plessier-Rozainvillers;764;4;768
32;Hauts-de-France;80;2;21;630;Poix-de-Picardie;2385;40;2425
32;Hauts-de-France;80;1;23;631;Ponches-Estruval;100;3;103
32;Hauts-de-France;80;2;12;632;Pont-de-Metz;2448;38;2486
32;Hauts-de-France;80;2;13;634;Pont-Noyelles;830;17;847
32;Hauts-de-France;80;1;23;635;Pont-Remy;1464;22;1486
32;Hauts-de-France;80;1;01;633;Ponthoile;611;10;621
32;Hauts-de-France;80;1;01;637;Port-le-Grand;289;1;290
32;Hauts-de-France;80;4;18;638;Potte;105;6;111
32;Hauts-de-France;80;2;07;639;Poulainville;1223;23;1246
32;Hauts-de-France;80;4;05;640;Pozières;267;3;270
32;Hauts-de-France;80;2;14;642;Prouville;319;2;321
32;Hauts-de-France;80;2;03;643;Prouzel;553;8;561
32;Hauts-de-France;80;4;18;644;Proyart;703;10;713
32;Hauts-de-France;80;4;05;645;Puchevillers;555;3;558
32;Hauts-de-France;80;4;18;646;Punchy;88;4;92
32;Hauts-de-France;80;4;18;647;Puzeaux;295;3;298
32;Hauts-de-France;80;4;05;648;Pys;121;1;122
32;Hauts-de-France;80;4;20;629;Pœuilly;115;2;117
32;Hauts-de-France;80;1;23;649;Quend;1355;30;1385
32;Hauts-de-France;80;2;07;650;Querrieu;642;18;660
32;Hauts-de-France;80;2;21;651;Le Quesne;267;2;269
32;Hauts-de-France;80;3;19;652;Le Quesnel;786;9;795
32;Hauts-de-France;80;1;02;654;Quesnoy-le-Montant;553;18;571
32;Hauts-de-France;80;2;04;655;Quesnoy-sur-Airaines;434;5;439
32;Hauts-de-France;80;2;04;656;Quevauvillers;1094;10;1104
32;Hauts-de-France;80;3;03;657;Quiry-le-Sec;325;2;327
32;Hauts-de-France;80;4;18;658;Quivières;143;3;146
32;Hauts-de-France;80;4;05;659;Raincheval;276;6;282
32;Hauts-de-France;80;2;07;661;Rainneville;1001;7;1008
32;Hauts-de-France;80;1;17;662;Ramburelles;280;2;282
32;Hauts-de-France;80;2;21;663;Rambures;341;7;348
32;Hauts-de-France;80;4;20;664;Rancourt;189;3;192
32;Hauts-de-France;80;1;23;665;Regnière-Écluse;125;3;128
32;Hauts-de-France;80;2;14;666;Remaisnil;31;0;31
32;Hauts-de-France;80;3;22;667;Remaugies;130;0;130
32;Hauts-de-France;80;2;03;668;Remiencourt;171;3;174
32;Hauts-de-France;80;4;18;669;Rethonvillers;358;6;364
32;Hauts-de-France;80;2;04;670;Revelles;504;8;512
32;Hauts-de-France;80;2;15;671;Ribeaucourt;242;7;249
32;Hauts-de-France;80;2;13;672;Ribemont-sur-Ancre;662;13;675
32;Hauts-de-France;80;2;04;673;Riencourt;176;7;183
32;Hauts-de-France;80;2;08;674;Rivery;3576;34;3610
32;Hauts-de-France;80;3;03;675;Rogy;127;2;129
32;Hauts-de-France;80;3;22;676;Roiglise;155;7;162
32;Hauts-de-France;80;4;20;677;Roisel;1604;19;1623
32;Hauts-de-France;80;3;22;678;Rollot;760;19;779
32;Hauts-de-France;80;4;20;679;Ronssoy;588;5;593
32;Hauts-de-France;80;4;19;680;Rosières-en-Santerre;3001;25;3026
32;Hauts-de-France;80;3;03;681;Rouvrel;307;8;315
32;Hauts-de-France;80;4;19;682;Rouvroy-en-Santerre;213;6;219
32;Hauts-de-France;80;4;18;683;Rouy-le-Grand;105;3;108
32;Hauts-de-France;80;4;18;684;Rouy-le-Petit;111;4;115
32;Hauts-de-France;80;3;22;685;Roye;5709;61;5770
32;Hauts-de-France;80;2;13;686;Rubempré;727;9;736
32;Hauts-de-France;80;3;22;687;Rubescourt;133;2;135
32;Hauts-de-France;80;1;23;688;Rue;3096;91;3187
32;Hauts-de-France;80;2;11;690;Rumigny;622;9;631
32;Hauts-de-France;80;1;02;691;Saigneville;373;14;387
32;Hauts-de-France;80;1;01;692;Sailly-Flibeaucourt;1030;18;1048
32;Hauts-de-France;80;2;13;693;Sailly-Laurette;320;1;321
32;Hauts-de-France;80;2;13;694;Sailly-le-Sec;349;6;355
32;Hauts-de-France;80;4;20;695;Sailly-Saillisel;479;6;485
32;Hauts-de-France;80;2;11;696;Sains-en-Amiénois;1212;32;1244
32;Hauts-de-France;80;2;14;697;Saint-Acheul;29;0;29
32;Hauts-de-France;80;2;04;698;Saint-Aubin-Montenoy;223;4;227
32;Hauts-de-France;80;2;21;699;Saint-Aubin-Rivière;112;0;112
32;Hauts-de-France;80;1;16;700;Saint-Blimont;878;16;894
32;Hauts-de-France;80;4;18;701;Saint-Christ-Briost;434;10;444
32;Hauts-de-France;80;2;11;702;Saint-Fuscien;1240;26;1266
32;Hauts-de-France;80;2;21;703;Saint-Germain-sur-Bresle;205;3;208
32;Hauts-de-France;80;2;07;704;Saint-Gratien;380;5;385
32;Hauts-de-France;80;4;05;705;Saint-Léger-lès-Authie;86;1;87
32;Hauts-de-France;80;2;15;706;Saint-Léger-lès-Domart;1852;16;1868
32;Hauts-de-France;80;2;21;707;Saint-Léger-sur-Bresle;77;4;81
32;Hauts-de-France;80;3;22;708;Saint-Mard;159;3;162
32;Hauts-de-France;80;2;21;709;Saint-Maulvis;266;8;274
32;Hauts-de-France;80;1;17;710;Saint-Maxent;393;5;398
32;Hauts-de-France;80;2;15;711;Saint-Ouen;1867;15;1882
32;Hauts-de-France;80;1;23;713;Saint-Quentin-en-Tourmont;283;5;288
32;Hauts-de-France;80;1;16;714;Saint-Quentin-la-Motte-Croix-au-Bailly;1287;21;1308
32;Hauts-de-France;80;1;23;716;Saint-Riquier;1270;29;1299
32;Hauts-de-France;80;2;03;717;Saint-Sauflieu;985;7;992
32;Hauts-de-France;80;2;04;718;Saint-Sauveur;1356;16;1372
32;Hauts-de-France;80;2;15;722;Saint-Vaast-en-Chaussée;492;7;499
32;Hauts-de-France;80;1;02;721;Saint-Valery-sur-Somme;2491;41;2532
32;Hauts-de-France;80;2;21;719;Sainte-Segrée;54;5;59
32;Hauts-de-France;80;2;04;723;Saisseval;239;1;240
32;Hauts-de-France;80;2;12;724;Saleux;2826;30;2856
32;Hauts-de-France;80;2;12;725;Salouël;3921;53;3974
32;Hauts-de-France;80;4;18;726;Sancourt;267;6;273
32;Hauts-de-France;80;2;21;728;Saulchoy-sous-Poix;73;0;73
32;Hauts-de-France;80;3;03;729;Sauvillers-Mongival;176;0;176
32;Hauts-de-France;80;2;04;730;Saveuse;942;8;950
32;Hauts-de-France;80;2;21;732;Senarpont;638;14;652
32;Hauts-de-France;80;4;05;733;Senlis-le-Sec;300;3;303
32;Hauts-de-France;80;2;03;734;Sentelie;212;3;215
32;Hauts-de-France;80;2;04;735;Seux;166;2;168
32;Hauts-de-France;80;4;20;737;Sorel;162;1;163
32;Hauts-de-France;80;1;17;736;Sorel-en-Vimeu;213;5;218
32;Hauts-de-France;80;2;04;738;Soues;125;3;128
32;Hauts-de-France;80;3;03;740;Sourdon;337;2;339
32;Hauts-de-France;80;4;18;741;Soyécourt;189;4;193
32;Hauts-de-France;80;2;15;742;Surcamps;64;2;66
32;Hauts-de-France;80;4;05;743;Suzanne;190;4;194
32;Hauts-de-France;80;2;04;744;Tailly;58;2;60
32;Hauts-de-France;80;2;13;746;Talmas;1069;12;1081
32;Hauts-de-France;80;4;20;747;Templeux-la-Fosse;138;3;141
32;Hauts-de-France;80;4;20;748;Templeux-le-Guérard;179;3;182
32;Hauts-de-France;80;2;14;749;Terramesnil;313;4;317
32;Hauts-de-France;80;4;18;750;Tertry;148;1;149
32;Hauts-de-France;80;3;19;751;Thennes;568;6;574
32;Hauts-de-France;80;2;03;752;Thézy-Glimont;664;8;672
32;Hauts-de-France;80;4;05;753;Thiepval;126;2;128
32;Hauts-de-France;80;2;21;754;Thieulloy-l'Abbaye;385;4;389
32;Hauts-de-France;80;2;21;755;Thieulloy-la-Ville;147;4;151
32;Hauts-de-France;80;4;05;756;Thièvres;63;0;63
32;Hauts-de-France;80;2;03;757;Thoix;144;2;146
32;Hauts-de-France;80;3;03;758;Thory;200;0;200
32;Hauts-de-France;80;3;22;759;Tilloloy;350;9;359
32;Hauts-de-France;80;1;17;760;Tilloy-Floriville;385;10;395
32;Hauts-de-France;80;4;20;762;Tincourt-Boucly;351;10;361
32;Hauts-de-France;80;1;01;763;Le Titre;351;8;359
32;Hauts-de-France;80;1;02;765;Tours-en-Vimeu;815;10;825
32;Hauts-de-France;80;4;05;766;Toutencourt;450;5;455
32;Hauts-de-France;80;2;21;767;Le Translay;253;6;259
32;Hauts-de-France;80;2;13;769;Treux;241;0;241
32;Hauts-de-France;80;3;  ;625;Trois-Rivières ;1519;12;1531
32;Hauts-de-France;80;1;16;770;Tully;541;9;550
32;Hauts-de-France;80;1;02;764;Tœufles;296;7;303
32;Hauts-de-France;80;4;18;771;Ugny-l'Équipée;37;0;37
32;Hauts-de-France;80;2;13;773;Vadencourt;103;0;103
32;Hauts-de-France;80;2;13;774;Vaire-sous-Corbie;291;3;294
32;Hauts-de-France;80;1;16;775;Valines;637;6;643
32;Hauts-de-France;80;4;05;776;Varennes;219;1;220
32;Hauts-de-France;80;4;05;777;Vauchelles-lès-Authie;145;1;146
32;Hauts-de-France;80;2;15;778;Vauchelles-lès-Domart;126;0;126
32;Hauts-de-France;80;1;01;779;Vauchelles-les-Quesnoy;853;19;872
32;Hauts-de-France;80;1;16;780;Vaudricourt;400;5;405
32;Hauts-de-France;80;4;18;781;Vauvillers;236;5;241
32;Hauts-de-France;80;2;15;782;Vaux-en-Amiénois;412;7;419
32;Hauts-de-France;80;1;17;783;Vaux-Marquenneville;85;1;86
32;Hauts-de-France;80;2;13;784;Vaux-sur-Somme;307;6;313
32;Hauts-de-France;80;2;08;785;Vecquemont;542;9;551
32;Hauts-de-France;80;2;03;786;Velennes;149;0;149
32;Hauts-de-France;80;1;23;787;Vercourt;93;1;94
32;Hauts-de-France;80;2;21;788;Vergies;168;2;170
32;Hauts-de-France;80;4;18;789;Vermandovillers;150;0;150
32;Hauts-de-France;80;3;22;790;Verpillières;172;3;175
32;Hauts-de-France;80;2;12;791;Vers-sur-Selle;736;6;742
32;Hauts-de-France;80;2;13;792;La Vicogne;248;1;249
32;Hauts-de-France;80;2;15;793;Vignacourt;2354;34;2388
32;Hauts-de-France;80;2;15;795;Ville-le-Marclet;471;38;509
32;Hauts-de-France;80;4;05;807;Ville-sur-Ancre;274;3;277
32;Hauts-de-France;80;4;18;794;Villecourt;57;1;58
32;Hauts-de-France;80;2;21;796;Villeroy;186;6;192
32;Hauts-de-France;80;3;19;797;Villers-aux-Érables;132;3;135
32;Hauts-de-France;80;2;07;798;Villers-Bocage;1428;53;1481
32;Hauts-de-France;80;2;09;799;Villers-Bretonneux;4482;54;4536
32;Hauts-de-France;80;2;21;800;Villers-Campsart;148;7;155
32;Hauts-de-France;80;4;20;801;Villers-Carbonnel;348;4;352
32;Hauts-de-France;80;4;20;802;Villers-Faucon;566;9;575
32;Hauts-de-France;80;3;22;803;Villers-lès-Roye;272;0;272
32;Hauts-de-France;80;1;23;804;Villers-sous-Ailly;176;5;181
32;Hauts-de-France;80;1;23;806;Villers-sur-Authie;473;8;481
32;Hauts-de-France;80;3;22;805;Villers-Tournelle;164;6;170
32;Hauts-de-France;80;1;23;808;Vironchaux;494;9;503
32;Hauts-de-France;80;1;17;809;Vismes;480;12;492
32;Hauts-de-France;80;1;23;810;Vitz-sur-Authie;128;1;129
32;Hauts-de-France;80;4;18;811;Voyennes;601;7;608
32;Hauts-de-France;80;4;20;812;Vraignes-en-Vermandois;139;3;142
32;Hauts-de-France;80;2;21;813;Vraignes-lès-Hornoy;96;3;99
32;Hauts-de-France;80;4;19;814;Vrély;443;9;452
32;Hauts-de-France;80;1;23;815;Vron;836;26;862
32;Hauts-de-France;80;2;13;819;Wargnies;86;3;89
32;Hauts-de-France;80;2;13;820;Warloy-Baillon;755;10;765
32;Hauts-de-France;80;2;04;821;Warlus;221;5;226
32;Hauts-de-France;80;3;22;822;Warsy;148;2;150
32;Hauts-de-France;80;4;19;823;Warvillers;142;10;152
32;Hauts-de-France;80;4;19;824;Wiencourt-l'Équipée;265;2;267
32;Hauts-de-France;80;1;17;825;Wiry-au-Mont;118;1;119
32;Hauts-de-France;80;1;16;826;Woignarue;797;17;814
32;Hauts-de-France;80;1;16;827;Woincourt;1255;14;1269
32;Hauts-de-France;80;2;21;828;Woirel;63;0;63
32;Hauts-de-France;80;4;18;829;Y;91;2;93
32;Hauts-de-France;80;1;23;830;Yaucourt-Bussus;244;5;249
32;Hauts-de-France;80;1;02;836;Yonval;223;7;230
32;Hauts-de-France;80;1;23;832;Yvrench;304;4;308
32;Hauts-de-France;80;1;23;833;Yvrencheux;125;2;127
32;Hauts-de-France;80;1;16;834;Yzengremer;514;47;561
32;Hauts-de-France;80;2;04;835;Yzeux;268;0;268
76;Occitanie;81;2;15;001;Aguts;227;9;236
76;Occitanie;81;2;16;002;Aiguefonde;2511;57;2568
76;Occitanie;81;1;13;003;Alban;937;36;973
76;Occitanie;81;1;96;004;Albi;48993;1748;50741
76;Occitanie;81;2;17;005;Albine;513;5;518
76;Occitanie;81;2;15;006;Algans;197;3;200
76;Occitanie;81;1;05;008;Almayrac;289;4;293
76;Occitanie;81;1;23;007;Alos;94;2;96
76;Occitanie;81;1;06;009;Amarens;68;0;68
76;Occitanie;81;1;13;010;Ambialet;463;6;469
76;Occitanie;81;2;21;011;Ambres;997;39;1036
76;Occitanie;81;1;23;012;Andillac;122;1;123
76;Occitanie;81;1;05;013;Andouque;407;8;415
76;Occitanie;81;2;14;014;Anglès;505;8;513
76;Occitanie;81;2;19;015;Appelle;71;1;72
76;Occitanie;81;2;18;016;Arfons;164;7;171
76;Occitanie;81;2;13;017;Arifat;162;1;163
76;Occitanie;81;1;22;018;Arthès;2488;49;2537
76;Occitanie;81;1;05;019;Assac;143;1;144
76;Occitanie;81;1;10;020;Aussac;267;12;279
76;Occitanie;81;2;16;021;Aussillon;5856;136;5992
76;Occitanie;81;2;15;022;Bannières;202;7;209
76;Occitanie;81;2;14;023;Barre;207;2;209
76;Occitanie;81;1;23;024;Beauvais-sur-Tescou;363;9;372
76;Occitanie;81;2;15;025;Belcastel;242;9;251
76;Occitanie;81;1;13;026;Bellegarde-Marsal;705;7;712
76;Occitanie;81;2;18;027;Belleserre;160;2;162
76;Occitanie;81;2;14;028;Berlats;104;1;105
76;Occitanie;81;1;10;029;Bernac;185;5;190
76;Occitanie;81;2;19;030;Bertre;114;1;115
76;Occitanie;81;2;14;031;Le Bez;823;18;841
76;Occitanie;81;2;19;032;Blan;1127;19;1146
76;Occitanie;81;1;06;033;Blaye-les-Mines;2965;186;3151
76;Occitanie;81;2;16;034;Boissezon;392;7;399
76;Occitanie;81;1;06;035;Bournazel;205;7;212
76;Occitanie;81;2;17;036;Bout-du-Pont-de-Larn;1260;22;1282
76;Occitanie;81;2;14;037;Brassac;1297;33;1330
76;Occitanie;81;1;11;038;Brens;2313;63;2376
76;Occitanie;81;2;12;039;Briatexte;2033;30;2063
76;Occitanie;81;2;20;040;Brousse;423;11;434
76;Occitanie;81;1;11;041;Broze;120;1;121
76;Occitanie;81;2;08;042;Burlats;2092;42;2134
76;Occitanie;81;2;12;043;Busque;739;13;752
76;Occitanie;81;2;20;044;Cabanès;297;4;301
76;Occitanie;81;1;06;045;Les Cabannes;369;9;378
76;Occitanie;81;1;10;046;Cadalen;1529;45;1574
76;Occitanie;81;1;05;047;Cadix;226;7;233
76;Occitanie;81;1;03;048;Cagnac-les-Mines;2583;32;2615
76;Occitanie;81;2;18;049;Cahuzac;363;3;366
76;Occitanie;81;1;23;051;Cahuzac-sur-Vère;1154;20;1174
76;Occitanie;81;1;22;052;Cambon;2120;55;2175
76;Occitanie;81;2;15;050;Cambon-lès-Lavaur;338;10;348
76;Occitanie;81;2;14;053;Cambounès;332;10;342
76;Occitanie;81;2;19;054;Cambounet-sur-le-Sor;936;28;964
76;Occitanie;81;2;18;055;Les Cammazes;345;1;346
76;Occitanie;81;1;23;056;Campagnac;156;2;158
76;Occitanie;81;2;20;058;Carbes;228;7;235
76;Occitanie;81;1;02;059;Carlus;673;15;688
76;Occitanie;81;1;97;060;Carmaux;9641;158;9799
76;Occitanie;81;1;10;061;Castanet;195;2;197
76;Occitanie;81;1;03;063;Castelnau-de-Lévis;1617;38;1655
76;Occitanie;81;1;23;064;Castelnau-de-Montmiral;1027;25;1052
76;Occitanie;81;2;98;065;Castres;41795;1465;43260
76;Occitanie;81;2;16;066;Caucalières;283;6;289
76;Occitanie;81;1;10;067;Cestayrols;468;16;484
76;Occitanie;81;1;06;068;Combefa;154;6;160
76;Occitanie;81;1;06;069;Cordes-sur-Ciel;828;39;867
76;Occitanie;81;1;21;070;Coufouleux;2908;54;2962
76;Occitanie;81;1;05;071;Courris;80;3;83
76;Occitanie;81;1;05;072;Crespin;132;3;135
76;Occitanie;81;1;05;073;Crespinet;177;1;178
76;Occitanie;81;1;22;074;Cunac;1575;61;1636
76;Occitanie;81;2;20;075;Cuq;494;11;505
76;Occitanie;81;2;15;076;Cuq-Toulza;698;20;718
76;Occitanie;81;1;13;077;Curvalle;402;10;412
76;Occitanie;81;2;20;078;Damiatte;1026;18;1044
76;Occitanie;81;1;22;079;Dénat;798;33;831
76;Occitanie;81;1;06;080;Donnazac;76;2;78
76;Occitanie;81;2;18;081;Dourgne;1316;36;1352
76;Occitanie;81;1;05;082;Le Dourn;112;1;113
76;Occitanie;81;2;18;083;Durfort;246;1;247
76;Occitanie;81;2;18;084;Escoussens;608;21;629
76;Occitanie;81;2;14;085;Escroux;47;1;48
76;Occitanie;81;2;14;086;Espérausses;173;3;176
76;Occitanie;81;1;13;088;Fauch;549;14;563
76;Occitanie;81;1;05;089;Faussergues;138;5;143
76;Occitanie;81;1;10;087;Fayssac;349;10;359
76;Occitanie;81;1;10;090;Fénols;247;6;253
76;Occitanie;81;2;20;092;Fiac;921;15;936
76;Occitanie;81;1;10;093;Florentin;683;46;729
76;Occitanie;81;2;14;062;Fontrieu;940;18;958
76;Occitanie;81;1;05;094;Fraissines;93;3;96
76;Occitanie;81;1;06;095;Frausseilles;83;1;84
76;Occitanie;81;1;13;096;Le Fraysse;401;5;406
76;Occitanie;81;1;22;097;Fréjairolles;1326;35;1361
76;Occitanie;81;2;20;098;Fréjeville;682;20;702
76;Occitanie;81;1;11;099;Gaillac;15345;322;15667
76;Occitanie;81;2;19;100;Garrevaques;400;10;410
76;Occitanie;81;1;04;101;Le Garric;1258;18;1276
76;Occitanie;81;2;21;102;Garrigues;254;13;267
76;Occitanie;81;2;14;103;Gijounet;131;7;138
76;Occitanie;81;2;21;104;Giroussens;1478;35;1513
76;Occitanie;81;2;12;105;Graulhet;12789;243;13032
76;Occitanie;81;1;23;106;Grazac;611;11;622
76;Occitanie;81;2;20;132;Guitalens-L'Albarède;845;12;857
76;Occitanie;81;1;06;108;Itzac;160;1;161
76;Occitanie;81;2;20;109;Jonquières;442;7;449
76;Occitanie;81;1;05;110;Jouqueviel;96;3;99
76;Occitanie;81;1;06;111;Labarthe-Bleys;76;0;76
76;Occitanie;81;1;10;112;Labastide-de-Lévis;924;23;947
76;Occitanie;81;1;06;114;Labastide-Gabausse;510;12;522
76;Occitanie;81;2;17;115;Labastide-Rouairoux;1414;25;1439
76;Occitanie;81;2;15;116;Labastide-Saint-Georges;1930;45;1975
76;Occitanie;81;1;10;117;Labessière-Candeil;750;22;772
76;Occitanie;81;2;20;118;Laboulbène;148;4;152
76;Occitanie;81;1;13;119;Laboutarie;486;6;492
76;Occitanie;81;2;18;120;Labruguière;6502;115;6617
76;Occitanie;81;2;17;121;Lacabarède;303;1;304
76;Occitanie;81;1;05;122;Lacapelle-Pinet;80;2;82
76;Occitanie;81;1;06;123;Lacapelle-Ségalar;97;3;100
76;Occitanie;81;2;14;124;Lacaune;2478;82;2560
76;Occitanie;81;2;14;125;Lacaze;304;8;312
76;Occitanie;81;2;15;126;Lacougotte-Cadoul;175;8;183
76;Occitanie;81;2;15;127;Lacroisille;112;7;119
76;Occitanie;81;2;14;128;Lacrouzette;1639;40;1679
76;Occitanie;81;2;18;129;Lagardiolle;235;5;240
76;Occitanie;81;2;16;130;Lagarrigue;1837;35;1872
76;Occitanie;81;1;10;131;Lagrave;2153;40;2193
76;Occitanie;81;1;13;133;Lamillarié;508;13;521
76;Occitanie;81;2;14;134;Lamontélarié;63;0;63
76;Occitanie;81;1;06;135;Laparrouquial;97;0;97
76;Occitanie;81;1;23;136;Larroque;155;3;158
76;Occitanie;81;2;14;137;Lasfaillades;84;1;85
76;Occitanie;81;1;10;138;Lasgraisses;534;9;543
76;Occitanie;81;2;20;139;Lautrec;1755;52;1807
76;Occitanie;81;2;15;140;Lavaur;10671;422;11093
76;Occitanie;81;1;05;141;Lédas-et-Penthiès;144;5;149
76;Occitanie;81;2;19;142;Lempaut;884;14;898
76;Occitanie;81;2;19;143;Lescout;721;13;734
76;Occitanie;81;1;04;144;Lescure-d'Albigeois;4571;91;4662
76;Occitanie;81;1;23;145;Lisle-sur-Tarn;4682;84;4766
76;Occitanie;81;1;06;146;Livers-Cazelles;223;5;228
76;Occitanie;81;1;13;147;Lombers;1138;14;1152
76;Occitanie;81;1;06;148;Loubers;77;6;83
76;Occitanie;81;1;21;149;Loupiac;414;15;429
76;Occitanie;81;2;21;150;Lugan;424;13;437
76;Occitanie;81;2;20;151;Magrin;128;6;134
76;Occitanie;81;1;03;152;Mailhoc;307;3;310
76;Occitanie;81;1;06;154;Marnaves;76;1;77
76;Occitanie;81;1;03;156;Marssac-sur-Tarn;3277;77;3354
76;Occitanie;81;2;15;157;Marzens;308;11;319
76;Occitanie;81;2;14;158;Le Masnau-Massuguiès;267;6;273
76;Occitanie;81;2;15;159;Massac-Séran;382;17;399
76;Occitanie;81;2;18;160;Massaguel;388;9;397
76;Occitanie;81;1;13;161;Massals;104;1;105
76;Occitanie;81;2;15;162;Maurens-Scopont;175;2;177
76;Occitanie;81;2;99;163;Mazamet;10033;423;10456
76;Occitanie;81;1;23;164;Mézens;505;12;517
76;Occitanie;81;1;06;165;Milhars;244;3;247
76;Occitanie;81;1;03;166;Milhavet;89;3;92
76;Occitanie;81;1;13;167;Miolles;105;1;106
76;Occitanie;81;1;05;168;Mirandol-Bourgnounac;1044;22;1066
76;Occitanie;81;2;12;169;Missècle;97;1;98
76;Occitanie;81;1;06;170;Monestiés;1360;13;1373
76;Occitanie;81;2;13;183;Mont-Roc;188;6;194
76;Occitanie;81;1;10;171;Montans;1472;31;1503
76;Occitanie;81;1;05;172;Montauriol;57;0;57
76;Occitanie;81;2;15;173;Montcabrier;314;7;321
76;Occitanie;81;2;20;174;Montdragon;626;6;632
76;Occitanie;81;1;23;175;Montdurausse;437;5;442
76;Occitanie;81;1;23;176;Montels;104;5;109
76;Occitanie;81;2;08;177;Montfa;488;6;494
76;Occitanie;81;1;23;178;Montgaillard;370;13;383
76;Occitanie;81;2;15;179;Montgey;282;8;290
76;Occitanie;81;1;06;180;Montirat;250;9;259
76;Occitanie;81;2;20;181;Montpinier;190;4;194
76;Occitanie;81;2;13;182;Montredon-Labessonnié;2002;42;2044
76;Occitanie;81;1;06;184;Montrosier;35;0;35
76;Occitanie;81;1;23;185;Montvalen;235;3;238
76;Occitanie;81;1;05;186;Moularès;265;5;270
76;Occitanie;81;2;12;187;Moulayrès;209;3;212
76;Occitanie;81;2;14;188;Moulin-Mage;318;3;321
76;Occitanie;81;2;15;189;Mouzens;124;2;126
76;Occitanie;81;1;06;191;Mouzieys-Panens;237;1;238
76;Occitanie;81;1;13;190;Mouzieys-Teulet;528;9;537
76;Occitanie;81;2;14;192;Murat-sur-Vèbre;859;12;871
76;Occitanie;81;2;14;193;Nages;339;4;343
76;Occitanie;81;2;09;195;Navès;690;23;713
76;Occitanie;81;2;16;196;Noailhac;850;21;871
76;Occitanie;81;1;06;197;Noailles;214;4;218
76;Occitanie;81;1;13;198;Orban;331;4;335
76;Occitanie;81;1;05;199;Padiès;189;3;192
76;Occitanie;81;2;19;200;Palleville;429;52;481
76;Occitanie;81;1;05;201;Pampelonne;844;20;864
76;Occitanie;81;1;10;202;Parisot;958;18;976
76;Occitanie;81;1;13;203;Paulinet;551;8;559
76;Occitanie;81;2;16;204;Payrin-Augmontel;2171;37;2208
76;Occitanie;81;2;15;205;Péchaudier;190;9;199
76;Occitanie;81;1;06;206;Penne;584;19;603
76;Occitanie;81;2;20;207;Peyregoux;79;29;108
76;Occitanie;81;1;10;208;Peyrole;592;11;603
76;Occitanie;81;2;17;209;Pont-de-Larn;2796;79;2875
76;Occitanie;81;2;19;210;Poudis;260;7;267
76;Occitanie;81;1;13;211;Poulan-Pouzols;497;10;507
76;Occitanie;81;2;20;212;Prades;127;4;131
76;Occitanie;81;2;20;213;Pratviel;88;2;90
76;Occitanie;81;2;15;214;Puéchoursi;99;1;100
76;Occitanie;81;2;12;215;Puybegon;642;9;651
76;Occitanie;81;2;20;216;Puycalvel;217;3;220
76;Occitanie;81;1;23;217;Puycelsi;451;11;462
76;Occitanie;81;1;89;218;Puygouzon;3485;79;3564
76;Occitanie;81;2;19;219;Puylaurens;3198;73;3271
76;Occitanie;81;1;23;220;Rabastens;5666;145;5811
76;Occitanie;81;2;13;221;Rayssac;237;1;238
76;Occitanie;81;1;13;222;Réalmont;3449;58;3507
76;Occitanie;81;2;17;223;Le Rialet;55;0;55
76;Occitanie;81;1;06;224;Le Riols;102;0;102
76;Occitanie;81;1;10;225;Rivières;1056;29;1085
76;Occitanie;81;2;08;227;Roquecourbe;2202;46;2248
76;Occitanie;81;1;23;228;Roquemaure;457;10;467
76;Occitanie;81;2;15;229;Roquevidal;133;4;137
76;Occitanie;81;1;05;230;Rosières;738;14;752
76;Occitanie;81;2;17;231;Rouairoux;372;7;379
76;Occitanie;81;1;02;232;Rouffiac;613;13;626
76;Occitanie;81;1;06;234;Roussayrolles;83;3;86
76;Occitanie;81;2;18;235;Saint-Affrique-les-Montagnes;725;28;753
76;Occitanie;81;2;21;236;Saint-Agnan;226;7;233
76;Occitanie;81;2;18;237;Saint-Amancet;188;3;191
76;Occitanie;81;2;17;238;Saint-Amans-Soult;1539;123;1662
76;Occitanie;81;2;17;239;Saint-Amans-Valtoret;883;12;895
76;Occitanie;81;1;13;240;Saint-André;102;4;106
76;Occitanie;81;2;18;242;Saint-Avit;262;3;265
76;Occitanie;81;1;23;243;Saint-Beauzile;131;2;133
76;Occitanie;81;1;06;244;Saint-Benoît-de-Carmaux;2129;35;2164
76;Occitanie;81;1;06;245;Saint-Christophe;125;6;131
76;Occitanie;81;1;05;247;Saint-Cirgue;209;3;212
76;Occitanie;81;2;12;248;Saint-Gauzens;872;20;892
76;Occitanie;81;2;20;250;Saint-Genest-de-Contest;281;9;290
76;Occitanie;81;2;19;251;Saint-Germain-des-Prés;926;18;944
76;Occitanie;81;2;08;252;Saint-Germier;153;1;154
76;Occitanie;81;1;05;253;Saint-Grégoire;460;7;467
76;Occitanie;81;1;05;254;Saint-Jean-de-Marcel;372;5;377
76;Occitanie;81;2;21;255;Saint-Jean-de-Rives;509;11;520
76;Occitanie;81;2;08;256;Saint-Jean-de-Vals;74;1;75
76;Occitanie;81;1;22;257;Saint-Juéry;6760;104;6864
76;Occitanie;81;2;20;258;Saint-Julien-du-Puy;436;16;452
76;Occitanie;81;1;05;259;Saint-Julien-Gaulène;219;1;220
76;Occitanie;81;2;21;261;Saint-Lieux-lès-Lavaur;1061;17;1078
76;Occitanie;81;1;06;262;Saint-Marcel-Campes;212;2;214
76;Occitanie;81;1;06;263;Saint-Martin-Laguépie;390;11;401
76;Occitanie;81;1;06;265;Saint-Michel-de-Vax;75;1;76
76;Occitanie;81;1;05;264;Saint-Michel-Labadié;92;2;94
76;Occitanie;81;2;20;266;Saint-Paul-Cap-de-Joux;1100;29;1129
76;Occitanie;81;2;14;267;Saint-Pierre-de-Trivisy;621;12;633
76;Occitanie;81;2;14;268;Saint-Salvi-de-Carcavès;73;4;77
76;Occitanie;81;2;08;269;Saint-Salvy-de-la-Balme;516;8;524
76;Occitanie;81;2;19;270;Saint-Sernin-lès-Lavaur;167;3;170
76;Occitanie;81;2;21;271;Saint-Sulpice-la-Pointe;9227;271;9498
76;Occitanie;81;1;23;272;Saint-Urcisse;214;1;215
76;Occitanie;81;1;23;246;Sainte-Cécile-du-Cayrou;111;2;113
76;Occitanie;81;1;03;326;Sainte-Croix;377;12;389
76;Occitanie;81;1;05;249;Sainte-Gemme;912;13;925
76;Occitanie;81;2;19;273;Saïx;3589;72;3661
76;Occitanie;81;1;02;274;Saliès;826;18;844
76;Occitanie;81;1;06;275;Salles;191;2;193
76;Occitanie;81;1;23;276;Salvagnac;1203;18;1221
76;Occitanie;81;1;05;277;Saussenac;590;9;599
76;Occitanie;81;2;17;278;Sauveterre;164;2;166
76;Occitanie;81;1;23;279;La Sauzière-Saint-Jean;264;8;272
76;Occitanie;81;1;06;280;Le Ségur;259;7;266
76;Occitanie;81;2;20;281;Sémalens;2011;55;2066
76;Occitanie;81;2;14;282;Senaux;34;0;34
76;Occitanie;81;1;10;283;Senouillac;1112;33;1145
76;Occitanie;81;1;02;284;Le Sequestre;1875;29;1904
76;Occitanie;81;1;05;285;Sérénac;487;2;489
76;Occitanie;81;2;20;286;Serviès;624;21;645
76;Occitanie;81;1;13;287;Sieurac;262;2;264
76;Occitanie;81;2;18;288;Sorèze;2869;63;2932
76;Occitanie;81;2;19;289;Soual;2573;40;2613
76;Occitanie;81;1;06;290;Souel;165;2;167
76;Occitanie;81;1;06;291;Taïx;485;6;491
76;Occitanie;81;1;05;292;Tanus;532;18;550
76;Occitanie;81;1;23;293;Tauriac;348;3;351
76;Occitanie;81;1;10;294;Técou;987;17;1004
76;Occitanie;81;1;13;295;Teillet;442;6;448
76;Occitanie;81;1;13;233;Terre-de-Bancalié ;1714;27;1741
76;Occitanie;81;1;03;297;Terssac;1221;29;1250
76;Occitanie;81;2;15;298;Teulat;489;13;502
76;Occitanie;81;2;20;299;Teyssode;372;15;387
76;Occitanie;81;1;06;300;Tonnac;100;2;102
76;Occitanie;81;1;05;302;Tréban;48;1;49
76;Occitanie;81;1;05;303;Trébas;410;4;414
76;Occitanie;81;1;06;304;Trévien;183;4;187
76;Occitanie;81;2;14;305;Vabre;756;19;775
76;Occitanie;81;1;05;306;Valderiès;846;23;869
76;Occitanie;81;2;16;307;Valdurenque;846;18;864
76;Occitanie;81;1;05;308;Valence-d'Albigeois;1308;27;1335
76;Occitanie;81;1;06;309;Vaour;311;15;326
76;Occitanie;81;2;15;310;Veilhes;150;3;153
76;Occitanie;81;2;20;311;Vénès;787;20;807
76;Occitanie;81;2;18;312;Verdalle;1003;174;1177
76;Occitanie;81;1;23;313;Le Verdier;226;6;232
76;Occitanie;81;2;14;314;Viane;530;39;569
76;Occitanie;81;2;20;315;Vielmur-sur-Agout;1440;48;1488
76;Occitanie;81;1;23;316;Vieux;225;3;228
76;Occitanie;81;1;13;317;Villefranche-d'Albigeois;1250;30;1280
76;Occitanie;81;2;15;318;Villeneuve-lès-Lavaur;144;2;146
76;Occitanie;81;1;03;319;Villeneuve-sur-Vère;494;14;508
76;Occitanie;81;1;06;320;Vindrac-Alayrac;148;5;153
76;Occitanie;81;2;17;321;Le Vintrou;88;1;89
76;Occitanie;81;1;06;322;Virac;238;6;244
76;Occitanie;81;2;20;323;Viterbe;362;6;368
76;Occitanie;81;2;15;324;Viviers-lès-Lavaur;225;5;230
76;Occitanie;81;2;19;325;Viviers-lès-Montagnes;1959;39;1998
76;Occitanie;82;1;09;001;Albefeuille-Lagarde;630;18;648
76;Occitanie;82;2;11;002;Albias;3260;57;3317
76;Occitanie;82;1;02;003;Angeville;246;5;251
76;Occitanie;82;1;04;004;Asques;134;0;134
76;Occitanie;82;2;15;005;Aucamville;1484;19;1503
76;Occitanie;82;1;02;006;Auterive;82;2;84
76;Occitanie;82;2;11;007;Auty;142;1;143
76;Occitanie;82;1;04;008;Auvillar;916;42;958
76;Occitanie;82;1;04;009;Balignac;40;2;42
76;Occitanie;82;1;04;010;Bardigues;279;6;285
76;Occitanie;82;1;03;011;Barry-d'Islemade;934;14;948
76;Occitanie;82;1;03;012;Les Barthes;566;8;574
76;Occitanie;82;1;02;013;Beaumont-de-Lomagne;3765;174;3939
76;Occitanie;82;2;15;014;Beaupuy;260;6;266
76;Occitanie;82;1;02;015;Belbèze-en-Lomagne;139;3;142
76;Occitanie;82;1;10;016;Belvèze;214;2;216
76;Occitanie;82;2;09;017;Bessens;1497;25;1522
76;Occitanie;82;2;01;018;Bioule;1131;29;1160
76;Occitanie;82;1;14;019;Boudou;742;17;759
76;Occitanie;82;2;15;020;Bouillac;612;14;626
76;Occitanie;82;1;10;021;Bouloc-en-Quercy;191;3;194
76;Occitanie;82;1;14;022;Bourg-de-Visa;379;10;389
76;Occitanie;82;2;02;023;Bourret;938;11;949
76;Occitanie;82;1;14;024;Brassac;245;3;248
76;Occitanie;82;2;09;025;Bressols;3698;103;3801
76;Occitanie;82;2;13;026;Bruniquel;605;9;614
76;Occitanie;82;2;15;027;Campsas;1387;23;1410
76;Occitanie;82;2;15;028;Canals;775;11;786
76;Occitanie;82;2;12;029;Castanet;285;3;288
76;Occitanie;82;1;02;030;Castelferrus;483;4;487
76;Occitanie;82;1;04;031;Castelmayran;1216;17;1233
76;Occitanie;82;1;14;032;Castelsagrat;555;13;568
76;Occitanie;82;1;03;033;Castelsarrasin;13934;318;14252
76;Occitanie;82;1;04;034;Castéra-Bouzet;108;3;111
76;Occitanie;82;1;04;035;Caumont;327;9;336
76;Occitanie;82;1;02;036;Le Causé;135;2;137
76;Occitanie;82;2;01;037;Caussade;6835;220;7055
76;Occitanie;82;2;12;038;Caylus;1457;28;1485
76;Occitanie;82;2;11;039;Cayrac;552;22;574
76;Occitanie;82;2;12;040;Cayriech;279;9;288
76;Occitanie;82;2;12;041;Cazals;229;3;232
76;Occitanie;82;1;10;042;Cazes-Mondenard;1187;21;1208
76;Occitanie;82;2;02;043;Comberouger;274;10;284
76;Occitanie;82;2;13;044;Corbarieu;1651;50;1701
76;Occitanie;82;1;02;045;Cordes-Tolosannes;352;6;358
76;Occitanie;82;1;02;046;Coutures;111;0;111
76;Occitanie;82;1;02;047;Cumont;51;0;51
76;Occitanie;82;2;15;048;Dieupentale;1675;14;1689
76;Occitanie;82;1;04;049;Donzac;1043;13;1056
76;Occitanie;82;1;04;050;Dunes;1202;24;1226
76;Occitanie;82;1;10;051;Durfort-Lacapelette;834;90;924
76;Occitanie;82;2;02;052;Escatalens;1107;106;1213
76;Occitanie;82;1;02;053;Escazeaux;287;3;290
76;Occitanie;82;1;14;054;Espalais;382;7;389
76;Occitanie;82;1;02;055;Esparsac;255;8;263
76;Occitanie;82;2;12;056;Espinas;173;4;177
76;Occitanie;82;2;15;057;Fabas;639;15;654
76;Occitanie;82;1;02;058;Fajolles;99;2;101
76;Occitanie;82;1;02;059;Faudoas;287;10;297
76;Occitanie;82;1;10;060;Fauroux;210;4;214
76;Occitanie;82;2;12;061;Féneyrols;144;2;146
76;Occitanie;82;2;09;062;Finhan;1531;19;1550
76;Occitanie;82;1;02;063;Garganvillar;673;13;686
76;Occitanie;82;1;02;064;Gariès;118;0;118
76;Occitanie;82;1;14;065;Gasques;410;10;420
76;Occitanie;82;2;13;066;Génébrières;616;13;629
76;Occitanie;82;1;04;067;Gensac;110;1;111
76;Occitanie;82;1;02;068;Gimat;235;6;241
76;Occitanie;82;2;12;069;Ginals;205;6;211
76;Occitanie;82;1;02;070;Glatens;73;2;75
76;Occitanie;82;1;02;071;Goas;37;2;39
76;Occitanie;82;1;14;072;Golfech;1009;26;1035
76;Occitanie;82;1;14;073;Goudourville;945;31;976
76;Occitanie;82;1;04;074;Gramont;137;5;142
76;Occitanie;82;2;15;075;Grisolles;4152;56;4208
76;Occitanie;82;2;11;076;L' Honor-de-Cos;1578;34;1612
76;Occitanie;82;2;10;077;Labarthe;399;5;404
76;Occitanie;82;2;12;078;Labastide-de-Penne;129;0;129
76;Occitanie;82;1;03;080;Labastide-du-Temple;1138;26;1164
76;Occitanie;82;2;13;079;Labastide-Saint-Pierre;3762;79;3841
76;Occitanie;82;1;02;081;Labourgade;188;2;190
76;Occitanie;82;2;12;082;Lacapelle-Livron;200;5;205
76;Occitanie;82;1;04;083;Lachapelle;118;1;119
76;Occitanie;82;1;10;084;Lacour;170;5;175
76;Occitanie;82;2;09;085;Lacourt-Saint-Pierre;1225;11;1236
76;Occitanie;82;1;02;086;Lafitte;224;3;227
76;Occitanie;82;2;10;087;Lafrançaise;2842;65;2907
76;Occitanie;82;2;12;088;Laguépie;606;13;619
76;Occitanie;82;1;14;089;Lamagistère;1162;18;1180
76;Occitanie;82;2;11;090;Lamothe-Capdeville;1063;29;1092
76;Occitanie;82;1;02;091;Lamothe-Cumont;127;3;130
76;Occitanie;82;2;12;092;Lapenche;281;4;285
76;Occitanie;82;1;02;093;Larrazet;693;8;701
76;Occitanie;82;1;10;094;Lauzerte;1447;17;1464
76;Occitanie;82;2;12;095;Lavaurette;217;13;230
76;Occitanie;82;1;04;097;Lavit;1607;18;1625
76;Occitanie;82;2;13;098;Léojac;1277;28;1305
76;Occitanie;82;1;05;099;Lizac;520;7;527
76;Occitanie;82;2;12;100;Loze;138;8;146
76;Occitanie;82;1;04;101;Malause;1178;16;1194
76;Occitanie;82;1;04;102;Mansonville;290;4;294
76;Occitanie;82;1;02;103;Marignac;109;6;115
76;Occitanie;82;1;04;104;Marsac;181;5;186
76;Occitanie;82;2;15;105;Mas-Grenier;1332;18;1350
76;Occitanie;82;1;02;106;Maubec;136;1;137
76;Occitanie;82;1;04;107;Maumusson;47;1;48
76;Occitanie;82;1;03;108;Meauzac;1343;29;1372
76;Occitanie;82;1;04;109;Merles;201;13;214
76;Occitanie;82;2;11;110;Mirabel;1037;18;1055
76;Occitanie;82;1;10;111;Miramont-de-Quercy;317;9;326
76;Occitanie;82;1;05;112;Moissac;13195;325;13520
76;Occitanie;82;2;11;113;Molières;1183;25;1208
76;Occitanie;82;2;09;114;Monbéqui;638;7;645
76;Occitanie;82;2;13;115;Monclar-de-Quercy;2006;18;2024
76;Occitanie;82;1;10;116;Montagudet;196;4;200
76;Occitanie;82;1;10;117;Montaigu-de-Quercy;1306;25;1331
76;Occitanie;82;1;02;118;Montaïn;103;1;104
76;Occitanie;82;2;11;119;Montalzat;656;18;674
76;Occitanie;82;2;11;120;Montastruc;298;5;303
76;Occitanie;82;2;99;121;Montauban;60952;1453;62405
76;Occitanie;82;1;10;122;Montbarla;180;3;183
76;Occitanie;82;2;09;123;Montbartier;1388;21;1409
76;Occitanie;82;2;09;124;Montbeton;4243;87;4330
76;Occitanie;82;2;09;125;Montech;6406;123;6529
76;Occitanie;82;2;12;126;Monteils;1360;84;1444
76;Occitanie;82;1;05;127;Montesquieu;751;19;770
76;Occitanie;82;2;11;128;Montfermier;105;3;108
76;Occitanie;82;1;04;129;Montgaillard;142;4;146
76;Occitanie;82;1;14;130;Montjoi;165;1;166
76;Occitanie;82;2;11;131;Montpezat-de-Quercy;1579;41;1620
76;Occitanie;82;2;01;132;Montricoux;1196;27;1223
76;Occitanie;82;2;12;133;Mouillac;96;1;97
76;Occitanie;82;2;01;134;Nègrepelisse;5642;80;5722
76;Occitanie;82;2;13;135;Nohic;1348;18;1366
76;Occitanie;82;2;13;136;Orgueil;1691;32;1723
76;Occitanie;82;2;12;137;Parisot;585;12;597
76;Occitanie;82;1;14;138;Perville;152;2;154
76;Occitanie;82;1;04;139;Le Pin;123;3;126
76;Occitanie;82;2;11;140;Piquecos;444;3;447
76;Occitanie;82;1;14;141;Pommevic;546;4;550
76;Occitanie;82;2;15;142;Pompignan;1491;19;1510
76;Occitanie;82;1;04;143;Poupas;84;0;84
76;Occitanie;82;2;10;144;Puycornet;733;11;744
76;Occitanie;82;1;04;146;Puygaillard-de-Lomagne;64;2;66
76;Occitanie;82;2;13;145;Puygaillard-de-Quercy;385;8;393
76;Occitanie;82;2;12;147;Puylagarde;332;8;340
76;Occitanie;82;2;12;148;Puylaroque;701;25;726
76;Occitanie;82;2;11;149;Réalville;1894;32;1926
76;Occitanie;82;2;13;150;Reyniès;861;24;885
76;Occitanie;82;1;10;151;Roquecor;404;9;413
76;Occitanie;82;1;04;152;Saint-Aignan;401;11;412
76;Occitanie;82;1;10;154;Saint-Amans-de-Pellagal;214;5;219
76;Occitanie;82;1;10;153;Saint-Amans-du-Pech;222;1;223
76;Occitanie;82;2;12;155;Saint-Antonin-Noble-Val;1848;46;1894
76;Occitanie;82;1;02;156;Saint-Arroumex;149;3;152
76;Occitanie;82;1;10;157;Saint-Beauzeil;98;2;100
76;Occitanie;82;1;04;158;Saint-Cirice;151;5;156
76;Occitanie;82;2;12;159;Saint-Cirq;553;17;570
76;Occitanie;82;1;14;160;Saint-Clair;269;8;277
76;Occitanie;82;2;01;161;Saint-Étienne-de-Tulmont;3863;76;3939
76;Occitanie;82;2;12;162;Saint-Georges;263;7;270
76;Occitanie;82;1;04;163;Saint-Jean-du-Bouzet;51;0;51
76;Occitanie;82;1;04;165;Saint-Loup;525;4;529
76;Occitanie;82;1;04;166;Saint-Michel;269;3;272
76;Occitanie;82;2;13;167;Saint-Nauphary;1857;40;1897
76;Occitanie;82;1;14;168;Saint-Nazaire-de-Valentane;337;3;340
76;Occitanie;82;1;04;169;Saint-Nicolas-de-la-Grave;2283;29;2312
76;Occitanie;82;1;14;170;Saint-Paul-d'Espis;572;19;591
76;Occitanie;82;2;02;171;Saint-Porquier;1407;24;1431
76;Occitanie;82;2;12;172;Saint-Projet;280;8;288
76;Occitanie;82;2;15;173;Saint-Sardos;1150;14;1164
76;Occitanie;82;2;11;174;Saint-Vincent-d'Autéjac;288;2;290
76;Occitanie;82;1;14;175;Saint-Vincent-Lespinasse;268;4;272
76;Occitanie;82;1;10;164;Sainte-Juliette;128;3;131
76;Occitanie;82;2;13;176;La Salvetat-Belmontet;841;12;853
76;Occitanie;82;1;10;177;Sauveterre;165;3;168
76;Occitanie;82;2;15;178;Savenès;807;17;824
76;Occitanie;82;2;12;179;Septfonds;2225;50;2275
76;Occitanie;82;1;02;180;Sérignac;533;8;541
76;Occitanie;82;1;04;181;Sistels;209;4;213
76;Occitanie;82;1;10;182;Touffailles;342;3;345
76;Occitanie;82;1;10;183;Tréjouls;240;10;250
76;Occitanie;82;2;01;184;Vaïssac;884;10;894
76;Occitanie;82;1;10;185;Valeilles;248;6;254
76;Occitanie;82;1;14;186;Valence;5213;154;5367
76;Occitanie;82;2;12;187;Varen;654;13;667
76;Occitanie;82;2;13;188;Varennes;611;14;625
76;Occitanie;82;2;10;189;Vazerac;733;14;747
76;Occitanie;82;2;15;190;Verdun-sur-Garonne;4782;66;4848
76;Occitanie;82;2;12;191;Verfeil;416;3;419
76;Occitanie;82;2;13;192;Verlhac-Tescou;521;14;535
76;Occitanie;82;1;02;193;Vigueron;136;3;139
76;Occitanie;82;2;03;096;La Ville-Dieu-du-Temple;3173;44;3217
76;Occitanie;82;2;13;194;Villebrumier;1378;35;1413
76;Occitanie;82;2;11;195;Villemade;761;13;774
93;Provence-Alpes-Côte d'Azur;83;1;14;001;Les Adrets-de-l'Estérel;2766;73;2839
93;Provence-Alpes-Côte d'Azur;83;3;04;002;Aiguines;272;5;277
93;Provence-Alpes-Côte d'Azur;83;1;04;003;Ampus;923;24;947
93;Provence-Alpes-Côte d'Azur;83;1;23;004;Les Arcs;7033;172;7205
93;Provence-Alpes-Côte d'Azur;83;3;04;005;Artignosc-sur-Verdon;301;6;307
93;Provence-Alpes-Côte d'Azur;83;3;13;006;Artigues;271;8;279
93;Provence-Alpes-Côte d'Azur;83;3;04;007;Aups;2275;37;2312
93;Provence-Alpes-Côte d'Azur;83;1;11;008;Bagnols-en-Forêt;2830;58;2888
93;Provence-Alpes-Côte d'Azur;83;2;10;009;Bandol;8404;145;8549
93;Provence-Alpes-Côte d'Azur;83;1;04;010;Bargème;223;1;224
93;Provence-Alpes-Côte d'Azur;83;1;04;011;Bargemon;1349;21;1370
93;Provence-Alpes-Côte d'Azur;83;3;13;012;Barjols;2975;39;3014
93;Provence-Alpes-Côte d'Azur;83;1;04;013;La Bastide;211;1;212
93;Provence-Alpes-Côte d'Azur;83;3;04;014;Baudinard-sur-Verdon;229;8;237
93;Provence-Alpes-Côte d'Azur;83;3;04;015;Bauduen;320;4;324
93;Provence-Alpes-Côte d'Azur;83;2;12;016;Le Beausset;9790;174;9964
93;Provence-Alpes-Côte d'Azur;83;2;18;017;Belgentier;2428;33;2461
93;Provence-Alpes-Côte d'Azur;83;3;09;018;Besse-sur-Issole;3035;44;3079
93;Provence-Alpes-Côte d'Azur;83;2;02;019;Bormes-les-Mimosas;8223;118;8341
93;Provence-Alpes-Côte d'Azur;83;1;04;020;Le Bourguet;38;1;39
93;Provence-Alpes-Côte d'Azur;83;3;13;021;Bras;2663;53;2716
93;Provence-Alpes-Côte d'Azur;83;1;04;022;Brenon;27;0;27
93;Provence-Alpes-Côte d'Azur;83;3;01;023;Brignoles;17364;352;17716
93;Provence-Alpes-Côte d'Azur;83;3;13;025;Brue-Auriac;1397;21;1418
93;Provence-Alpes-Côte d'Azur;83;3;09;026;Cabasse;1961;35;1996
93;Provence-Alpes-Côte d'Azur;83;2;12;027;La Cadière-d'Azur;5563;97;5660
93;Provence-Alpes-Côte d'Azur;83;1;04;028;Callas;1934;39;1973
93;Provence-Alpes-Côte d'Azur;83;1;11;029;Callian;3252;60;3312
93;Provence-Alpes-Côte d'Azur;83;3;07;030;Camps-la-Source;1902;47;1949
93;Provence-Alpes-Côte d'Azur;83;3;09;031;Le Cannet-des-Maures;4282;59;4341
93;Provence-Alpes-Côte d'Azur;83;3;01;032;Carcès;3414;81;3495
93;Provence-Alpes-Côte d'Azur;83;3;07;033;Carnoules;3490;35;3525
93;Provence-Alpes-Côte d'Azur;83;2;06;034;Carqueiranne;9555;165;9720
93;Provence-Alpes-Côte d'Azur;83;2;12;035;Le Castellet;3887;41;3928
93;Provence-Alpes-Côte d'Azur;83;1;15;036;Cavalaire-sur-Mer;7499;84;7583
93;Provence-Alpes-Côte d'Azur;83;3;01;037;La Celle;1476;55;1531
93;Provence-Alpes-Côte d'Azur;83;1;04;038;Châteaudouble;474;16;490
93;Provence-Alpes-Côte d'Azur;83;3;13;039;Châteauvert;146;24;170
93;Provence-Alpes-Côte d'Azur;83;1;04;040;Châteauvieux;81;1;82
93;Provence-Alpes-Côte d'Azur;83;1;04;041;Claviers;706;12;718
93;Provence-Alpes-Côte d'Azur;83;1;15;042;Cogolin;11556;242;11798
93;Provence-Alpes-Côte d'Azur;83;2;09;043;Collobrières;1891;89;1980
93;Provence-Alpes-Côte d'Azur;83;1;04;044;Comps-sur-Artuby;346;5;351
93;Provence-Alpes-Côte d'Azur;83;3;01;045;Correns;912;8;920
93;Provence-Alpes-Côte d'Azur;83;3;01;046;Cotignac;2136;39;2175
93;Provence-Alpes-Côte d'Azur;83;2;02;047;La Crau;18506;423;18929
93;Provence-Alpes-Côte d'Azur;83;1;15;048;La Croix-Valmer;3778;101;3879
93;Provence-Alpes-Côte d'Azur;83;2;18;049;Cuers;11560;137;11697
93;Provence-Alpes-Côte d'Azur;83;1;03;050;Draguignan;39106;909;40015
93;Provence-Alpes-Côte d'Azur;83;3;01;051;Entrecasteaux;1124;23;1147
93;Provence-Alpes-Côte d'Azur;83;3;13;052;Esparron;364;5;369
93;Provence-Alpes-Côte d'Azur;83;2;10;053;Évenos;2423;51;2474
93;Provence-Alpes-Côte d'Azur;83;2;18;054;La Farlède;9348;114;9462
93;Provence-Alpes-Côte d'Azur;83;1;11;055;Fayence;5765;86;5851
93;Provence-Alpes-Côte d'Azur;83;1;04;056;Figanières;2608;53;2661
93;Provence-Alpes-Côte d'Azur;83;3;09;057;Flassans-sur-Issole;3548;66;3614
93;Provence-Alpes-Côte d'Azur;83;1;04;058;Flayosc;4282;104;4386
93;Provence-Alpes-Côte d'Azur;83;3;07;059;Forcalqueiret;3061;48;3109
93;Provence-Alpes-Côte d'Azur;83;3;04;060;Fox-Amphoux;460;4;464
93;Provence-Alpes-Côte d'Azur;83;1;96;061;Fréjus;53786;837;54623
93;Provence-Alpes-Côte d'Azur;83;2;06;062;La Garde;25380;312;25692
93;Provence-Alpes-Côte d'Azur;83;1;09;063;La Garde-Freinet;1867;42;1909
93;Provence-Alpes-Côte d'Azur;83;3;07;064;Garéoult;5310;99;5409
93;Provence-Alpes-Côte d'Azur;83;1;15;065;Gassin;2586;54;2640
93;Provence-Alpes-Côte d'Azur;83;3;13;066;Ginasservis;1859;34;1893
93;Provence-Alpes-Côte d'Azur;83;3;09;067;Gonfaron;4324;59;4383
93;Provence-Alpes-Côte d'Azur;83;1;15;068;Grimaud;4553;60;4613
93;Provence-Alpes-Côte d'Azur;83;2;97;069;Hyères;55069;978;56047
93;Provence-Alpes-Côte d'Azur;83;2;02;070;Le Lavandou;5981;62;6043
93;Provence-Alpes-Côte d'Azur;83;2;02;071;La Londe-les-Maures;10389;133;10522
93;Provence-Alpes-Côte d'Azur;83;1;23;072;Lorgues;9001;288;9289
93;Provence-Alpes-Côte d'Azur;83;3;09;073;Le Luc;11008;111;11119
93;Provence-Alpes-Côte d'Azur;83;1;04;074;La Martre;212;5;217
93;Provence-Alpes-Côte d'Azur;83;3;09;075;Les Mayons;638;8;646
93;Provence-Alpes-Côte d'Azur;83;3;07;076;Mazaugues;878;13;891
93;Provence-Alpes-Côte d'Azur;83;3;07;077;Méounes-lès-Montrieux;2202;20;2222
93;Provence-Alpes-Côte d'Azur;83;3;04;078;Moissac-Bellevue;291;7;298
93;Provence-Alpes-Côte d'Azur;83;1;15;079;La Môle;1446;25;1471
93;Provence-Alpes-Côte d'Azur;83;1;11;080;Mons;811;15;826
93;Provence-Alpes-Côte d'Azur;83;1;11;081;Montauroux;6479;131;6610
93;Provence-Alpes-Côte d'Azur;83;1;04;082;Montferrat;1538;22;1560
93;Provence-Alpes-Côte d'Azur;83;3;01;083;Montfort-sur-Argens;1385;25;1410
93;Provence-Alpes-Côte d'Azur;83;3;04;084;Montmeyan;546;3;549
93;Provence-Alpes-Côte d'Azur;83;1;04;085;La Motte;2833;51;2884
93;Provence-Alpes-Côte d'Azur;83;1;23;086;Le Muy;9281;249;9530
93;Provence-Alpes-Côte d'Azur;83;3;12;087;Nans-les-Pins;4802;84;4886
93;Provence-Alpes-Côte d'Azur;83;3;07;088;Néoules;2770;66;2836
93;Provence-Alpes-Côte d'Azur;83;3;13;089;Ollières;647;22;669
93;Provence-Alpes-Côte d'Azur;83;2;10;090;Ollioules;13771;249;14020
93;Provence-Alpes-Côte d'Azur;83;2;07;091;Pierrefeu-du-Var;6065;104;6169
93;Provence-Alpes-Côte d'Azur;83;3;09;092;Pignans;4395;45;4440
93;Provence-Alpes-Côte d'Azur;83;3;12;093;Plan-d'Aups-Sainte-Baume;2174;26;2200
93;Provence-Alpes-Côte d'Azur;83;1;15;094;Le Plan-de-la-Tour;2937;50;2987
93;Provence-Alpes-Côte d'Azur;83;3;13;095;Pontevès;744;18;762
93;Provence-Alpes-Côte d'Azur;83;3;13;096;Pourcieux;1571;22;1593
93;Provence-Alpes-Côte d'Azur;83;3;13;097;Pourrières;5177;90;5267
93;Provence-Alpes-Côte d'Azur;83;2;06;098;Le Pradet;10265;147;10412
93;Provence-Alpes-Côte d'Azur;83;1;11;099;Puget-sur-Argens;8064;108;8172
93;Provence-Alpes-Côte d'Azur;83;3;07;100;Puget-Ville;4330;51;4381
93;Provence-Alpes-Côte d'Azur;83;1;15;101;Ramatuelle;2079;47;2126
93;Provence-Alpes-Côte d'Azur;83;1;02;152;Rayol-Canadel-sur-Mer;689;14;703
93;Provence-Alpes-Côte d'Azur;83;3;04;102;Régusse;2625;15;2640
93;Provence-Alpes-Côte d'Azur;83;2;21;103;Le Revest-les-Eaux;3914;58;3972
93;Provence-Alpes-Côte d'Azur;83;3;13;104;Rians;4255;84;4339
93;Provence-Alpes-Côte d'Azur;83;2;12;105;Riboux;48;0;48
93;Provence-Alpes-Côte d'Azur;83;3;07;106;Rocbaron;5142;66;5208
93;Provence-Alpes-Côte d'Azur;83;1;04;109;La Roque-Esclapon;259;0;259
93;Provence-Alpes-Côte d'Azur;83;1;11;107;Roquebrune-sur-Argens;14626;189;14815
93;Provence-Alpes-Côte d'Azur;83;3;07;108;La Roquebrussanne;2329;43;2372
93;Provence-Alpes-Côte d'Azur;83;3;01;110;Rougiers;1660;29;1689
93;Provence-Alpes-Côte d'Azur;83;1;01;154;Saint-Antonin-du-Var;737;14;751
93;Provence-Alpes-Côte d'Azur;83;2;12;112;Saint-Cyr-sur-Mer;11580;249;11829
93;Provence-Alpes-Côte d'Azur;83;3;13;113;Saint-Julien;2406;41;2447
93;Provence-Alpes-Côte d'Azur;83;2;17;153;Saint-Mandrier-sur-Mer;5979;69;6048
93;Provence-Alpes-Côte d'Azur;83;3;13;114;Saint-Martin-de-Pallières;245;4;249
93;Provence-Alpes-Côte d'Azur;83;3;13;116;Saint-Maximin-la-Sainte-Baume;16574;489;17063
93;Provence-Alpes-Côte d'Azur;83;1;11;117;Saint-Paul-en-Forêt;1743;41;1784
93;Provence-Alpes-Côte d'Azur;83;1;14;118;Saint-Raphaël;35633;598;36231
93;Provence-Alpes-Côte d'Azur;83;1;15;119;Saint-Tropez;4103;76;4179
93;Provence-Alpes-Côte d'Azur;83;3;12;120;Saint-Zacharie;5993;82;6075
93;Provence-Alpes-Côte d'Azur;83;3;07;111;Sainte-Anastasie-sur-Issole;2023;25;2048
93;Provence-Alpes-Côte d'Azur;83;1;15;115;Sainte-Maxime;14240;217;14457
93;Provence-Alpes-Côte d'Azur;83;1;04;121;Salernes;3800;78;3878
93;Provence-Alpes-Côte d'Azur;83;3;04;122;Les Salles-sur-Verdon;236;4;240
93;Provence-Alpes-Côte d'Azur;83;2;10;123;Sanary-sur-Mer;16696;264;16960
93;Provence-Alpes-Côte d'Azur;83;1;11;124;Seillans;2671;33;2704
93;Provence-Alpes-Côte d'Azur;83;3;13;125;Seillons-Source-d'Argens;2502;38;2540
93;Provence-Alpes-Côte d'Azur;83;2;98;126;La Seyne-sur-Mer;62888;766;63654
93;Provence-Alpes-Côte d'Azur;83;2;12;127;Signes;2892;44;2936
93;Provence-Alpes-Côte d'Azur;83;1;04;128;Sillans-la-Cascade;753;55;808
93;Provence-Alpes-Côte d'Azur;83;2;17;129;Six-Fours-les-Plages;33665;550;34215
93;Provence-Alpes-Côte d'Azur;83;2;18;130;Solliès-Pont;11496;177;11673
93;Provence-Alpes-Côte d'Azur;83;2;18;131;Solliès-Toucas;5696;107;5803
93;Provence-Alpes-Côte d'Azur;83;2;18;132;Solliès-Ville;2488;45;2533
93;Provence-Alpes-Côte d'Azur;83;1;11;133;Tanneron;1666;33;1699
93;Provence-Alpes-Côte d'Azur;83;1;23;134;Taradeau;1802;33;1835
93;Provence-Alpes-Côte d'Azur;83;3;04;135;Tavernes;1402;16;1418
93;Provence-Alpes-Côte d'Azur;83;3;09;136;Le Thoronet;2507;45;2552
93;Provence-Alpes-Côte d'Azur;83;2;99;137;Toulon;176198;1867;178065
93;Provence-Alpes-Côte d'Azur;83;1;11;138;Tourrettes;2871;50;2921
93;Provence-Alpes-Côte d'Azur;83;3;04;139;Tourtour;583;15;598
93;Provence-Alpes-Côte d'Azur;83;3;01;140;Tourves;5056;71;5127
93;Provence-Alpes-Côte d'Azur;83;1;03;141;Trans-en-Provence;5878;132;6010
93;Provence-Alpes-Côte d'Azur;83;1;04;142;Trigance;200;4;204
93;Provence-Alpes-Côte d'Azur;83;3;01;143;Le Val;4293;95;4388
93;Provence-Alpes-Côte d'Azur;83;2;21;144;La Valette-du-Var;23795;259;24054
93;Provence-Alpes-Côte d'Azur;83;3;13;145;Varages;1184;15;1199
93;Provence-Alpes-Côte d'Azur;83;3;13;146;La Verdière;1608;13;1621
93;Provence-Alpes-Côte d'Azur;83;3;04;147;Vérignon;9;0;9
93;Provence-Alpes-Côte d'Azur;83;1;23;148;Vidauban;12176;141;12317
93;Provence-Alpes-Côte d'Azur;83;3;04;149;Villecroze;1466;28;1494
93;Provence-Alpes-Côte d'Azur;83;3;13;150;Vinon-sur-Verdon;4242;88;4330
93;Provence-Alpes-Côte d'Azur;83;3;01;151;Vins-sur-Caramy;988;16;1004
93;Provence-Alpes-Côte d'Azur;84;3;10;001;Althen-des-Paluds;2860;46;2906
93;Provence-Alpes-Côte d'Azur;84;1;13;002;Ansouis;1035;25;1060
93;Provence-Alpes-Côte d'Azur;84;1;01;003;Apt;11011;221;11232
93;Provence-Alpes-Côte d'Azur;84;3;06;004;Aubignan;5719;93;5812
93;Provence-Alpes-Côte d'Azur;84;3;12;005;Aurel;199;2;201
93;Provence-Alpes-Côte d'Azur;84;1;01;006;Auribeau;70;4;74
93;Provence-Alpes-Côte d'Azur;84;2;99;007;Avignon;91729;1705;93434
93;Provence-Alpes-Côte d'Azur;84;3;16;008;Le Barroux;638;50;688
93;Provence-Alpes-Côte d'Azur;84;1;13;009;La Bastide-des-Jourdans;1579;94;1673
93;Provence-Alpes-Côte d'Azur;84;1;13;010;La Bastidonne;855;22;877
93;Provence-Alpes-Côte d'Azur;84;3;12;011;Le Beaucet;353;9;362
93;Provence-Alpes-Côte d'Azur;84;3;10;012;Beaumes-de-Venise;2398;48;2446
93;Provence-Alpes-Côte d'Azur;84;1;01;013;Beaumettes;267;4;271
93;Provence-Alpes-Côte d'Azur;84;1;13;014;Beaumont-de-Pertuis;1136;16;1152
93;Provence-Alpes-Côte d'Azur;84;3;16;015;Beaumont-du-Ventoux;288;5;293
93;Provence-Alpes-Côte d'Azur;84;2;15;016;Bédarrides;5244;75;5319
93;Provence-Alpes-Côte d'Azur;84;3;12;017;Bédoin;3096;68;3164
93;Provence-Alpes-Côte d'Azur;84;3;12;018;Blauvac;501;8;509
93;Provence-Alpes-Côte d'Azur;84;3;05;019;Bollène;13509;231;13740
93;Provence-Alpes-Côte d'Azur;84;1;01;020;Bonnieux;1260;24;1284
93;Provence-Alpes-Côte d'Azur;84;3;16;021;Brantes;88;3;91
93;Provence-Alpes-Côte d'Azur;84;3;16;022;Buisson;288;13;301
93;Provence-Alpes-Côte d'Azur;84;1;01;023;Buoux;77;2;79
93;Provence-Alpes-Côte d'Azur;84;1;13;024;Cabrières-d'Aigues;956;14;970
93;Provence-Alpes-Côte d'Azur;84;1;08;025;Cabrières-d'Avignon;1833;37;1870
93;Provence-Alpes-Côte d'Azur;84;1;08;026;Cadenet;4192;77;4269
93;Provence-Alpes-Côte d'Azur;84;3;11;027;Caderousse;2661;47;2708
93;Provence-Alpes-Côte d'Azur;84;3;16;028;Cairanne;1078;20;1098
93;Provence-Alpes-Côte d'Azur;84;3;16;029;Camaret-sur-Aigues;4533;111;4644
93;Provence-Alpes-Côte d'Azur;84;3;10;030;Caromb;3370;57;3427
93;Provence-Alpes-Côte d'Azur;84;3;06;031;Carpentras;28798;766;29564
93;Provence-Alpes-Côte d'Azur;84;1;01;032;Caseneuve;493;8;501
93;Provence-Alpes-Côte d'Azur;84;1;01;033;Castellet-en-Luberon;125;0;125
93;Provence-Alpes-Côte d'Azur;84;2;07;034;Caumont-sur-Durance;4899;99;4998
93;Provence-Alpes-Côte d'Azur;84;1;07;035;Cavaillon;26198;413;26611
93;Provence-Alpes-Côte d'Azur;84;2;09;036;Châteauneuf-de-Gadagne;3328;74;3402
93;Provence-Alpes-Côte d'Azur;84;3;15;037;Châteauneuf-du-Pape;2062;30;2092
93;Provence-Alpes-Côte d'Azur;84;1;08;038;Cheval-Blanc;4295;74;4369
93;Provence-Alpes-Côte d'Azur;84;2;15;039;Courthézon;5723;72;5795
93;Provence-Alpes-Côte d'Azur;84;3;16;040;Crestet;414;16;430
93;Provence-Alpes-Côte d'Azur;84;3;12;041;Crillon-le-Brave;472;20;492
93;Provence-Alpes-Côte d'Azur;84;1;08;042;Cucuron;1759;32;1791
93;Provence-Alpes-Côte d'Azur;84;2;10;043;Entraigues-sur-la-Sorgue;8534;122;8656
93;Provence-Alpes-Côte d'Azur;84;3;16;044;Entrechaux;1128;32;1160
93;Provence-Alpes-Côte d'Azur;84;3;16;045;Faucon;437;8;445
93;Provence-Alpes-Côte d'Azur;84;3;12;046;Flassan;474;14;488
93;Provence-Alpes-Côte d'Azur;84;2;09;139;Fontaine-de-Vaucluse;585;16;601
93;Provence-Alpes-Côte d'Azur;84;1;01;047;Gargas;3061;49;3110
93;Provence-Alpes-Côte d'Azur;84;1;01;048;Gignac;69;1;70
93;Provence-Alpes-Côte d'Azur;84;3;16;049;Gigondas;467;11;478
93;Provence-Alpes-Côte d'Azur;84;1;01;050;Gordes;1672;34;1706
93;Provence-Alpes-Côte d'Azur;84;1;01;051;Goult;1097;27;1124
93;Provence-Alpes-Côte d'Azur;84;1;13;052;Grambois;1239;29;1268
93;Provence-Alpes-Côte d'Azur;84;3;17;053;Grillon;1742;31;1773
93;Provence-Alpes-Côte d'Azur;84;2;09;054;L' Isle-sur-la-Sorgue;19706;473;20179
93;Provence-Alpes-Côte d'Azur;84;2;14;055;Jonquerettes;1528;37;1565
93;Provence-Alpes-Côte d'Azur;84;3;15;056;Jonquières;5436;63;5499
93;Provence-Alpes-Côte d'Azur;84;1;01;057;Joucas;340;5;345
93;Provence-Alpes-Côte d'Azur;84;1;01;058;Lacoste;410;7;417
93;Provence-Alpes-Côte d'Azur;84;3;16;059;Lafare;119;1;120
93;Provence-Alpes-Côte d'Azur;84;1;01;060;Lagarde-d'Apt;34;1;35
93;Provence-Alpes-Côte d'Azur;84;3;05;061;Lagarde-Paréol;328;13;341
93;Provence-Alpes-Côte d'Azur;84;1;08;062;Lagnes;1645;33;1678
93;Provence-Alpes-Côte d'Azur;84;3;05;063;Lamotte-du-Rhône;396;1;397
93;Provence-Alpes-Côte d'Azur;84;3;05;064;Lapalud;3817;78;3895
93;Provence-Alpes-Côte d'Azur;84;1;08;065;Lauris;3867;69;3936
93;Provence-Alpes-Côte d'Azur;84;1;01;066;Lioux;290;4;294
93;Provence-Alpes-Côte d'Azur;84;3;06;067;Loriol-du-Comtat;2551;55;2606
93;Provence-Alpes-Côte d'Azur;84;1;08;068;Lourmarin;1043;22;1065
93;Provence-Alpes-Côte d'Azur;84;3;16;069;Malaucène;2834;61;2895
93;Provence-Alpes-Côte d'Azur;84;3;12;070;Malemort-du-Comtat;1827;23;1850
93;Provence-Alpes-Côte d'Azur;84;1;08;071;Maubec;1933;48;1981
93;Provence-Alpes-Côte d'Azur;84;3;12;072;Mazan;6127;156;6283
93;Provence-Alpes-Côte d'Azur;84;1;01;073;Ménerbes;1000;17;1017
93;Provence-Alpes-Côte d'Azur;84;1;08;074;Mérindol;2147;37;2184
93;Provence-Alpes-Côte d'Azur;84;3;12;075;Méthamis;439;8;447
93;Provence-Alpes-Côte d'Azur;84;1;13;076;Mirabeau;1324;39;1363
93;Provence-Alpes-Côte d'Azur;84;3;12;077;Modène;457;7;464
93;Provence-Alpes-Côte d'Azur;84;3;05;078;Mondragon;3754;63;3817
93;Provence-Alpes-Côte d'Azur;84;3;12;079;Monieux;289;5;294
93;Provence-Alpes-Côte d'Azur;84;3;10;080;Monteux;12875;219;13094
93;Provence-Alpes-Côte d'Azur;84;2;04;081;Morières-lès-Avignon;8563;127;8690
93;Provence-Alpes-Côte d'Azur;84;3;12;082;Mormoiron;1864;49;1913
93;Provence-Alpes-Côte d'Azur;84;3;05;083;Mornas;2420;47;2467
93;Provence-Alpes-Côte d'Azur;84;1;13;084;La Motte-d'Aigues;1359;41;1400
93;Provence-Alpes-Côte d'Azur;84;1;01;085;Murs;414;6;420
93;Provence-Alpes-Côte d'Azur;84;1;01;086;Oppède;1304;27;1331
93;Provence-Alpes-Côte d'Azur;84;3;11;087;Orange;28922;665;29587
93;Provence-Alpes-Côte d'Azur;84;3;12;088;Pernes-les-Fontaines;9975;284;10259
93;Provence-Alpes-Côte d'Azur;84;1;13;089;Pertuis;20397;307;20704
93;Provence-Alpes-Côte d'Azur;84;1;13;090;Peypin-d'Aigues;674;15;689
93;Provence-Alpes-Côte d'Azur;84;3;11;091;Piolenc;5324;94;5418
93;Provence-Alpes-Côte d'Azur;84;2;14;092;Le Pontet;17273;141;17414
93;Provence-Alpes-Côte d'Azur;84;1;08;093;Puget;785;20;805
93;Provence-Alpes-Côte d'Azur;84;3;16;094;Puyméras;587;12;599
93;Provence-Alpes-Côte d'Azur;84;1;08;095;Puyvert;817;14;831
93;Provence-Alpes-Côte d'Azur;84;3;16;096;Rasteau;824;21;845
93;Provence-Alpes-Côte d'Azur;84;3;17;097;Richerenches;578;82;660
93;Provence-Alpes-Côte d'Azur;84;3;16;098;Roaix;638;9;647
93;Provence-Alpes-Côte d'Azur;84;1;08;099;Robion;4587;74;4661
93;Provence-Alpes-Côte d'Azur;84;3;16;100;La Roque-Alric;52;0;52
93;Provence-Alpes-Côte d'Azur;84;3;12;101;La Roque-sur-Pernes;416;13;429
93;Provence-Alpes-Côte d'Azur;84;1;01;102;Roussillon;1303;31;1334
93;Provence-Alpes-Côte d'Azur;84;1;01;103;Rustrel;675;20;695
93;Provence-Alpes-Côte d'Azur;84;3;16;104;Sablet;1316;31;1347
93;Provence-Alpes-Côte d'Azur;84;1;01;105;Saignon;955;22;977
93;Provence-Alpes-Côte d'Azur;84;3;12;107;Saint-Christol;1373;20;1393
93;Provence-Alpes-Côte d'Azur;84;3;12;108;Saint-Didier;2006;41;2047
93;Provence-Alpes-Côte d'Azur;84;3;10;109;Saint-Hippolyte-le-Graveyron;172;9;181
93;Provence-Alpes-Côte d'Azur;84;3;16;110;Saint-Léger-du-Ventoux;33;0;33
93;Provence-Alpes-Côte d'Azur;84;3;16;111;Saint-Marcellin-lès-Vaison;320;10;330
93;Provence-Alpes-Côte d'Azur;84;1;01;112;Saint-Martin-de-Castillon;755;7;762
93;Provence-Alpes-Côte d'Azur;84;1;13;113;Saint-Martin-de-la-Brasque;832;17;849
93;Provence-Alpes-Côte d'Azur;84;1;01;114;Saint-Pantaléon;189;3;192
93;Provence-Alpes-Côte d'Azur;84;3;12;115;Saint-Pierre-de-Vassols;517;12;529
93;Provence-Alpes-Côte d'Azur;84;3;16;116;Saint-Romain-en-Viennois;788;21;809
93;Provence-Alpes-Côte d'Azur;84;3;16;117;Saint-Roman-de-Malegarde;328;7;335
93;Provence-Alpes-Côte d'Azur;84;1;01;118;Saint-Saturnin-lès-Apt;2844;70;2914
93;Provence-Alpes-Côte d'Azur;84;2;14;119;Saint-Saturnin-lès-Avignon;4857;111;4968
93;Provence-Alpes-Côte d'Azur;84;3;12;120;Saint-Trinit;119;1;120
93;Provence-Alpes-Côte d'Azur;84;3;05;106;Sainte-Cécile-les-Vignes;2548;52;2600
93;Provence-Alpes-Côte d'Azur;84;1;13;121;Sannes;253;0;253
93;Provence-Alpes-Côte d'Azur;84;3;10;122;Sarrians;6088;77;6165
93;Provence-Alpes-Côte d'Azur;84;3;12;123;Sault;1373;23;1396
93;Provence-Alpes-Côte d'Azur;84;2;09;124;Saumane-de-Vaucluse;949;16;965
93;Provence-Alpes-Côte d'Azur;84;3;16;125;Savoillan;62;0;62
93;Provence-Alpes-Côte d'Azur;84;3;16;126;Séguret;848;23;871
93;Provence-Alpes-Côte d'Azur;84;3;05;127;Sérignan-du-Comtat;2764;79;2843
93;Provence-Alpes-Côte d'Azur;84;1;01;128;Sivergues;45;1;46
93;Provence-Alpes-Côte d'Azur;84;2;15;129;Sorgues;18802;233;19035
93;Provence-Alpes-Côte d'Azur;84;3;16;130;Suzette;115;3;118
93;Provence-Alpes-Côte d'Azur;84;1;08;131;Taillades;1923;40;1963
93;Provence-Alpes-Côte d'Azur;84;2;09;132;Le Thor;8996;178;9174
93;Provence-Alpes-Côte d'Azur;84;1;13;133;La Tour-d'Aigues;4333;138;4471
93;Provence-Alpes-Côte d'Azur;84;3;16;134;Travaillan;717;13;730
93;Provence-Alpes-Côte d'Azur;84;3;05;135;Uchaux;1657;51;1708
93;Provence-Alpes-Côte d'Azur;84;3;16;136;Vacqueyras;1274;31;1305
93;Provence-Alpes-Côte d'Azur;84;3;16;137;Vaison-la-Romaine;5953;129;6082
93;Provence-Alpes-Côte d'Azur;84;3;17;138;Valréas;9426;229;9655
93;Provence-Alpes-Côte d'Azur;84;1;08;140;Vaugines;563;19;582
93;Provence-Alpes-Côte d'Azur;84;2;14;141;Vedène;11131;365;11496
93;Provence-Alpes-Côte d'Azur;84;2;14;142;Velleron;2967;54;3021
93;Provence-Alpes-Côte d'Azur;84;3;12;143;Venasque;1011;18;1029
93;Provence-Alpes-Côte d'Azur;84;1;01;144;Viens;639;18;657
93;Provence-Alpes-Côte d'Azur;84;1;01;145;Villars;778;14;792
93;Provence-Alpes-Côte d'Azur;84;3;16;146;Villedieu;491;14;505
93;Provence-Alpes-Côte d'Azur;84;1;13;147;Villelaure;3416;88;3504
93;Provence-Alpes-Côte d'Azur;84;3;12;148;Villes-sur-Auzon;1282;34;1316
93;Provence-Alpes-Côte d'Azur;84;3;16;149;Violès;1697;32;1729
93;Provence-Alpes-Côte d'Azur;84;3;17;150;Visan;1963;57;2020
93;Provence-Alpes-Côte d'Azur;84;1;13;151;Vitrolles-en-Lubéron;164;5;169
52;Pays de la Loire;85;3;17;152;Achards ;5189;108;5297
52;Pays de la Loire;85;1;09;001;L' Aiguillon-sur-Mer;2062;35;2097
52;Pays de la Loire;85;3;15;002;L' Aiguillon-sur-Vie;1987;23;2010
52;Pays de la Loire;85;2;01;003;Aizenay;9694;194;9888
52;Pays de la Loire;85;3;09;004;Angles;2847;34;2881
52;Pays de la Loire;85;1;04;005;Antigny;1052;20;1072
52;Pays de la Loire;85;2;02;006;Apremont;1833;13;1846
52;Pays de la Loire;85;2;13;008;Aubigny-Les Clouzeaux;6712;101;6813
52;Pays de la Loire;85;1;05;009;Auchay-sur-Vendée ;1143;23;1166
52;Pays de la Loire;85;3;17;010;Avrillé;1421;20;1441
52;Pays de la Loire;85;3;16;011;Barbâtre;1725;52;1777
52;Pays de la Loire;85;3;16;012;La Barre-de-Monts;2201;48;2249
52;Pays de la Loire;85;2;10;013;Bazoges-en-Paillers;1440;27;1467
52;Pays de la Loire;85;1;04;014;Bazoges-en-Pareds;1149;27;1176
52;Pays de la Loire;85;2;01;015;Beaufou;1511;21;1532
52;Pays de la Loire;85;3;17;016;Beaulieu-sous-la-Roche;2225;30;2255
52;Pays de la Loire;85;2;11;017;Beaurepaire;2425;49;2474
52;Pays de la Loire;85;3;16;018;Beauvoir-sur-Mer;3883;60;3943
52;Pays de la Loire;85;2;01;019;Bellevigny;6079;123;6202
52;Pays de la Loire;85;1;05;020;Benet;3992;74;4066
52;Pays de la Loire;85;3;17;022;Le Bernard;1227;18;1245
52;Pays de la Loire;85;2;11;021;La Bernardière;1835;34;1869
52;Pays de la Loire;85;1;09;023;Bessay;433;9;442
52;Pays de la Loire;85;3;02;024;Bois-de-Céné;2024;34;2058
52;Pays de la Loire;85;2;10;025;La Boissière-de-Montaigu;2258;51;2309
52;Pays de la Loire;85;3;09;026;La Boissière-des-Landes;1403;18;1421
52;Pays de la Loire;85;1;05;028;Bouillé-Courdault;598;8;606
52;Pays de la Loire;85;3;16;029;Bouin;2157;36;2193
52;Pays de la Loire;85;1;03;031;Le Boupère;3168;42;3210
52;Pays de la Loire;85;1;04;033;Bourneau;728;19;747
52;Pays de la Loire;85;2;03;034;Bournezeau;3386;100;3486
52;Pays de la Loire;85;3;15;243;Brem-sur-Mer;2780;49;2829
52;Pays de la Loire;85;3;15;035;Bretignolles-sur-Mer;4868;85;4953
52;Pays de la Loire;85;1;09;036;La Bretonnière-la-Claye;580;11;591
52;Pays de la Loire;85;1;04;037;Breuil-Barret;610;17;627
52;Pays de la Loire;85;2;10;038;Les Brouzils;2808;43;2851
52;Pays de la Loire;85;2;11;039;La Bruffière;3972;60;4032
52;Pays de la Loire;85;1;04;040;La Caillère-Saint-Hilaire;1118;24;1142
52;Pays de la Loire;85;1;04;041;Cezais;296;12;308
52;Pays de la Loire;85;1;08;042;Chaillé-les-Marais;1884;24;1908
52;Pays de la Loire;85;3;15;045;La Chaize-Giraud;1076;14;1090
52;Pays de la Loire;85;2;13;046;La Chaize-le-Vicomte;3785;58;3843
52;Pays de la Loire;85;3;02;047;Challans;20898;764;21662
52;Pays de la Loire;85;3;09;050;Le Champ-Saint-Père;1836;22;1858
52;Pays de la Loire;85;1;08;049;Champagné-les-Marais;1782;16;1798
52;Pays de la Loire;85;2;03;051;Chantonnay;8354;451;8805
52;Pays de la Loire;85;2;11;302;Chanverrie ;5489;131;5620
52;Pays de la Loire;85;1;04;053;La Chapelle-aux-Lys;256;3;259
52;Pays de la Loire;85;3;17;054;La Chapelle-Hermier;902;7;909
52;Pays de la Loire;85;2;02;055;La Chapelle-Palluau;945;18;963
52;Pays de la Loire;85;1;04;056;La Chapelle-Thémer;388;9;397
52;Pays de la Loire;85;1;08;058;Chasnais;729;20;749
52;Pays de la Loire;85;1;04;059;La Châtaigneraie;2565;36;2601
52;Pays de la Loire;85;1;09;061;Château-Guibert;1505;32;1537
52;Pays de la Loire;85;3;02;062;Châteauneuf;1085;20;1105
52;Pays de la Loire;85;2;10;064;Chauché;2456;33;2489
52;Pays de la Loire;85;2;10;065;Chavagnes-en-Paillers;3529;100;3629
52;Pays de la Loire;85;1;06;066;Chavagnes-les-Redoux;824;17;841
52;Pays de la Loire;85;1;04;067;Cheffois;985;21;1006
52;Pays de la Loire;85;3;15;070;Coëx;3230;37;3267
52;Pays de la Loire;85;3;15;071;Commequiers;3554;56;3610
52;Pays de la Loire;85;2;10;072;La Copechagnière;1012;11;1023
52;Pays de la Loire;85;1;09;073;Corpe;1012;16;1028
52;Pays de la Loire;85;1;09;074;La Couture;220;3;223
52;Pays de la Loire;85;2;11;076;Cugand;3531;89;3620
52;Pays de la Loire;85;3;09;077;Curzon;526;7;533
52;Pays de la Loire;85;1;05;078;Damvix;745;17;762
52;Pays de la Loire;85;1;05;080;Doix lès Fontaines;1723;33;1756
52;Pays de la Loire;85;2;12;081;Dompierre-sur-Yon;4294;112;4406
52;Pays de la Loire;85;2;06;082;Les Epesses;2873;56;2929
52;Pays de la Loire;85;3;16;083;L' Épine;1633;40;1673
52;Pays de la Loire;85;2;03;084;Essarts en Bocage;9053;164;9217
52;Pays de la Loire;85;2;02;086;Falleron;1617;15;1632
52;Pays de la Loire;85;3;09;307;La Faute-sur-Mer;664;8;672
52;Pays de la Loire;85;1;05;087;Faymoreau;200;4;204
52;Pays de la Loire;85;3;15;088;Le Fenouiller;4796;132;4928
52;Pays de la Loire;85;2;03;089;La Ferrière;5285;154;5439
52;Pays de la Loire;85;1;05;092;Fontenay-le-Comte;13302;695;13997
52;Pays de la Loire;85;2;03;093;Fougeré;1215;22;1237
52;Pays de la Loire;85;1;05;094;Foussais-Payré;1147;30;1177
52;Pays de la Loire;85;3;02;095;Froidfond;1903;20;1923
52;Pays de la Loire;85;3;02;096;La Garnache;5075;99;5174
52;Pays de la Loire;85;2;11;097;La Gaubretière;3085;66;3151
52;Pays de la Loire;85;2;01;098;La Genétouze;1956;37;1993
52;Pays de la Loire;85;3;17;099;Le Girouard;1073;22;1095
52;Pays de la Loire;85;3;15;100;Givrand;2223;52;2275
52;Pays de la Loire;85;3;09;101;Le Givre;499;5;504
52;Pays de la Loire;85;2;02;102;Grand'Landes;681;9;690
52;Pays de la Loire;85;3;17;103;Grosbreuil;2210;31;2241
52;Pays de la Loire;85;1;08;104;Grues;873;11;884
52;Pays de la Loire;85;1;08;105;Le Gué-de-Velluire;536;13;549
52;Pays de la Loire;85;3;16;106;La Guérinière;1333;35;1368
52;Pays de la Loire;85;2;01;108;L' Herbergement;3204;108;3312
52;Pays de la Loire;85;2;06;109;Les Herbiers;16135;481;16616
52;Pays de la Loire;85;1;04;110;L' Hermenault;915;14;929
52;Pays de la Loire;85;1;08;111;L' Île-d'Elle;1507;23;1530
52;Pays de la Loire;85;3;17;112;L' Île-d'Olonne;2739;58;2797
52;Pays de la Loire;85;3;07;113;L' Île-d'Yeu;4829;138;4967
52;Pays de la Loire;85;3;17;114;Jard-sur-Mer;2664;31;2695
52;Pays de la Loire;85;1;04;115;La Jaudonnière;602;11;613
52;Pays de la Loire;85;3;09;116;La Jonchère;460;6;466
52;Pays de la Loire;85;1;08;117;Lairoux;620;19;639
52;Pays de la Loire;85;2;12;118;Landeronde;2335;50;2385
52;Pays de la Loire;85;2;11;119;Les Landes-Genusson;2407;42;2449
52;Pays de la Loire;85;3;15;120;Landevieille;1419;36;1455
52;Pays de la Loire;85;1;05;121;Le Langon;1011;32;1043
52;Pays de la Loire;85;1;05;123;Liez;278;4;282
52;Pays de la Loire;85;1;04;125;Loge-Fougereuse;398;4;402
52;Pays de la Loire;85;1;05;126;Longèves;1337;49;1386
52;Pays de la Loire;85;3;17;127;Longeville-sur-Mer;2435;26;2461
52;Pays de la Loire;85;2;01;129;Les Lucs-sur-Boulogne;3498;72;3570
52;Pays de la Loire;85;1;08;128;Luçon;9576;386;9962
52;Pays de la Loire;85;2;02;130;Maché;1564;19;1583
52;Pays de la Loire;85;1;08;131;Les Magnils-Reigniers;1531;41;1572
52;Pays de la Loire;85;1;05;132;Maillé;754;13;767
52;Pays de la Loire;85;1;05;133;Maillezais;929;23;952
52;Pays de la Loire;85;2;11;134;Mallièvre;247;10;257
52;Pays de la Loire;85;1;09;135;Mareuil-sur-Lay-Dissais;2803;123;2926
52;Pays de la Loire;85;1;04;136;Marillet;119;1;120
52;Pays de la Loire;85;1;04;137;Marsais-Sainte-Radégonde;482;14;496
52;Pays de la Loire;85;3;17;138;Martinet;1154;12;1166
52;Pays de la Loire;85;1;05;139;Le Mazeau;447;14;461
52;Pays de la Loire;85;1;06;140;La Meilleraie-Tillay;1498;43;1541
52;Pays de la Loire;85;1;04;141;Menomblet;665;12;677
52;Pays de la Loire;85;2;03;142;La Merlatière;1006;23;1029
52;Pays de la Loire;85;1;05;143;Mervent;1044;20;1064
52;Pays de la Loire;85;2;10;144;Mesnard-la-Barotière;1472;26;1498
52;Pays de la Loire;85;1;06;145;Monsireigne;964;17;981
52;Pays de la Loire;85;2;10;146;Montaigu-Vendée ;20229;625;20854
52;Pays de la Loire;85;1;06;147;Montournais;1651;50;1701
52;Pays de la Loire;85;1;05;148;Montreuil;806;22;828
52;Pays de la Loire;85;2;01;197;Montréverd;3732;57;3789
52;Pays de la Loire;85;1;08;149;Moreilles;416;5;421
52;Pays de la Loire;85;2;11;151;Mortagne-sur-Sèvre;6000;166;6166
52;Pays de la Loire;85;2;06;153;Mouchamps;2901;45;2946
52;Pays de la Loire;85;2;12;155;Mouilleron-le-Captif;4946;123;5069
52;Pays de la Loire;85;1;04;154;Mouilleron-Saint-Germain;1825;94;1919
52;Pays de la Loire;85;3;09;156;Moutiers-les-Mauxfaits;2159;33;2192
52;Pays de la Loire;85;1;09;157;Moutiers-sur-le-Lay;757;12;769
52;Pays de la Loire;85;1;08;158;Mouzeuil-Saint-Martin;1200;27;1227
52;Pays de la Loire;85;1;08;159;Nalliers;2306;47;2353
52;Pays de la Loire;85;2;13;160;Nesmy;2899;44;2943
52;Pays de la Loire;85;3;17;161;Nieul-le-Dolent;2495;25;2520
52;Pays de la Loire;85;3;16;163;Noirmoutier-en-l'Île;4614;107;4721
52;Pays de la Loire;85;3;16;164;Notre-Dame-de-Monts;2143;47;2190
52;Pays de la Loire;85;3;16;189;Notre-Dame-de-Riez;2128;43;2171
52;Pays de la Loire;85;1;05;167;L' Orbrie;793;18;811
52;Pays de la Loire;85;2;02;169;Palluau;1106;16;1122
52;Pays de la Loire;85;1;09;171;Péault;609;23;632
52;Pays de la Loire;85;3;16;172;Le Perrier;2043;33;2076
52;Pays de la Loire;85;1;04;174;Petosse;697;18;715
52;Pays de la Loire;85;1;09;175;Les Pineaux;651;3;654
52;Pays de la Loire;85;1;05;176;Pissotte;1160;36;1196
52;Pays de la Loire;85;2;01;178;Le Poiré-sur-Vie;8530;218;8748
52;Pays de la Loire;85;3;17;179;Poiroux;1124;10;1134
52;Pays de la Loire;85;1;08;181;Pouillé;636;17;653
52;Pays de la Loire;85;1;06;182;Pouzauges;5549;204;5753
52;Pays de la Loire;85;1;05;184;Puy-de-Serre;317;7;324
52;Pays de la Loire;85;1;08;185;Puyravault;663;6;669
52;Pays de la Loire;85;2;10;186;La Rabatelière;995;15;1010
52;Pays de la Loire;85;1;06;187;Réaumur;863;15;878
52;Pays de la Loire;85;1;04;188;La Réorthe;1099;22;1121
52;Pays de la Loire;85;1;05;162;Rives-d'Autise ;2104;51;2155
52;Pays de la Loire;85;2;09;213;Rives de l'Yon;4180;170;4350
52;Pays de la Loire;85;2;99;191;La Roche-sur-Yon;54766;2951;57717
52;Pays de la Loire;85;2;01;190;Rocheservière;3350;46;3396
52;Pays de la Loire;85;2;03;192;Rochetrejoux;969;9;978
52;Pays de la Loire;85;1;09;193;Rosnay;639;17;656
52;Pays de la Loire;85;3;14;194;Sables-d'Olonne ;44355;1418;45773
52;Pays de la Loire;85;2;10;196;Saint-André-Goule-d'Oie;1844;16;1860
52;Pays de la Loire;85;2;11;198;Saint-Aubin-des-Ormeaux;1330;18;1348
52;Pays de la Loire;85;1;04;199;Saint-Aubin-la-Plaine;540;6;546
52;Pays de la Loire;85;3;09;200;Saint-Avaugourd-des-Landes;1075;21;1096
52;Pays de la Loire;85;3;09;201;Saint-Benoist-sur-Mer;487;6;493
52;Pays de la Loire;85;3;02;204;Saint-Christophe-du-Ligneron;2570;43;2613
52;Pays de la Loire;85;1;04;205;Saint-Cyr-des-Gâts;531;8;539
52;Pays de la Loire;85;3;09;206;Saint-Cyr-en-Talmondais;387;13;400
52;Pays de la Loire;85;1;08;207;Saint-Denis-du-Payré;385;8;393
52;Pays de la Loire;85;2;01;208;Saint-Denis-la-Chevasse;2349;37;2386
52;Pays de la Loire;85;1;04;209;Saint-Étienne-de-Brillouet;625;9;634
52;Pays de la Loire;85;2;02;210;Saint-Étienne-du-Bois;2118;25;2143
52;Pays de la Loire;85;2;10;215;Saint-Fulgent;3803;135;3938
52;Pays de la Loire;85;3;17;218;Saint-Georges-de-Pointindoux;1670;15;1685
52;Pays de la Loire;85;2;03;220;Saint-Germain-de-Prinçay;1566;27;1593
52;Pays de la Loire;85;3;16;221;Saint-Gervais;2685;36;2721
52;Pays de la Loire;85;3;15;222;Saint-Gilles-Croix-de-Vie;7759;236;7995
52;Pays de la Loire;85;3;15;226;Saint-Hilaire-de-Riez;11179;199;11378
52;Pays de la Loire;85;1;04;229;Saint-Hilaire-de-Voust;590;12;602
52;Pays de la Loire;85;1;05;227;Saint-Hilaire-des-Loges;1936;52;1988
52;Pays de la Loire;85;3;17;231;Saint-Hilaire-la-Forêt;788;15;803
52;Pays de la Loire;85;2;03;232;Saint-Hilaire-le-Vouhis;1069;23;1092
52;Pays de la Loire;85;1;04;233;Saint-Jean-de-Beugné;603;9;612
52;Pays de la Loire;85;3;16;234;Saint-Jean-de-Monts;8668;223;8891
52;Pays de la Loire;85;1;04;235;Saint-Juire-Champgillon;415;12;427
52;Pays de la Loire;85;3;17;236;Saint-Julien-des-Landes;1834;21;1855
52;Pays de la Loire;85;1;04;237;Saint-Laurent-de-la-Salle;367;12;379
52;Pays de la Loire;85;2;11;238;Saint-Laurent-sur-Sèvre;3620;440;4060
52;Pays de la Loire;85;3;15;239;Saint-Maixent-sur-Vie;1101;5;1106
52;Pays de la Loire;85;2;11;240;Saint-Malô-du-Bois;1610;49;1659
52;Pays de la Loire;85;2;06;242;Saint-Mars-la-Réorthe;988;20;1008
52;Pays de la Loire;85;1;05;244;Saint-Martin-de-Fraigneau;813;58;871
52;Pays de la Loire;85;1;04;245;Saint-Martin-des-Fontaines;171;2;173
52;Pays de la Loire;85;2;03;246;Saint-Martin-des-Noyers;2427;38;2465
52;Pays de la Loire;85;2;11;247;Saint-Martin-des-Tilleuls;1075;18;1093
52;Pays de la Loire;85;1;04;248;Saint-Martin-Lars-en-Sainte-Hermine;412;12;424
52;Pays de la Loire;85;3;17;250;Saint-Mathurin;2294;35;2329
52;Pays de la Loire;85;1;04;251;Saint-Maurice-des-Noues;641;18;659
52;Pays de la Loire;85;1;04;252;Saint-Maurice-le-Girard;592;24;616
52;Pays de la Loire;85;1;06;254;Saint-Mesmin;1761;44;1805
52;Pays de la Loire;85;1;08;255;Saint-Michel-en-l'Herm;2344;77;2421
52;Pays de la Loire;85;1;05;256;Saint-Michel-le-Cloucq;1289;32;1321
52;Pays de la Loire;85;2;06;259;Saint-Paul-en-Pareds;1332;35;1367
52;Pays de la Loire;85;2;02;260;Saint-Paul-Mont-Penit;811;11;822
52;Pays de la Loire;85;2;01;262;Saint-Philbert-de-Bouaine;3472;38;3510
52;Pays de la Loire;85;1;04;264;Saint-Pierre-du-Chemin;1333;20;1353
52;Pays de la Loire;85;1;05;265;Saint-Pierre-le-Vieux;951;21;972
52;Pays de la Loire;85;2;03;266;Saint-Prouant;1647;28;1675
52;Pays de la Loire;85;3;15;268;Saint-Révérend;1445;30;1475
52;Pays de la Loire;85;1;05;269;Saint-Sigismond;413;7;420
52;Pays de la Loire;85;1;04;271;Saint-Sulpice-en-Pareds;434;13;447
52;Pays de la Loire;85;3;16;273;Saint-Urbain;1849;34;1883
52;Pays de la Loire;85;1;04;274;Saint-Valérien;528;12;540
52;Pays de la Loire;85;2;03;276;Saint-Vincent-Sterlanges;772;13;785
52;Pays de la Loire;85;3;09;277;Saint-Vincent-sur-Graon;1517;24;1541
52;Pays de la Loire;85;3;17;278;Saint-Vincent-sur-Jard;1302;22;1324
52;Pays de la Loire;85;2;03;202;Sainte-Cécile;1605;119;1724
52;Pays de la Loire;85;3;17;211;Sainte-Flaive-des-Loups;2417;25;2442
52;Pays de la Loire;85;3;17;214;Sainte-Foy;2315;45;2360
52;Pays de la Loire;85;1;08;216;Sainte-Gemme-la-Plaine;2048;212;2260
52;Pays de la Loire;85;1;04;223;Sainte-Hermine;2930;61;2991
52;Pays de la Loire;85;1;09;261;Sainte-Pexine;267;12;279
52;Pays de la Loire;85;1;08;267;Sainte-Radégonde-des-Noyers;925;18;943
52;Pays de la Loire;85;3;02;280;Sallertaine;3129;70;3199
52;Pays de la Loire;85;1;04;281;Sérigné;971;30;1001
52;Pays de la Loire;85;1;06;090;Sèvremont;6455;235;6690
52;Pays de la Loire;85;2;03;282;Sigournais;910;16;926
52;Pays de la Loire;85;3;16;284;Soullans;4225;93;4318
52;Pays de la Loire;85;2;09;285;Le Tablier;744;13;757
52;Pays de la Loire;85;1;08;286;La Taillée;571;5;576
52;Pays de la Loire;85;1;06;287;Tallud-Sainte-Gemme;464;8;472
52;Pays de la Loire;85;3;17;288;Talmont-Saint-Hilaire;7748;183;7931
52;Pays de la Loire;85;1;04;289;La Tardière;1320;26;1346
52;Pays de la Loire;85;1;04;290;Thiré;561;13;574
52;Pays de la Loire;85;2;03;291;Thorigny;1231;20;1251
52;Pays de la Loire;85;1;04;292;Thouarsais-Bouildroux;774;10;784
52;Pays de la Loire;85;2;11;293;Tiffauges;1581;38;1619
52;Pays de la Loire;85;3;09;294;La Tranche-sur-Mer;2924;65;2989
52;Pays de la Loire;85;2;10;295;Treize-Septiers;3245;81;3326
52;Pays de la Loire;85;2;11;296;Treize-Vents;1252;24;1276
52;Pays de la Loire;85;1;08;297;Triaize;999;15;1014
52;Pays de la Loire;85;3;17;298;Vairé;1727;30;1757
52;Pays de la Loire;85;1;05;177;Velluire-sur-Vendée ;1382;22;1404
52;Pays de la Loire;85;2;12;300;Venansault;4636;171;4807
52;Pays de la Loire;85;2;10;301;Vendrennes;1743;21;1764
52;Pays de la Loire;85;1;05;303;Vix;1796;30;1826
52;Pays de la Loire;85;1;08;304;Vouillé-les-Marais;748;10;758
52;Pays de la Loire;85;1;04;305;Vouvant;876;48;924
52;Pays de la Loire;85;1;05;306;Xanton-Chassenon;731;9;740
75;Nouvelle-Aquitaine;86;2;10;001;Adriers;716;8;724
75;Nouvelle-Aquitaine;86;3;11;002;Amberre;577;21;598
75;Nouvelle-Aquitaine;86;2;09;003;Anché;340;7;347
75;Nouvelle-Aquitaine;86;1;12;004;Angles-sur-l'Anglin;353;14;367
75;Nouvelle-Aquitaine;86;1;08;005;Angliers;623;23;646
75;Nouvelle-Aquitaine;86;2;12;006;Antigny;541;19;560
75;Nouvelle-Aquitaine;86;1;03;007;Antran;1178;32;1210
75;Nouvelle-Aquitaine;86;1;05;009;Archigny;1076;17;1093
75;Nouvelle-Aquitaine;86;1;08;008;Arçay;349;6;355
75;Nouvelle-Aquitaine;86;3;18;010;Aslonnes;1114;19;1133
75;Nouvelle-Aquitaine;86;2;10;011;Asnières-sur-Blour;181;4;185
75;Nouvelle-Aquitaine;86;2;06;012;Asnois;163;8;171
75;Nouvelle-Aquitaine;86;1;08;013;Aulnay;97;3;100
75;Nouvelle-Aquitaine;86;1;05;014;Availles-en-Châtellerault;1749;42;1791
75;Nouvelle-Aquitaine;86;2;06;015;Availles-Limouzine;1256;26;1282
75;Nouvelle-Aquitaine;86;3;11;016;Avanton;2188;40;2228
75;Nouvelle-Aquitaine;86;3;19;017;Ayron;1121;17;1138
75;Nouvelle-Aquitaine;86;1;08;018;Basses;319;2;321
75;Nouvelle-Aquitaine;86;3;07;019;Beaumont Saint-Cyr;2997;43;3040
75;Nouvelle-Aquitaine;86;1;05;020;Bellefonds;255;4;259
75;Nouvelle-Aquitaine;86;1;08;022;Berrie;261;4;265
75;Nouvelle-Aquitaine;86;1;08;023;Berthegon;293;6;299
75;Nouvelle-Aquitaine;86;3;19;024;Béruges;1540;24;1564
75;Nouvelle-Aquitaine;86;2;12;025;Béthines;474;5;479
75;Nouvelle-Aquitaine;86;1;08;026;Beuxes;550;5;555
75;Nouvelle-Aquitaine;86;3;13;027;Biard;1802;61;1863
75;Nouvelle-Aquitaine;86;3;01;028;Bignoux;1053;18;1071
75;Nouvelle-Aquitaine;86;2;06;029;Blanzay;783;24;807
75;Nouvelle-Aquitaine;86;3;19;123;Boivre-la-Vallée ;3072;52;3124
75;Nouvelle-Aquitaine;86;3;01;031;Bonnes;1733;20;1753
75;Nouvelle-Aquitaine;86;1;05;032;Bonneuil-Matours;2092;81;2173
75;Nouvelle-Aquitaine;86;2;10;034;Bouresse;592;13;605
75;Nouvelle-Aquitaine;86;2;12;035;Bourg-Archambault;187;6;193
75;Nouvelle-Aquitaine;86;1;08;036;Bournand;882;19;901
75;Nouvelle-Aquitaine;86;2;12;037;Brigueil-le-Chantre;509;5;514
75;Nouvelle-Aquitaine;86;2;10;038;Brion;222;8;230
75;Nouvelle-Aquitaine;86;2;09;039;Brux;729;9;738
75;Nouvelle-Aquitaine;86;2;12;040;La Bussière;319;11;330
75;Nouvelle-Aquitaine;86;3;14;041;Buxerolles;10042;138;10180
75;Nouvelle-Aquitaine;86;1;03;042;Buxeuil;925;12;937
75;Nouvelle-Aquitaine;86;1;08;044;Ceaux-en-Loudun;549;11;560
75;Nouvelle-Aquitaine;86;3;09;045;Celle-Lévescault;1351;17;1368
75;Nouvelle-Aquitaine;86;1;05;046;Cenon-sur-Vienne;1758;29;1787
75;Nouvelle-Aquitaine;86;1;08;047;Cernay;482;13;495
75;Nouvelle-Aquitaine;86;3;07;048;Chabournay;1120;12;1132
75;Nouvelle-Aquitaine;86;1;08;049;Chalais;509;16;525
75;Nouvelle-Aquitaine;86;3;19;050;Chalandray;843;13;856
75;Nouvelle-Aquitaine;86;2;06;051;Champagné-le-Sec;199;4;203
75;Nouvelle-Aquitaine;86;2;06;052;Champagné-Saint-Hilaire;1002;21;1023
75;Nouvelle-Aquitaine;86;3;  ;053;Champigny en Rochereau ;1943;35;1978
75;Nouvelle-Aquitaine;86;2;06;054;Champniers;351;5;356
75;Nouvelle-Aquitaine;86;2;06;055;La Chapelle-Bâton;358;12;370
75;Nouvelle-Aquitaine;86;3;01;058;La Chapelle-Moulière;716;20;736
75;Nouvelle-Aquitaine;86;2;05;059;Chapelle-Viviers;566;4;570
75;Nouvelle-Aquitaine;86;2;06;061;Charroux;1137;25;1162
75;Nouvelle-Aquitaine;86;3;01;062;Chasseneuil-du-Poitou;4687;51;4738
75;Nouvelle-Aquitaine;86;2;06;063;Chatain;250;1;251
75;Nouvelle-Aquitaine;86;2;06;064;Château-Garnier;613;10;623
75;Nouvelle-Aquitaine;86;3;18;065;Château-Larcher;1039;16;1055
75;Nouvelle-Aquitaine;86;1;98;066;Châtellerault;31733;804;32537
75;Nouvelle-Aquitaine;86;2;09;068;Chaunay;1213;17;1230
75;Nouvelle-Aquitaine;86;1;08;069;La Chaussée;180;4;184
75;Nouvelle-Aquitaine;86;3;05;070;Chauvigny;7045;114;7159
75;Nouvelle-Aquitaine;86;1;04;072;Chenevelles;462;9;471
75;Nouvelle-Aquitaine;86;3;11;073;Cherves;550;11;561
75;Nouvelle-Aquitaine;86;3;19;074;Chiré-en-Montreuil;912;15;927
75;Nouvelle-Aquitaine;86;3;08;075;Chouppes;754;19;773
75;Nouvelle-Aquitaine;86;3;11;076;Cissé;2807;48;2855
75;Nouvelle-Aquitaine;86;2;10;077;Civaux;1204;17;1221
75;Nouvelle-Aquitaine;86;2;06;078;Civray;2618;140;2758
75;Nouvelle-Aquitaine;86;3;09;080;Cloué;490;5;495
75;Nouvelle-Aquitaine;86;1;02;081;Colombiers;1469;30;1499
75;Nouvelle-Aquitaine;86;3;09;083;Coulombiers;1134;13;1147
75;Nouvelle-Aquitaine;86;2;12;084;Coulonges;235;5;240
75;Nouvelle-Aquitaine;86;3;08;085;Coussay;250;6;256
75;Nouvelle-Aquitaine;86;1;04;086;Coussay-les-Bois;978;18;996
75;Nouvelle-Aquitaine;86;1;08;087;Craon;186;4;190
75;Nouvelle-Aquitaine;86;3;13;088;Croutelle;864;24;888
75;Nouvelle-Aquitaine;86;3;11;089;Cuhon;395;6;401
75;Nouvelle-Aquitaine;86;3;09;091;Curzay-sur-Vonne;398;7;405
75;Nouvelle-Aquitaine;86;1;08;090;Curçay-sur-Dive;215;1;216
75;Nouvelle-Aquitaine;86;1;03;092;Dangé-Saint-Romain;2975;58;3033
75;Nouvelle-Aquitaine;86;1;08;093;Dercé;156;3;159
75;Nouvelle-Aquitaine;86;3;18;094;Dienné;567;12;579
75;Nouvelle-Aquitaine;86;3;07;095;Dissay;3236;50;3286
75;Nouvelle-Aquitaine;86;1;08;096;Doussay;656;9;665
75;Nouvelle-Aquitaine;86;2;06;097;La Ferrière-Airoux;324;5;329
75;Nouvelle-Aquitaine;86;2;05;098;Fleix;138;2;140
75;Nouvelle-Aquitaine;86;3;18;099;Fleuré;1055;9;1064
75;Nouvelle-Aquitaine;86;3;13;100;Fontaine-le-Comte;3871;73;3944
75;Nouvelle-Aquitaine;86;3;19;102;Frozes;581;8;589
75;Nouvelle-Aquitaine;86;2;06;104;Genouillé;504;5;509
75;Nouvelle-Aquitaine;86;2;10;103;Gençay;1739;65;1804
75;Nouvelle-Aquitaine;86;3;18;105;Gizay;374;1;375
75;Nouvelle-Aquitaine;86;1;08;106;Glénouze;100;2;102
75;Nouvelle-Aquitaine;86;2;10;107;Gouex;479;8;487
75;Nouvelle-Aquitaine;86;1;08;108;La Grimaudière;400;12;412
75;Nouvelle-Aquitaine;86;1;08;109;Guesnes;222;8;230
75;Nouvelle-Aquitaine;86;2;12;110;Haims;225;4;229
75;Nouvelle-Aquitaine;86;1;03;111;Ingrandes;1744;35;1779
75;Nouvelle-Aquitaine;86;2;10;112;L' Isle-Jourdain;1165;12;1177
75;Nouvelle-Aquitaine;86;3;18;113;Iteuil;2954;48;3002
75;Nouvelle-Aquitaine;86;3;01;114;Jardres;1278;23;1301
75;Nouvelle-Aquitaine;86;3;07;115;Jaunay-Marigny;7587;255;7842
75;Nouvelle-Aquitaine;86;3;09;116;Jazeneuil;793;17;810
75;Nouvelle-Aquitaine;86;2;12;117;Jouhet;527;7;534
75;Nouvelle-Aquitaine;86;2;12;118;Journet;372;9;381
75;Nouvelle-Aquitaine;86;2;06;119;Joussé;302;1;303
75;Nouvelle-Aquitaine;86;2;12;120;Lathus-Saint-Rémy;1217;16;1233
75;Nouvelle-Aquitaine;86;3;19;121;Latillé;1452;27;1479
75;Nouvelle-Aquitaine;86;2;05;122;Lauthiers;68;3;71
75;Nouvelle-Aquitaine;86;3;01;124;Lavoux;1179;19;1198
75;Nouvelle-Aquitaine;86;1;04;125;Leigné-les-Bois;594;13;607
75;Nouvelle-Aquitaine;86;1;03;127;Leigné-sur-Usseau;461;3;464
75;Nouvelle-Aquitaine;86;2;05;126;Leignes-sur-Fontaine;641;13;654
75;Nouvelle-Aquitaine;86;1;02;128;Lencloître;2465;32;2497
75;Nouvelle-Aquitaine;86;1;04;129;Lésigny;532;8;540
75;Nouvelle-Aquitaine;86;1;03;130;Leugny;394;4;398
75;Nouvelle-Aquitaine;86;2;10;131;Lhommaizé;871;24;895
75;Nouvelle-Aquitaine;86;2;12;132;Liglet;312;3;315
75;Nouvelle-Aquitaine;86;3;17;133;Ligugé;3361;59;3420
75;Nouvelle-Aquitaine;86;2;06;134;Linazay;223;1;224
75;Nouvelle-Aquitaine;86;3;01;135;Liniers;565;11;576
75;Nouvelle-Aquitaine;86;2;06;136;Lizant;396;8;404
75;Nouvelle-Aquitaine;86;1;08;137;Loudun;6740;352;7092
75;Nouvelle-Aquitaine;86;2;10;138;Luchapt;250;3;253
75;Nouvelle-Aquitaine;86;3;09;139;Lusignan;2660;38;2698
75;Nouvelle-Aquitaine;86;2;10;140;Lussac-les-Châteaux;2318;50;2368
75;Nouvelle-Aquitaine;86;2;06;141;Magné;675;14;689
75;Nouvelle-Aquitaine;86;3;19;142;Maillé;655;12;667
75;Nouvelle-Aquitaine;86;1;04;143;Mairé;164;5;169
75;Nouvelle-Aquitaine;86;3;11;144;Maisonneuve;333;8;341
75;Nouvelle-Aquitaine;86;3;18;147;Marigny-Chemereau;604;12;616
75;Nouvelle-Aquitaine;86;3;18;148;Marnay;706;12;718
75;Nouvelle-Aquitaine;86;1;08;149;Martaizé;381;9;390
75;Nouvelle-Aquitaine;86;3;18;145;Marçay;1207;15;1222
75;Nouvelle-Aquitaine;86;3;11;150;Massognes;276;7;283
75;Nouvelle-Aquitaine;86;1;08;151;Maulay;178;8;186
75;Nouvelle-Aquitaine;86;2;06;152;Mauprévoir;590;15;605
75;Nouvelle-Aquitaine;86;2;10;153;Mazerolles;856;13;869
75;Nouvelle-Aquitaine;86;1;08;154;Mazeuil;258;4;262
75;Nouvelle-Aquitaine;86;1;08;156;Messemé;239;4;243
75;Nouvelle-Aquitaine;86;3;16;157;Mignaloux-Beauvoir;4801;176;4977
75;Nouvelle-Aquitaine;86;3;11;158;Migné-Auxances;6127;116;6243
75;Nouvelle-Aquitaine;86;2;10;159;Millac;553;14;567
75;Nouvelle-Aquitaine;86;3;11;160;Mirebeau;2196;35;2231
75;Nouvelle-Aquitaine;86;1;08;161;Moncontour;990;19;1009
75;Nouvelle-Aquitaine;86;1;03;162;Mondion;108;1;109
75;Nouvelle-Aquitaine;86;3;01;163;Montamisé;3665;61;3726
75;Nouvelle-Aquitaine;86;1;05;164;Monthoiron;664;5;669
75;Nouvelle-Aquitaine;86;2;12;165;Montmorillon;5911;458;6369
75;Nouvelle-Aquitaine;86;1;08;167;Monts-sur-Guesnes;902;7;909
75;Nouvelle-Aquitaine;86;1;08;169;Morton;347;5;352
75;Nouvelle-Aquitaine;86;2;12;170;Moulismes;368;12;380
75;Nouvelle-Aquitaine;86;2;10;171;Moussac;441;14;455
75;Nouvelle-Aquitaine;86;1;08;173;Mouterre-Silly;661;12;673
75;Nouvelle-Aquitaine;86;2;10;172;Mouterre-sur-Blourde;164;4;168
75;Nouvelle-Aquitaine;86;1;02;174;Naintré;5908;118;6026
75;Nouvelle-Aquitaine;86;2;12;175;Nalliers;316;12;328
75;Nouvelle-Aquitaine;86;2;10;176;Nérignac;123;5;128
75;Nouvelle-Aquitaine;86;3;11;177;Neuville-de-Poitou;5308;83;5391
75;Nouvelle-Aquitaine;86;3;18;178;Nieuil-l'Espoir;2736;38;2774
75;Nouvelle-Aquitaine;86;3;18;180;Nouaillé-Maupertuis;2799;51;2850
75;Nouvelle-Aquitaine;86;1;08;181;Nueil-sous-Faye;210;5;215
75;Nouvelle-Aquitaine;86;1;03;182;Orches;394;10;404
75;Nouvelle-Aquitaine;86;1;03;183;Les Ormes;1620;21;1641
75;Nouvelle-Aquitaine;86;1;02;184;Ouzilly;929;11;940
75;Nouvelle-Aquitaine;86;1;03;186;Oyré;965;23;988
75;Nouvelle-Aquitaine;86;2;05;187;Paizay-le-Sec;460;14;474
75;Nouvelle-Aquitaine;86;2;06;189;Payroux;483;6;489
75;Nouvelle-Aquitaine;86;2;10;190;Persac;753;14;767
75;Nouvelle-Aquitaine;86;2;12;191;Pindray;251;7;258
75;Nouvelle-Aquitaine;86;2;12;192;Plaisance;170;4;174
75;Nouvelle-Aquitaine;86;1;04;193;Pleumartin;1232;13;1245
75;Nouvelle-Aquitaine;86;3;99;194;Poitiers;88665;2293;90958
75;Nouvelle-Aquitaine;86;1;03;195;Port-de-Piles;567;11;578
75;Nouvelle-Aquitaine;86;1;08;197;Pouant;415;11;426
75;Nouvelle-Aquitaine;86;1;08;196;Pouançay;235;5;240
75;Nouvelle-Aquitaine;86;3;01;198;Pouillé;674;9;683
75;Nouvelle-Aquitaine;86;2;06;200;Pressac;582;13;595
75;Nouvelle-Aquitaine;86;1;08;201;Prinçay;214;2;216
75;Nouvelle-Aquitaine;86;3;12;202;La Puye;598;10;608
75;Nouvelle-Aquitaine;86;2;10;203;Queaux;542;11;553
75;Nouvelle-Aquitaine;86;3;19;204;Quinçay;2187;56;2243
75;Nouvelle-Aquitaine;86;1;08;205;Ranton;197;3;200
75;Nouvelle-Aquitaine;86;1;08;206;Raslay;137;5;142
75;Nouvelle-Aquitaine;86;1;04;207;La Roche-Posay;1557;31;1588
75;Nouvelle-Aquitaine;86;1;08;079;La Roche-Rigault;554;36;590
75;Nouvelle-Aquitaine;86;3;18;209;Roches-Prémarie-Andillé;2028;32;2060
75;Nouvelle-Aquitaine;86;1;08;210;Roiffé;756;20;776
75;Nouvelle-Aquitaine;86;2;09;211;Romagne;897;92;989
75;Nouvelle-Aquitaine;86;3;09;213;Rouillé;2495;185;2680
75;Nouvelle-Aquitaine;86;3;17;214;Saint-Benoît;7266;247;7513
75;Nouvelle-Aquitaine;86;1;03;217;Saint-Christophe;296;12;308
75;Nouvelle-Aquitaine;86;1;08;218;Saint-Clair;198;8;206
75;Nouvelle-Aquitaine;86;2;06;220;Saint-Gaudent;311;8;319
75;Nouvelle-Aquitaine;86;1;02;221;Saint-Genest-d'Ambière;1227;22;1249
75;Nouvelle-Aquitaine;86;3;07;222;Saint-Georges-lès-Baillargeaux;4200;55;4255
75;Nouvelle-Aquitaine;86;2;12;223;Saint-Germain;922;25;947
75;Nouvelle-Aquitaine;86;1;03;224;Saint-Gervais-les-Trois-Clochers;1320;32;1352
75;Nouvelle-Aquitaine;86;1;08;225;Saint-Jean-de-Sauves;1402;29;1431
75;Nouvelle-Aquitaine;86;3;01;226;Saint-Julien-l'Ars;2721;48;2769
75;Nouvelle-Aquitaine;86;1;08;227;Saint-Laon;131;4;135
75;Nouvelle-Aquitaine;86;2;10;228;Saint-Laurent-de-Jourdes;196;3;199
75;Nouvelle-Aquitaine;86;1;08;229;Saint-Léger-de-Montbrillais;339;5;344
75;Nouvelle-Aquitaine;86;2;12;230;Saint-Léomer;179;4;183
75;Nouvelle-Aquitaine;86;2;06;231;Saint-Macoux;479;17;496
75;Nouvelle-Aquitaine;86;2;06;234;Saint-Martin-l'Ars;386;5;391
75;Nouvelle-Aquitaine;86;3;88;281;Saint-Martin-la-Pallu;5563;87;5650
75;Nouvelle-Aquitaine;86;2;10;235;Saint-Maurice-la-Clouère;1306;36;1342
75;Nouvelle-Aquitaine;86;2;06;237;Saint-Pierre-d'Exideuil;767;20;787
75;Nouvelle-Aquitaine;86;2;12;236;Saint-Pierre-de-Maillé;880;16;896
75;Nouvelle-Aquitaine;86;1;03;241;Saint-Rémy-sur-Creuse;392;6;398
75;Nouvelle-Aquitaine;86;2;06;242;Saint-Romain;395;7;402
75;Nouvelle-Aquitaine;86;3;09;244;Saint-Sauvant;1260;24;1284
75;Nouvelle-Aquitaine;86;2;12;246;Saint-Savin;836;16;852
75;Nouvelle-Aquitaine;86;2;06;247;Saint-Saviol;533;13;546
75;Nouvelle-Aquitaine;86;2;10;248;Saint-Secondin;541;16;557
75;Nouvelle-Aquitaine;86;3;05;239;Sainte-Radégonde;170;0;170
75;Nouvelle-Aquitaine;86;1;08;249;Saires;128;6;134
75;Nouvelle-Aquitaine;86;1;08;250;Saix;291;5;296
75;Nouvelle-Aquitaine;86;1;08;252;Sammarçolles;642;14;656
75;Nouvelle-Aquitaine;86;3;09;253;Sanxay;549;11;560
75;Nouvelle-Aquitaine;86;2;12;254;Saulgé;1010;11;1021
75;Nouvelle-Aquitaine;86;2;06;255;Savigné;1331;27;1358
75;Nouvelle-Aquitaine;86;3;01;256;Savigny-Lévescault;1178;25;1203
75;Nouvelle-Aquitaine;86;1;03;257;Savigny-sous-Faye;377;5;382
75;Nouvelle-Aquitaine;86;1;02;258;Scorbé-Clairvaux;2252;31;2283
75;Nouvelle-Aquitaine;86;1;04;245;Senillé-Saint-Sauveur;1836;44;1880
75;Nouvelle-Aquitaine;86;1;03;260;Sérigny;309;1;310
75;Nouvelle-Aquitaine;86;3;01;261;Sèvres-Anxaumont;2222;77;2299
75;Nouvelle-Aquitaine;86;2;10;262;Sillars;602;15;617
75;Nouvelle-Aquitaine;86;3;18;263;Smarves;2831;43;2874
75;Nouvelle-Aquitaine;86;2;06;264;Sommières-du-Clain;771;17;788
75;Nouvelle-Aquitaine;86;1;03;265;Sossais;433;7;440
75;Nouvelle-Aquitaine;86;2;06;266;Surin;138;2;140
75;Nouvelle-Aquitaine;86;3;01;268;Tercé;1117;17;1134
75;Nouvelle-Aquitaine;86;1;08;269;Ternay;187;3;190
75;Nouvelle-Aquitaine;86;2;12;270;Thollet;154;3;157
75;Nouvelle-Aquitaine;86;3;11;271;Thurageau;814;14;828
75;Nouvelle-Aquitaine;86;1;02;272;Thuré;2863;151;3014
75;Nouvelle-Aquitaine;86;2;12;273;La Trimouille;874;23;897
75;Nouvelle-Aquitaine;86;1;08;274;Les Trois-Moutiers;1064;24;1088
75;Nouvelle-Aquitaine;86;1;03;275;Usseau;604;9;613
75;Nouvelle-Aquitaine;86;2;10;276;Usson-du-Poitou;1257;22;1279
75;Nouvelle-Aquitaine;86;2;05;233;Valdivienne;2746;43;2789
75;Nouvelle-Aquitaine;86;2;09;082;Valence-en-Poitou ;4461;116;4577
75;Nouvelle-Aquitaine;86;1;03;279;Vaux-sur-Vienne;538;6;544
75;Nouvelle-Aquitaine;86;1;03;280;Vellèches;362;5;367
75;Nouvelle-Aquitaine;86;3;18;284;Vernon;709;21;730
75;Nouvelle-Aquitaine;86;2;10;285;Verrières;986;26;1012
75;Nouvelle-Aquitaine;86;1;08;286;Verrue;390;4;394
75;Nouvelle-Aquitaine;86;1;08;287;Vézières;357;6;363
75;Nouvelle-Aquitaine;86;1;04;288;Vicq-sur-Gartempe;613;7;620
75;Nouvelle-Aquitaine;86;2;10;289;Le Vigeant;687;30;717
75;Nouvelle-Aquitaine;86;3;18;290;La Villedieu-du-Clain;1573;35;1608
75;Nouvelle-Aquitaine;86;2;12;291;Villemort;103;7;110
75;Nouvelle-Aquitaine;86;3;11;292;Villiers;906;18;924
75;Nouvelle-Aquitaine;86;3;18;293;Vivonne;4377;75;4452
75;Nouvelle-Aquitaine;86;3;19;294;Vouillé;3689;73;3762
75;Nouvelle-Aquitaine;86;2;06;295;Voulême;385;5;390
75;Nouvelle-Aquitaine;86;2;09;296;Voulon;468;7;475
75;Nouvelle-Aquitaine;86;3;19;297;Vouneuil-sous-Biard;5978;136;6114
75;Nouvelle-Aquitaine;86;1;05;298;Vouneuil-sur-Vienne;2237;30;2267
75;Nouvelle-Aquitaine;86;3;11;299;Vouzailles;587;9;596
75;Nouvelle-Aquitaine;86;3;11;300;Yversay;566;5;571
75;Nouvelle-Aquitaine;87;2;01;001;Aixe-sur-Vienne;5820;78;5898
75;Nouvelle-Aquitaine;87;2;02;002;Ambazac;5630;74;5704
75;Nouvelle-Aquitaine;87;1;04;003;Arnac-la-Poste;942;26;968
75;Nouvelle-Aquitaine;87;2;07;004;Augne;109;2;111
75;Nouvelle-Aquitaine;87;2;20;005;Aureil;1006;20;1026
75;Nouvelle-Aquitaine;87;1;04;006;Azat-le-Ris;251;1;252
75;Nouvelle-Aquitaine;87;1;04;007;Balledent;196;3;199
75;Nouvelle-Aquitaine;87;1;04;008;La Bazeuge;144;0;144
75;Nouvelle-Aquitaine;87;2;07;009;Beaumont-du-Lac;142;5;147
75;Nouvelle-Aquitaine;87;1;03;011;Bellac;3652;128;3780
75;Nouvelle-Aquitaine;87;1;03;012;Berneuil;432;5;437
75;Nouvelle-Aquitaine;87;2;02;013;Bersac-sur-Rivalier;643;16;659
75;Nouvelle-Aquitaine;87;1;02;014;Bessines-sur-Gartempe;2818;58;2876
75;Nouvelle-Aquitaine;87;2;01;015;Beynac;693;73;766
75;Nouvelle-Aquitaine;87;2;02;016;Les Billanges;285;7;292
75;Nouvelle-Aquitaine;87;1;03;017;Blanzac;497;11;508
75;Nouvelle-Aquitaine;87;1;03;018;Blond;694;23;717
75;Nouvelle-Aquitaine;87;2;05;019;Boisseuil;2927;63;2990
75;Nouvelle-Aquitaine;87;2;02;020;Bonnac-la-Côte;1676;27;1703
75;Nouvelle-Aquitaine;87;2;01;021;Bosmie-l'Aiguille;2597;34;2631
75;Nouvelle-Aquitaine;87;1;03;022;Breuilaufa;125;1;126
75;Nouvelle-Aquitaine;87;1;03;023;Le Buis;188;4;192
75;Nouvelle-Aquitaine;87;2;07;024;Bujaleuf;821;9;830
75;Nouvelle-Aquitaine;87;2;01;025;Burgnac;849;12;861
75;Nouvelle-Aquitaine;87;2;21;027;Bussière-Galant;1280;16;1296
75;Nouvelle-Aquitaine;87;2;21;029;Les Cars;630;11;641
75;Nouvelle-Aquitaine;87;3;19;030;Chaillac-sur-Vienne;1252;22;1274
75;Nouvelle-Aquitaine;87;2;21;031;Le Chalard;311;4;315
75;Nouvelle-Aquitaine;87;2;21;032;Châlus;1629;29;1658
75;Nouvelle-Aquitaine;87;1;03;033;Chamboret;789;9;798
75;Nouvelle-Aquitaine;87;3;18;034;Champagnac-la-Rivière;570;8;578
75;Nouvelle-Aquitaine;87;2;20;035;Champnétery;540;9;549
75;Nouvelle-Aquitaine;87;3;18;036;Champsac;668;11;679
75;Nouvelle-Aquitaine;87;3;18;037;La Chapelle-Montbrandeix;260;2;262
75;Nouvelle-Aquitaine;87;2;06;038;Chaptelat;2112;18;2130
75;Nouvelle-Aquitaine;87;2;07;039;Château-Chervix;798;13;811
75;Nouvelle-Aquitaine;87;2;07;040;Châteauneuf-la-Forêt;1523;20;1543
75;Nouvelle-Aquitaine;87;1;04;041;Châteauponsac;2038;21;2059
75;Nouvelle-Aquitaine;87;2;20;042;Le Châtenet-en-Dognon;391;6;397
75;Nouvelle-Aquitaine;87;2;07;043;Cheissoux;191;2;193
75;Nouvelle-Aquitaine;87;3;18;044;Chéronnac;330;6;336
75;Nouvelle-Aquitaine;87;1;03;045;Cieux;993;13;1006
75;Nouvelle-Aquitaine;87;3;18;046;Cognac-la-Forêt;1187;9;1196
75;Nouvelle-Aquitaine;87;1;03;047;Compreignac;1847;16;1863
75;Nouvelle-Aquitaine;87;2;05;048;Condat-sur-Vienne;5139;73;5212
75;Nouvelle-Aquitaine;87;2;07;049;Coussac-Bonneval;1318;34;1352
75;Nouvelle-Aquitaine;87;2;06;050;Couzeix;9349;158;9507
75;Nouvelle-Aquitaine;87;2;07;051;La Croisille-sur-Briance;630;12;642
75;Nouvelle-Aquitaine;87;1;04;052;La Croix-sur-Gartempe;184;1;185
75;Nouvelle-Aquitaine;87;1;04;053;Cromac;245;2;247
75;Nouvelle-Aquitaine;87;3;18;054;Cussac;1213;21;1234
75;Nouvelle-Aquitaine;87;1;04;056;Dinsac;274;3;277
75;Nouvelle-Aquitaine;87;1;04;057;Dompierre-les-Églises;367;5;372
75;Nouvelle-Aquitaine;87;2;07;058;Domps;113;3;116
75;Nouvelle-Aquitaine;87;1;04;059;Le Dorat;1638;66;1704
75;Nouvelle-Aquitaine;87;3;18;060;Dournazac;664;9;673
75;Nouvelle-Aquitaine;87;1;04;061;Droux;346;5;351
75;Nouvelle-Aquitaine;87;2;20;062;Eybouleuf;447;8;455
75;Nouvelle-Aquitaine;87;2;05;063;Eyjeaux;1319;26;1345
75;Nouvelle-Aquitaine;87;2;07;064;Eymoutiers;2064;24;2088
75;Nouvelle-Aquitaine;87;2;17;065;Feytiat;6117;78;6195
75;Nouvelle-Aquitaine;87;2;21;066;Flavignac;1065;11;1076
75;Nouvelle-Aquitaine;87;1;02;067;Folles;475;9;484
75;Nouvelle-Aquitaine;87;1;02;068;Fromental;528;16;544
75;Nouvelle-Aquitaine;87;1;03;069;Gajoubert;143;1;144
75;Nouvelle-Aquitaine;87;2;20;070;La Geneytouse;966;17;983
75;Nouvelle-Aquitaine;87;2;21;071;Glandon;779;18;797
75;Nouvelle-Aquitaine;87;2;07;072;Glanges;510;10;520
75;Nouvelle-Aquitaine;87;3;18;073;Gorre;396;9;405
75;Nouvelle-Aquitaine;87;1;04;074;Les Grands-Chézeaux;246;2;248
75;Nouvelle-Aquitaine;87;2;16;075;Isle;7779;150;7929
75;Nouvelle-Aquitaine;87;2;02;076;Jabreilles-les-Bordes;234;3;237
75;Nouvelle-Aquitaine;87;2;21;077;Janailhac;532;9;541
75;Nouvelle-Aquitaine;87;3;19;078;Javerdat;705;5;710
75;Nouvelle-Aquitaine;87;2;02;079;La Jonchère-Saint-Maurice;831;12;843
75;Nouvelle-Aquitaine;87;1;04;080;Jouac;179;3;182
75;Nouvelle-Aquitaine;87;2;01;081;Jourgnac;1108;14;1122
75;Nouvelle-Aquitaine;87;2;21;082;Ladignac-le-Long;1173;12;1185
75;Nouvelle-Aquitaine;87;2;02;083;Laurière;555;7;562
75;Nouvelle-Aquitaine;87;2;21;084;Lavignac;159;4;163
75;Nouvelle-Aquitaine;87;2;99;085;Limoges;131479;2263;133742
75;Nouvelle-Aquitaine;87;2;07;086;Linards;1043;16;1059
75;Nouvelle-Aquitaine;87;1;04;087;Lussac-les-Églises;510;3;513
75;Nouvelle-Aquitaine;87;2;07;088;Magnac-Bourg;1097;20;1117
75;Nouvelle-Aquitaine;87;1;04;089;Magnac-Laval;1716;169;1885
75;Nouvelle-Aquitaine;87;1;04;090;Mailhac-sur-Benaize;268;5;273
75;Nouvelle-Aquitaine;87;3;18;091;Maisonnais-sur-Tardoire;387;7;394
75;Nouvelle-Aquitaine;87;3;18;092;Marval;520;6;526
75;Nouvelle-Aquitaine;87;2;07;093;Masléon;282;3;285
75;Nouvelle-Aquitaine;87;2;21;094;Meilhac;529;5;534
75;Nouvelle-Aquitaine;87;2;07;095;Meuzac;736;13;749
75;Nouvelle-Aquitaine;87;2;21;096;La Meyze;838;20;858
75;Nouvelle-Aquitaine;87;2;20;099;Moissannes;340;16;356
75;Nouvelle-Aquitaine;87;1;03;100;Montrol-Sénard;277;2;279
75;Nouvelle-Aquitaine;87;1;03;101;Mortemart;116;1;117
75;Nouvelle-Aquitaine;87;1;03;103;Nantiat;1599;25;1624
75;Nouvelle-Aquitaine;87;2;07;104;Nedde;458;4;462
75;Nouvelle-Aquitaine;87;2;07;105;Neuvic-Entier;927;17;944
75;Nouvelle-Aquitaine;87;2;21;106;Nexon;2524;45;2569
75;Nouvelle-Aquitaine;87;2;06;107;Nieul;1640;18;1658
75;Nouvelle-Aquitaine;87;1;03;108;Nouic;464;5;469
75;Nouvelle-Aquitaine;87;1;04;109;Oradour-Saint-Genest;330;34;364
75;Nouvelle-Aquitaine;87;3;19;110;Oradour-sur-Glane;2466;22;2488
75;Nouvelle-Aquitaine;87;3;18;111;Oradour-sur-Vayres;1490;20;1510
75;Nouvelle-Aquitaine;87;2;21;112;Pageas;580;13;593
75;Nouvelle-Aquitaine;87;2;12;113;Le Palais-sur-Vienne;6038;64;6102
75;Nouvelle-Aquitaine;87;2;17;114;Panazol;10974;212;11186
75;Nouvelle-Aquitaine;87;3;18;115;Pensol;175;2;177
75;Nouvelle-Aquitaine;87;1;03;116;Peyrat-de-Bellac;1054;24;1078
75;Nouvelle-Aquitaine;87;2;07;117;Peyrat-le-Château;1021;16;1037
75;Nouvelle-Aquitaine;87;2;06;118;Peyrilhac;1275;13;1288
75;Nouvelle-Aquitaine;87;2;05;119;Pierre-Buffière;1152;11;1163
75;Nouvelle-Aquitaine;87;2;07;120;La Porcherie;504;11;515
75;Nouvelle-Aquitaine;87;1;04;121;Rancon;494;11;505
75;Nouvelle-Aquitaine;87;1;02;122;Razès;1162;13;1175
75;Nouvelle-Aquitaine;87;2;07;123;Rempnat;149;4;153
75;Nouvelle-Aquitaine;87;2;21;124;Rilhac-Lastours;373;2;375
75;Nouvelle-Aquitaine;87;2;12;125;Rilhac-Rancon;4610;65;4675
75;Nouvelle-Aquitaine;87;2;21;127;La Roche-l'Abeille;611;13;624
75;Nouvelle-Aquitaine;87;3;18;126;Rochechouart;3768;51;3819
75;Nouvelle-Aquitaine;87;2;20;129;Royères;939;6;945
75;Nouvelle-Aquitaine;87;2;07;130;Roziers-Saint-Georges;176;0;176
75;Nouvelle-Aquitaine;87;3;19;131;Saillat-sur-Vienne;825;12;837
75;Nouvelle-Aquitaine;87;2;07;132;Saint-Amand-le-Petit;112;4;116
75;Nouvelle-Aquitaine;87;1;04;133;Saint-Amand-Magnazeix;507;4;511
75;Nouvelle-Aquitaine;87;3;18;135;Saint-Auvent;958;18;976
75;Nouvelle-Aquitaine;87;3;18;137;Saint-Bazile;121;2;123
75;Nouvelle-Aquitaine;87;2;05;138;Saint-Bonnet-Briance;569;14;583
75;Nouvelle-Aquitaine;87;1;03;139;Saint-Bonnet-de-Bellac;471;8;479
75;Nouvelle-Aquitaine;87;3;19;140;Saint-Brice-sur-Vienne;1676;17;1693
75;Nouvelle-Aquitaine;87;3;18;141;Saint-Cyr;685;10;695
75;Nouvelle-Aquitaine;87;2;20;142;Saint-Denis-des-Murs;535;7;542
75;Nouvelle-Aquitaine;87;2;06;143;Saint-Gence;2154;27;2181
75;Nouvelle-Aquitaine;87;2;05;144;Saint-Genest-sur-Roselle;519;5;524
75;Nouvelle-Aquitaine;87;1;04;145;Saint-Georges-les-Landes;239;1;240
75;Nouvelle-Aquitaine;87;2;07;146;Saint-Germain-les-Belles;1158;13;1171
75;Nouvelle-Aquitaine;87;2;07;147;Saint-Gilles-les-Forêts;45;2;47
75;Nouvelle-Aquitaine;87;2;05;148;Saint-Hilaire-Bonneval;990;12;1002
75;Nouvelle-Aquitaine;87;1;04;149;Saint-Hilaire-la-Treille;378;8;386
75;Nouvelle-Aquitaine;87;2;21;150;Saint-Hilaire-les-Places;858;14;872
75;Nouvelle-Aquitaine;87;2;05;151;Saint-Jean-Ligoure;503;9;512
75;Nouvelle-Aquitaine;87;2;06;152;Saint-Jouvent;1656;23;1679
75;Nouvelle-Aquitaine;87;2;07;153;Saint-Julien-le-Petit;289;0;289
75;Nouvelle-Aquitaine;87;3;19;154;Saint-Junien;11257;274;11531
75;Nouvelle-Aquitaine;87;1;03;155;Saint-Junien-les-Combes;176;7;183
75;Nouvelle-Aquitaine;87;2;20;156;Saint-Just-le-Martel;2670;46;2716
75;Nouvelle-Aquitaine;87;2;02;157;Saint-Laurent-les-Églises;857;34;891
75;Nouvelle-Aquitaine;87;3;18;158;Saint-Laurent-sur-Gorre;1470;14;1484
75;Nouvelle-Aquitaine;87;2;02;159;Saint-Léger-la-Montagne;350;3;353
75;Nouvelle-Aquitaine;87;1;04;160;Saint-Léger-Magnazeix;493;4;497
75;Nouvelle-Aquitaine;87;2;20;161;Saint-Léonard-de-Noblat;4470;114;4584
75;Nouvelle-Aquitaine;87;1;03;163;Saint-Martial-sur-Isop;138;4;142
75;Nouvelle-Aquitaine;87;3;19;164;Saint-Martin-de-Jussac;566;10;576
75;Nouvelle-Aquitaine;87;1;04;165;Saint-Martin-le-Mault;134;1;135
75;Nouvelle-Aquitaine;87;2;01;166;Saint-Martin-le-Vieux;928;16;944
75;Nouvelle-Aquitaine;87;2;20;167;Saint-Martin-Terressus;556;5;561
75;Nouvelle-Aquitaine;87;3;18;168;Saint-Mathieu;1080;14;1094
75;Nouvelle-Aquitaine;87;2;05;169;Saint-Maurice-les-Brousses;1056;25;1081
75;Nouvelle-Aquitaine;87;2;07;170;Saint-Méard;353;7;360
75;Nouvelle-Aquitaine;87;1;04;172;Saint-Ouen-sur-Gartempe;215;5;220
75;Nouvelle-Aquitaine;87;1;  ;128;Saint-Pardoux-le-Lac ;1325;13;1338
75;Nouvelle-Aquitaine;87;2;05;174;Saint-Paul;1232;23;1255
75;Nouvelle-Aquitaine;87;2;07;176;Saint-Priest-Ligoure;667;12;679
75;Nouvelle-Aquitaine;87;2;01;177;Saint-Priest-sous-Aixe;1763;19;1782
75;Nouvelle-Aquitaine;87;2;20;178;Saint-Priest-Taurion;2886;32;2918
75;Nouvelle-Aquitaine;87;1;04;179;Saint-Sornin-la-Marche;250;0;250
75;Nouvelle-Aquitaine;87;1;04;180;Saint-Sornin-Leulac;606;4;610
75;Nouvelle-Aquitaine;87;2;02;181;Saint-Sulpice-Laurière;831;17;848
75;Nouvelle-Aquitaine;87;1;04;182;Saint-Sulpice-les-Feuilles;1221;17;1238
75;Nouvelle-Aquitaine;87;2;02;183;Saint-Sylvestre;922;10;932
75;Nouvelle-Aquitaine;87;3;19;185;Saint-Victurnien;1761;29;1790
75;Nouvelle-Aquitaine;87;2;07;186;Saint-Vitte-sur-Briance;325;4;329
75;Nouvelle-Aquitaine;87;2;21;187;Saint-Yrieix-la-Perche;6729;432;7161
75;Nouvelle-Aquitaine;87;2;01;188;Saint-Yrieix-sous-Aixe;427;3;430
75;Nouvelle-Aquitaine;87;2;07;134;Sainte-Anne-Saint-Priest;163;3;166
75;Nouvelle-Aquitaine;87;3;18;162;Sainte-Marie-de-Vaux;207;2;209
75;Nouvelle-Aquitaine;87;3;18;189;Les Salles-Lavauguyon;141;1;142
75;Nouvelle-Aquitaine;87;2;20;190;Sauviat-sur-Vige;881;7;888
75;Nouvelle-Aquitaine;87;2;01;191;Séreilhac;1990;23;2013
75;Nouvelle-Aquitaine;87;2;05;192;Solignac;1583;24;1607
75;Nouvelle-Aquitaine;87;2;07;193;Surdoux;44;3;47
75;Nouvelle-Aquitaine;87;2;07;194;Sussac;351;3;354
75;Nouvelle-Aquitaine;87;1;04;195;Tersannes;137;1;138
75;Nouvelle-Aquitaine;87;1;03;197;Thouron;548;9;557
75;Nouvelle-Aquitaine;87;1;03;097;Val d'Issoire;1038;12;1050
75;Nouvelle-Aquitaine;87;1;  ;028;Val-d'Oire-et-Gartempe ;1655;22;1677
75;Nouvelle-Aquitaine;87;1;03;198;Vaulry;412;5;417
75;Nouvelle-Aquitaine;87;3;18;199;Vayres;741;13;754
75;Nouvelle-Aquitaine;87;1;04;200;Verneuil-Moustiers;128;0;128
75;Nouvelle-Aquitaine;87;2;01;201;Verneuil-sur-Vienne;4885;216;5101
75;Nouvelle-Aquitaine;87;2;06;202;Veyrac;2092;35;2127
75;Nouvelle-Aquitaine;87;2;07;203;Vicq-sur-Breuilh;1321;27;1348
75;Nouvelle-Aquitaine;87;3;18;204;Videix;204;4;208
75;Nouvelle-Aquitaine;87;2;05;205;Le Vigen;2201;39;2240
75;Nouvelle-Aquitaine;87;1;04;206;Villefavard;158;1;159
44;Grand Est;88;1;04;001;Les Ableuvenettes;60;0;60
44;Grand Est;88;1;04;002;Ahéville;71;0;71
44;Grand Est;88;2;17;003;Aingeville;61;1;62
44;Grand Est;88;2;04;004;Ainvelle;139;6;145
44;Grand Est;88;3;11;005;Allarmont;207;4;211
44;Grand Est;88;1;09;006;Ambacourt;290;8;298
44;Grand Est;88;2;04;007;Ameuvelle;49;1;50
44;Grand Est;88;1;11;008;Anglemont;168;3;171
44;Grand Est;88;3;07;009;Anould;3363;68;3431
44;Grand Est;88;2;09;010;Aouze;197;1;198
44;Grand Est;88;1;05;011;Arches;1629;53;1682
44;Grand Est;88;1;06;012;Archettes;1081;13;1094
44;Grand Est;88;2;09;013;Aroffe;83;0;83
44;Grand Est;88;3;07;014;Arrentès-de-Corcieux;181;5;186
44;Grand Est;88;2;10;015;Attignéville;210;3;213
44;Grand Est;88;2;04;016;Attigny;221;10;231
44;Grand Est;88;2;17;017;Aulnois;164;6;170
44;Grand Est;88;2;10;019;Autigny-la-Tour;154;3;157
44;Grand Est;88;2;10;020;Autreville;185;5;190
44;Grand Est;88;1;13;021;Autrey;282;12;294
44;Grand Est;88;2;17;022;Auzainvilliers;230;6;236
44;Grand Est;88;1;03;023;Avillers;82;2;84
44;Grand Est;88;1;03;024;Avrainville;115;0;115
44;Grand Est;88;2;10;025;Avranville;70;3;73
44;Grand Est;88;1;02;026;Aydoilles;1012;48;1060
44;Grand Est;88;1;02;027;Badménil-aux-Bois;149;6;155
44;Grand Est;88;1;06;028;La Baffe;620;94;714
44;Grand Est;88;1;04;030;Bainville-aux-Saules;142;0;142
44;Grand Est;88;2;09;031;Balléville;101;4;105
44;Grand Est;88;3;14;032;Ban-de-Laveline;1205;33;1238
44;Grand Est;88;3;11;033;Ban-de-Sapt;349;7;356
44;Grand Est;88;3;07;106;Ban-sur-Meurthe-Clefcy;947;29;976
44;Grand Est;88;3;07;035;Barbey-Seroux;146;6;152
44;Grand Est;88;2;10;036;Barville;95;2;97
44;Grand Est;88;3;01;037;Basse-sur-le-Rupt;867;27;894
44;Grand Est;88;1;03;038;Battexey;34;0;34
44;Grand Est;88;1;09;039;Baudricourt;327;7;334
44;Grand Est;88;1;02;040;Bayecourt;252;5;257
44;Grand Est;88;1;04;041;Bazegney;111;8;119
44;Grand Est;88;1;11;042;Bazien;79;1;80
44;Grand Est;88;2;17;043;Bazoilles-et-Ménil;110;3;113
44;Grand Est;88;2;10;044;Bazoilles-sur-Meuse;600;16;616
44;Grand Est;88;2;10;045;Beaufremont;89;0;89
44;Grand Est;88;1;02;046;Beauménil;129;4;133
44;Grand Est;88;1;04;047;Begnécourt;151;7;158
44;Grand Est;88;1;16;048;Bellefontaine;986;26;1012
44;Grand Est;88;2;04;049;Belmont-lès-Darney;113;2;115
44;Grand Est;88;1;02;050;Belmont-sur-Buttant;304;5;309
44;Grand Est;88;2;17;051;Belmont-sur-Vair;131;1;132
44;Grand Est;88;2;04;052;Belrupt;99;2;101
44;Grand Est;88;3;11;053;Belval;159;2;161
44;Grand Est;88;3;14;054;Bertrimoutier;305;10;315
44;Grand Est;88;1;03;055;Bettegney-Saint-Brice;167;0;167
44;Grand Est;88;1;03;056;Bettoncourt;96;2;98
44;Grand Est;88;3;14;057;Le Beulay;95;6;101
44;Grand Est;88;1;09;058;Biécourt;100;5;105
44;Grand Est;88;3;02;059;Biffontaine;401;12;413
44;Grand Est;88;1;09;060;Blémerey;30;1;31
44;Grand Est;88;2;04;061;Bleurville;303;13;316
44;Grand Est;88;2;04;062;Blevaincourt;103;2;105
44;Grand Est;88;1;04;063;Bocquegney;134;4;138
44;Grand Est;88;3;02;064;Bois-de-Champ;108;1;109
44;Grand Est;88;2;04;065;Bonvillet;293;5;298
44;Grand Est;88;1;09;066;Boulaincourt;70;4;74
44;Grand Est;88;3;13;068;La Bourgonce;900;20;920
44;Grand Est;88;1;03;069;Bouxières-aux-Bois;138;6;144
44;Grand Est;88;1;03;070;Bouxurulles;172;1;173
44;Grand Est;88;1;04;071;Bouzemont;52;1;53
44;Grand Est;88;1;03;073;Brantigny;214;4;218
44;Grand Est;88;2;10;074;Brechainville;60;0;60
44;Grand Est;88;3;01;075;La Bresse;4146;150;4296
44;Grand Est;88;1;02;076;Brouvelieures;440;10;450
44;Grand Est;88;1;11;077;Brû;564;14;578
44;Grand Est;88;1;02;078;Bruyères;3078;53;3131
44;Grand Est;88;2;17;079;Bulgnéville;1541;103;1644
44;Grand Est;88;1;03;080;Bult;307;2;309
44;Grand Est;88;1;15;081;Bussang;1360;23;1383
44;Grand Est;88;1;08;465;Capavenir Vosges;8748;227;8975
44;Grand Est;88;3;11;082;Celles-sur-Plaine;795;17;812
44;Grand Est;88;2;10;083;Certilleux;210;10;220
44;Grand Est;88;1;03;084;Chamagne;466;9;475
44;Grand Est;88;1;02;086;Champ-le-Duc;531;24;555
44;Grand Est;88;3;02;085;Champdray;183;2;185
44;Grand Est;88;1;05;087;Chantraine;3205;95;3300
44;Grand Est;88;1;16;088;La Chapelle-aux-Bois;670;8;678
44;Grand Est;88;3;07;089;La Chapelle-devant-Bruyères;569;14;583
44;Grand Est;88;1;03;090;Charmes;4700;55;4755
44;Grand Est;88;1;02;091;Charmois-devant-Bruyères;390;9;399
44;Grand Est;88;1;16;092;Charmois-l'Orgueilleux;592;8;600
44;Grand Est;88;3;11;093;Châtas;46;2;48
44;Grand Est;88;1;03;094;Châtel-sur-Moselle;1699;50;1749
44;Grand Est;88;2;09;095;Châtenois;1698;44;1742
44;Grand Est;88;2;04;096;Châtillon-sur-Saône;122;8;130
44;Grand Est;88;1;09;097;Chauffecourt;42;1;43
44;Grand Est;88;1;05;098;Chaumousey;902;25;927
44;Grand Est;88;1;08;099;Chavelot;1381;22;1403
44;Grand Est;88;1;09;100;Chef-Haut;46;2;48
44;Grand Est;88;1;02;101;Cheniménil;1232;23;1255
44;Grand Est;88;2;10;102;Chermisey;95;1;96
44;Grand Est;88;1;04;103;Circourt;87;2;89
44;Grand Est;88;2;10;104;Circourt-sur-Mouzon;188;10;198
44;Grand Est;88;2;04;105;Claudon;212;4;216
44;Grand Est;88;2;10;107;Clérey-la-Côte;33;0;33
44;Grand Est;88;1;16;108;Le Clerjus;537;19;556
44;Grand Est;88;3;12;109;Cleurie;646;13;659
44;Grand Est;88;1;03;110;Clézentaine;216;5;221
44;Grand Est;88;3;14;111;Coinches;357;4;361
44;Grand Est;88;3;14;113;Combrimont;134;1;135
44;Grand Est;88;2;17;114;Contrexéville;3192;223;3415
44;Grand Est;88;3;07;115;Corcieux;1519;14;1533
44;Grand Est;88;3;01;116;Cornimont;3159;72;3231
44;Grand Est;88;2;09;117;Courcelles-sous-Châtenois;78;1;79
44;Grand Est;88;2;10;118;Coussey;717;20;737
44;Grand Est;88;2;17;119;Crainvilliers;171;2;173
44;Grand Est;88;3;14;120;La Croix-aux-Mines;495;9;504
44;Grand Est;88;1;03;121;Damas-aux-Bois;269;6;275
44;Grand Est;88;1;04;122;Damas-et-Bettegney;365;7;372
44;Grand Est;88;2;04;123;Damblain;253;5;258
44;Grand Est;88;2;04;124;Darney;1078;53;1131
44;Grand Est;88;2;09;125;Darney-aux-Chênes;64;1;65
44;Grand Est;88;1;08;126;Darnieulles;1398;31;1429
44;Grand Est;88;1;03;127;Deinvillers;60;2;62
44;Grand Est;88;3;11;128;Denipaire;248;5;253
44;Grand Est;88;1;03;129;Derbamont;112;3;115
44;Grand Est;88;1;02;130;Destord;252;4;256
44;Grand Est;88;1;02;131;Deycimont;308;14;322
44;Grand Est;88;1;06;132;Deyvillers;1389;39;1428
44;Grand Est;88;1;06;133;Dignonville;195;9;204
44;Grand Est;88;1;05;134;Dinozé;611;13;624
44;Grand Est;88;1;02;135;Docelles;865;18;883
44;Grand Est;88;1;06;136;Dogneville;1485;27;1512
44;Grand Est;88;2;09;137;Dolaincourt;100;0;100
44;Grand Est;88;2;04;138;Dombasle-devant-Darney;80;2;82
44;Grand Est;88;1;09;139;Dombasle-en-Xaintois;122;1;123
44;Grand Est;88;2;17;140;Dombrot-le-Sec;372;14;386
44;Grand Est;88;2;17;141;Dombrot-sur-Vair;241;3;244
44;Grand Est;88;2;17;144;Domèvre-sous-Montfort;57;0;57
44;Grand Est;88;1;08;142;Domèvre-sur-Avière;400;8;408
44;Grand Est;88;1;02;143;Domèvre-sur-Durbion;271;14;285
44;Grand Est;88;1;02;145;Domfaing;216;3;219
44;Grand Est;88;2;17;146;Domjulien;175;2;177
44;Grand Est;88;1;04;147;Dommartin-aux-Bois;390;5;395
44;Grand Est;88;1;15;148;Dommartin-lès-Remiremont;1895;51;1946
44;Grand Est;88;2;04;149;Dommartin-lès-Vallois;54;0;54
44;Grand Est;88;2;09;150;Dommartin-sur-Vraine;301;6;307
44;Grand Est;88;1;04;151;Dompaire;1128;29;1157
44;Grand Est;88;1;02;152;Dompierre;254;14;268
44;Grand Est;88;1;11;153;Domptail;347;8;355
44;Grand Est;88;2;10;154;Domrémy-la-Pucelle;94;2;96
44;Grand Est;88;1;09;155;Domvallier;103;8;111
44;Grand Est;88;1;11;156;Doncières;135;2;137
44;Grand Est;88;1;16;157;Dounoux;853;18;871
44;Grand Est;88;1;12;158;Éloyes;3137;60;3197
44;Grand Est;88;3;14;159;Entre-deux-Eaux;501;8;509
44;Grand Est;88;1;98;160;Épinal;32223;1459;33682
44;Grand Est;88;2;04;161;Escles;435;12;447
44;Grand Est;88;2;04;162;Esley;192;5;197
44;Grand Est;88;1;03;163;Essegney;747;9;756
44;Grand Est;88;2;17;164;Estrennes;92;1;93
44;Grand Est;88;3;11;165;Étival-Clairefontaine;2618;53;2671
44;Grand Est;88;1;03;166;Évaux-et-Ménil;357;3;360
44;Grand Est;88;1;01;167;Faucompierre;236;5;241
44;Grand Est;88;1;03;168;Fauconcourt;131;2;133
44;Grand Est;88;1;02;169;Fays;219;9;228
44;Grand Est;88;1;15;170;Ferdrupt;722;17;739
44;Grand Est;88;2;04;171;Fignévelle;46;1;47
44;Grand Est;88;1;02;172;Fiménil;227;4;231
44;Grand Est;88;1;03;173;Florémont;455;12;467
44;Grand Est;88;1;08;174;Fomerey;154;4;158
44;Grand Est;88;1;02;175;Fontenay;464;21;485
44;Grand Est;88;1;16;176;Fontenoy-le-Château;521;35;556
44;Grand Est;88;3;01;177;La Forge;525;11;536
44;Grand Est;88;1;05;178;Les Forges;1850;69;1919
44;Grand Est;88;2;04;179;Fouchécourt;44;3;47
44;Grand Est;88;2;04;180;Frain;128;2;130
44;Grand Est;88;3;07;181;Fraize;2852;46;2898
44;Grand Est;88;3;14;182;Frapelle;193;9;202
44;Grand Est;88;2;10;183;Frebécourt;324;7;331
44;Grand Est;88;1;02;184;Fremifontaine;454;11;465
44;Grand Est;88;1;09;185;Frenelle-la-Grande;107;4;111
44;Grand Est;88;1;09;186;Frenelle-la-Petite;45;0;45
44;Grand Est;88;2;04;187;Frénois;53;1;54
44;Grand Est;88;1;15;188;Fresse-sur-Moselle;1733;48;1781
44;Grand Est;88;2;10;189;Fréville;138;4;142
44;Grand Est;88;1;08;190;Frizon;520;6;526
44;Grand Est;88;1;04;192;Gelvécourt-et-Adompt;108;1;109
44;Grand Est;88;3;14;193;Gemaingoutte;142;1;143
44;Grand Est;88;2;17;194;Gemmelaincourt;144;12;156
44;Grand Est;88;2;17;195;Gendreville;106;3;109
44;Grand Est;88;3;07;196;Gérardmer;7802;624;8426
44;Grand Est;88;3;01;197;Gerbamont;357;11;368
44;Grand Est;88;3;07;198;Gerbépal;595;12;607
44;Grand Est;88;2;04;199;Gignéville;80;3;83
44;Grand Est;88;1;08;200;Gigney;49;1;50
44;Grand Est;88;1;04;201;Girancourt;897;14;911
44;Grand Est;88;1;03;202;Gircourt-lès-Viéville;187;3;190
44;Grand Est;88;1;02;203;Girecourt-sur-Durbion;344;11;355
44;Grand Est;88;1;16;205;Girmont-Val-d'Ajol;257;17;274
44;Grand Est;88;2;09;206;Gironcourt-sur-Vraine;899;17;916
44;Grand Est;88;2;04;208;Godoncourt;117;4;121
44;Grand Est;88;1;08;209;Golbey;8714;122;8836
44;Grand Est;88;1;04;210;Gorhey;176;6;182
44;Grand Est;88;2;10;212;Grand;355;10;365
44;Grand Est;88;3;14;213;La Grande-Fosse;132;0;132
44;Grand Est;88;3;11;215;Grandrupt;77;2;79
44;Grand Est;88;2;16;214;Grandrupt-de-Bains;79;4;83
44;Grand Est;88;1;02;216;Grandvillers;743;12;755
44;Grand Est;88;3;07;218;Granges-Aumontzey;2630;57;2687
44;Grand Est;88;2;10;219;Greux;153;6;159
44;Grand Est;88;2;04;220;Grignoncourt;43;1;44
44;Grand Est;88;1;16;221;Gruey-lès-Surance;250;12;262
44;Grand Est;88;1;02;222;Gugnécourt;245;19;264
44;Grand Est;88;1;03;223;Gugney-aux-Aulx;161;7;168
44;Grand Est;88;1;03;224;Hadigny-les-Verrières;397;12;409
44;Grand Est;88;1;16;225;Hadol;2358;105;2463
44;Grand Est;88;1;04;226;Hagécourt;125;3;128
44;Grand Est;88;2;17;227;Hagnéville-et-Roncourt;87;1;88
44;Grand Est;88;1;03;228;Haillainville;171;4;175
44;Grand Est;88;2;10;229;Harchéchamp;76;4;80
44;Grand Est;88;1;03;230;Hardancourt;41;0;41
44;Grand Est;88;2;17;231;Haréville;480;18;498
44;Grand Est;88;2;10;232;Harmonville;224;4;228
44;Grand Est;88;1;04;233;Harol;629;52;681
44;Grand Est;88;1;16;236;La Haye;120;0;120
44;Grand Est;88;1;04;237;Hennecourt;363;7;370
44;Grand Est;88;2;04;238;Hennezel;398;12;410
44;Grand Est;88;1;03;239;Hergugney;132;3;135
44;Grand Est;88;1;02;240;Herpelmont;283;2;285
44;Grand Est;88;2;09;241;Houécourt;441;12;453
44;Grand Est;88;2;10;242;Houéville;48;1;49
44;Grand Est;88;1;13;243;Housseras;486;7;493
44;Grand Est;88;3;07;244;La Houssière;567;18;585
44;Grand Est;88;3;11;245;Hurbache;319;13;332
44;Grand Est;88;1;09;246;Hymont;480;12;492
44;Grand Est;88;1;08;247;Igney;1165;14;1179
44;Grand Est;88;2;04;248;Isches;169;4;173
44;Grand Est;88;2;10;249;Jainvillotte;77;3;80
44;Grand Est;88;1;12;250;Jarménil;475;5;480
44;Grand Est;88;1;13;251;Jeanménil;1116;34;1150
44;Grand Est;88;2;04;252;Jésonville;126;7;133
44;Grand Est;88;1;06;253;Jeuxey;685;16;701
44;Grand Est;88;1;03;254;Jorxey;82;1;83
44;Grand Est;88;2;10;255;Jubainville;91;3;94
44;Grand Est;88;1;02;256;Jussarupt;273;4;277
44;Grand Est;88;1;09;257;Juvaincourt;183;3;186
44;Grand Est;88;2;04;258;Lamarche;864;16;880
44;Grand Est;88;2;10;259;Landaville;299;9;308
44;Grand Est;88;1;03;260;Langley;158;2;160
44;Grand Est;88;1;02;261;Laval-sur-Vologne;626;11;637
44;Grand Est;88;1;02;262;Laveline-devant-Bruyères;591;12;603
44;Grand Est;88;1;02;263;Laveline-du-Houx;205;6;211
44;Grand Est;88;1;04;264;Légéville-et-Bonfays;55;3;58
44;Grand Est;88;2;10;265;Lemmecourt;30;0;30
44;Grand Est;88;1;02;266;Lépanges-sur-Vologne;843;19;862
44;Grand Est;88;2;04;267;Lerrain;458;16;474
44;Grand Est;88;3;14;268;Lesseux;146;8;154
44;Grand Est;88;3;07;269;Liézey;294;7;301
44;Grand Est;88;2;10;270;Liffol-le-Grand;2134;59;2193
44;Grand Est;88;2;17;271;Lignéville;312;7;319
44;Grand Est;88;2;04;272;Lironcourt;70;0;70
44;Grand Est;88;1;06;273;Longchamp;450;11;461
44;Grand Est;88;2;09;274;Longchamp-sous-Châtenois;76;1;77
44;Grand Est;88;3;14;275;Lubine;236;2;238
44;Grand Est;88;3;14;276;Lusse;415;16;431
44;Grand Est;88;3;11;277;Luvigny;117;3;120
44;Grand Est;88;2;09;278;Maconcourt;73;1;74
44;Grand Est;88;1;09;279;Madecourt;51;1;52
44;Grand Est;88;1;03;280;Madegney;131;0;131
44;Grand Est;88;1;04;281;Madonne-et-Lamerey;403;12;415
44;Grand Est;88;2;17;283;Malaincourt;83;2;85
44;Grand Est;88;3;14;284;Mandray;585;12;597
44;Grand Est;88;2;17;285;Mandres-sur-Vair;449;125;574
44;Grand Est;88;1;03;286;Marainville-sur-Madon;96;0;96
44;Grand Est;88;2;04;287;Marey;64;1;65
44;Grand Est;88;1;04;288;Maroncourt;7;0;7
44;Grand Est;88;2;04;289;Martigny-les-Bains;810;69;879
44;Grand Est;88;2;10;290;Martigny-les-Gerbonvaux;108;2;110
44;Grand Est;88;2;04;291;Martinvelle;125;3;128
44;Grand Est;88;1;09;292;Mattaincourt;815;24;839
44;Grand Est;88;2;10;293;Maxey-sur-Meuse;221;4;225
44;Grand Est;88;1;08;294;Mazeley;265;3;268
44;Grand Est;88;1;09;295;Mazirot;226;7;233
44;Grand Est;88;2;17;296;Médonville;87;0;87
44;Grand Est;88;1;02;297;Méménil;152;5;157
44;Grand Est;88;1;11;298;Ménarmont;71;0;71
44;Grand Est;88;1;15;302;Le Ménil;1048;23;1071
44;Grand Est;88;3;11;300;Ménil-de-Senones;135;6;141
44;Grand Est;88;2;09;299;Ménil-en-Xaintois;150;1;151
44;Grand Est;88;1;11;301;Ménil-sur-Belvitte;298;11;309
44;Grand Est;88;2;10;303;Midrevaux;211;1;212
44;Grand Est;88;1;09;304;Mirecourt;5078;501;5579
44;Grand Est;88;2;10;305;Moncel-sur-Vair;198;5;203
44;Grand Est;88;3;11;306;Le Mont;51;0;51
44;Grand Est;88;2;04;307;Mont-lès-Lamarche;96;2;98
44;Grand Est;88;2;10;308;Mont-lès-Neufchâteau;301;5;306
44;Grand Est;88;2;17;309;Monthureux-le-Sec;158;9;167
44;Grand Est;88;2;04;310;Monthureux-sur-Saône;894;18;912
44;Grand Est;88;1;16;311;Montmotier;41;1;42
44;Grand Est;88;2;09;312;Morelmaison;202;5;207
44;Grand Est;88;1;03;313;Moriville;429;8;437
44;Grand Est;88;2;04;314;Morizécourt;104;4;108
44;Grand Est;88;3;02;315;Mortagne;171;2;173
44;Grand Est;88;2;17;316;Morville;49;2;51
44;Grand Est;88;3;11;317;Moussey;590;5;595
44;Grand Est;88;1;03;318;Moyemont;225;5;230
44;Grand Est;88;3;11;319;Moyenmoutier;3138;65;3203
44;Grand Est;88;3;14;320;Nayemont-les-Fosses;791;39;830
44;Grand Est;88;2;10;321;Neufchâteau;6642;284;6926
44;Grand Est;88;1;02;322;La Neuveville-devant-Lépanges;497;12;509
44;Grand Est;88;2;09;324;La Neuveville-sous-Châtenois;374;10;384
44;Grand Est;88;2;17;325;La Neuveville-sous-Montfort;180;7;187
44;Grand Est;88;3;14;326;Neuvillers-sur-Fave;344;10;354
44;Grand Est;88;1;03;327;Nomexy;2054;23;2077
44;Grand Est;88;3;11;328;Nompatelize;541;23;564
44;Grand Est;88;2;04;330;Nonville;197;2;199
44;Grand Est;88;1;02;331;Nonzeville;52;2;54
44;Grand Est;88;2;17;332;Norroy;218;6;224
44;Grand Est;88;1;11;333;Nossoncourt;120;1;121
44;Grand Est;88;1;09;334;Oëlleville;308;5;313
44;Grand Est;88;2;17;335;Offroicourt;152;3;155
44;Grand Est;88;2;09;336;Ollainville;70;1;71
44;Grand Est;88;1;03;338;Ortoncourt;87;0;87
44;Grand Est;88;1;02;340;Padoux;507;10;517
44;Grand Est;88;3;14;341;Pair-et-Grandrupt;515;10;525
44;Grand Est;88;1;02;342;Pallegney;164;3;167
44;Grand Est;88;2;17;343;Parey-sous-Montfort;154;4;158
44;Grand Est;88;2;10;344;Pargny-sous-Mureau;182;5;187
44;Grand Est;88;3;14;345;La Petite-Fosse;75;3;78
44;Grand Est;88;3;11;346;La Petite-Raon;745;12;757
44;Grand Est;88;1;04;347;Pierrefitte;116;1;117
44;Grand Est;88;1;02;348;Pierrepont-sur-l'Arentèle;133;2;135
44;Grand Est;88;3;07;349;Plainfaing;1645;26;1671
44;Grand Est;88;2;09;350;Pleuvezain;79;3;82
44;Grand Est;88;1;16;351;Plombières-les-Bains;1641;35;1676
44;Grand Est;88;2;10;352;Pompierre;207;5;212
44;Grand Est;88;2;04;353;Pont-lès-Bonfays;108;3;111
44;Grand Est;88;1;03;354;Pont-sur-Madon;181;0;181
44;Grand Est;88;1;03;355;Portieux;1249;21;1270
44;Grand Est;88;3;02;356;Les Poulières;256;4;260
44;Grand Est;88;1;09;357;Poussay;689;21;710
44;Grand Est;88;1;12;358;Pouxeux;1993;35;2028
44;Grand Est;88;1;02;359;Prey;91;2;93
44;Grand Est;88;3;14;361;Provenchères-et-Colroy;1354;114;1468
44;Grand Est;88;2;04;360;Provenchères-lès-Darney;158;5;163
44;Grand Est;88;3;11;362;Le Puid;107;1;108
44;Grand Est;88;2;10;363;Punerot;157;5;162
44;Grand Est;88;1;09;364;Puzieux;146;3;149
44;Grand Est;88;1;04;365;Racécourt;165;10;175
44;Grand Est;88;2;09;366;Rainville;279;12;291
44;Grand Est;88;1;13;367;Rambervillers;5139;135;5274
44;Grand Est;88;1;09;368;Ramecourt;189;4;193
44;Grand Est;88;1;15;369;Ramonchamp;1933;138;2071
44;Grand Est;88;1;17;370;Rancourt;60;1;61
44;Grand Est;88;1;12;371;Raon-aux-Bois;1234;18;1252
44;Grand Est;88;3;11;372;Raon-l'Étape;6297;145;6442
44;Grand Est;88;3;11;373;Raon-sur-Plaine;145;2;147
44;Grand Est;88;1;03;374;Rapey;23;0;23
44;Grand Est;88;3;14;375;Raves;470;7;477
44;Grand Est;88;2;10;376;Rebeuville;280;7;287
44;Grand Est;88;2;04;377;Regnévelle;124;2;126
44;Grand Est;88;1;03;378;Regney;92;2;94
44;Grand Est;88;1;03;379;Rehaincourt;363;6;369
44;Grand Est;88;3;02;380;Rehaupal;210;2;212
44;Grand Est;88;2;04;381;Relanges;204;12;216
44;Grand Est;88;1;09;382;Remicourt;64;1;65
44;Grand Est;88;1;12;383;Remiremont;7691;300;7991
44;Grand Est;88;3;14;386;Remomeix;468;4;472
44;Grand Est;88;2;17;385;Remoncourt;577;10;587
44;Grand Est;88;2;09;387;Removille;215;4;219
44;Grand Est;88;1;05;388;Renauvoid;119;3;122
44;Grand Est;88;1;09;389;Repel;82;0;82
44;Grand Est;88;2;04;390;Robécourt;107;8;115
44;Grand Est;88;3;01;391;Rochesson;693;17;710
44;Grand Est;88;2;10;393;Rollainville;306;9;315
44;Grand Est;88;2;04;394;Romain-aux-Bois;51;0;51
44;Grand Est;88;1;03;395;Romont;381;8;389
44;Grand Est;88;3;02;398;Les Rouges-Eaux;88;4;92
44;Grand Est;88;1;02;399;Le Roulier;199;4;203
44;Grand Est;88;1;09;400;Rouvres-en-Xaintois;281;13;294
44;Grand Est;88;2;10;401;Rouvres-la-Chétive;448;9;457
44;Grand Est;88;1;11;402;Roville-aux-Chênes;369;150;519
44;Grand Est;88;2;17;403;Rozerotte;191;2;193
44;Grand Est;88;2;04;404;Rozières-sur-Mouzon;65;1;66
44;Grand Est;88;1;03;406;Rugney;138;1;139
44;Grand Est;88;2;10;407;Ruppes;140;3;143
44;Grand Est;88;1;15;408;Rupt-sur-Moselle;3528;67;3595
44;Grand Est;88;1;12;409;Saint-Amé;2149;38;2187
44;Grand Est;88;2;04;411;Saint-Baslemont;79;1;80
44;Grand Est;88;1;11;412;Saint-Benoît-la-Chipotte;428;9;437
44;Grand Est;88;3;99;413;Saint-Dié-des-Vosges;19724;526;20250
44;Grand Est;88;1;12;415;Saint-Étienne-lès-Remiremont;3842;80;3922
44;Grand Est;88;1;03;416;Saint-Genest;138;2;140
44;Grand Est;88;1;13;417;Saint-Gorgon;392;9;401
44;Grand Est;88;3;11;419;Saint-Jean-d'Ormont;120;0;120
44;Grand Est;88;2;04;421;Saint-Julien;109;2;111
44;Grand Est;88;3;14;423;Saint-Léonard;1351;22;1373
44;Grand Est;88;1;03;425;Saint-Maurice-sur-Mortagne;180;5;185
44;Grand Est;88;1;15;426;Saint-Maurice-sur-Moselle;1385;37;1422
44;Grand Est;88;2;09;427;Saint-Menge;127;1;128
44;Grand Est;88;3;13;428;Saint-Michel-sur-Meurthe;1851;57;1908
44;Grand Est;88;1;12;429;Saint-Nabord;4023;251;4274
44;Grand Est;88;2;17;430;Saint-Ouen-lès-Parey;499;13;512
44;Grand Est;88;2;09;431;Saint-Paul;160;3;163
44;Grand Est;88;1;11;432;Saint-Pierremont;152;3;155
44;Grand Est;88;1;09;433;Saint-Prancher;79;1;80
44;Grand Est;88;2;17;434;Saint-Remimont;223;4;227
44;Grand Est;88;3;11;435;Saint-Remy;519;12;531
44;Grand Est;88;3;11;436;Saint-Stail;72;1;73
44;Grand Est;88;1;03;437;Saint-Vallier;99;3;102
44;Grand Est;88;1;11;410;Sainte-Barbe;273;4;277
44;Grand Est;88;1;02;418;Sainte-Hélène;455;4;459
44;Grand Est;88;3;14;424;Sainte-Marguerite;2314;69;2383
44;Grand Est;88;3;13;438;La Salle;393;7;400
44;Grand Est;88;1;05;439;Sanchey;943;36;979
44;Grand Est;88;2;09;440;Sandaucourt;171;4;175
44;Grand Est;88;2;04;441;Sans-Vallois;131;2;133
44;Grand Est;88;3;01;442;Sapois;638;9;647
44;Grand Est;88;2;10;443;Sartes;96;2;98
44;Grand Est;88;3;11;444;Le Saulcy;328;11;339
44;Grand Est;88;3;14;445;Saulcy-sur-Meurthe;2326;56;2382
44;Grand Est;88;2;17;446;Saulxures-lès-Bulgnéville;251;2;253
44;Grand Est;88;3;01;447;Saulxures-sur-Moselotte;2540;80;2620
44;Grand Est;88;2;17;448;Sauville;180;7;187
44;Grand Est;88;1;03;449;Savigny;184;0;184
44;Grand Est;88;2;04;450;Senaide;183;1;184
44;Grand Est;88;3;11;451;Senones;2439;35;2474
44;Grand Est;88;2;04;452;Senonges;131;0;131
44;Grand Est;88;2;10;453;Seraumont;38;0;38
44;Grand Est;88;1;02;454;Sercœur;235;10;245
44;Grand Est;88;2;04;455;Serécourt;99;6;105
44;Grand Est;88;2;04;456;Serocourt;87;3;90
44;Grand Est;88;2;10;457;Sionne;141;1;142
44;Grand Est;88;1;03;458;Socourt;272;3;275
44;Grand Est;88;2;09;459;Soncourt;44;1;45
44;Grand Est;88;2;10;460;Soulosse-sous-Saint-Élophe;649;13;662
44;Grand Est;88;2;17;461;Suriauville;215;0;215
44;Grand Est;88;3;01;462;Le Syndicat;1885;40;1925
44;Grand Est;88;3;13;463;Taintrux;1535;42;1577
44;Grand Est;88;3;01;464;Tendon;513;8;521
44;Grand Est;88;2;17;466;They-sous-Montfort;128;5;133
44;Grand Est;88;3;01;467;Thiéfosse;581;15;596
44;Grand Est;88;1;15;468;Le Thillot;3405;56;3461
44;Grand Est;88;1;09;469;Thiraucourt;99;4;103
44;Grand Est;88;3;01;470;Le Tholy;1566;43;1609
44;Grand Est;88;2;04;471;Les Thons;103;1;104
44;Grand Est;88;2;17;472;Thuillières;119;4;123
44;Grand Est;88;2;04;473;Tignécourt;106;4;110
44;Grand Est;88;2;10;474;Tilleux;61;0;61
44;Grand Est;88;2;04;475;Tollaincourt;124;5;129
44;Grand Est;88;1;09;476;Totainville;119;1;120
44;Grand Est;88;2;10;477;Trampot;94;1;95
44;Grand Est;88;2;10;478;Tranqueville-Graux;104;1;105
44;Grand Est;88;1;16;479;Trémonzey;255;4;259
44;Grand Est;88;1;03;480;Ubexy;171;0;171
44;Grand Est;88;1;16;481;Uriménil;1348;22;1370
44;Grand Est;88;2;17;482;Urville;57;2;59
44;Grand Est;88;1;08;483;Uxegney;2282;66;2348
44;Grand Est;88;1;16;484;Uzemain;1046;30;1076
44;Grand Est;88;2;17;485;La Vacheresse-et-la-Rouillie;122;0;122
44;Grand Est;88;3;01;486;Vagney;3918;108;4026
44;Grand Est;88;1;16;487;Le Val-d'Ajol;3857;99;3956
44;Grand Est;88;2;17;488;Valfroicourt;239;5;244
44;Grand Est;88;1;09;489;Valleroy-aux-Saules;257;8;265
44;Grand Est;88;2;17;490;Valleroy-le-Sec;172;4;176
44;Grand Est;88;2;04;491;Les Vallois;120;5;125
44;Grand Est;88;3;07;492;Le Valtin;73;2;75
44;Grand Est;88;1;03;493;Varmonzey;25;1;26
44;Grand Est;88;1;04;494;Vaubexy;124;2;126
44;Grand Est;88;1;06;495;Vaudéville;170;7;177
44;Grand Est;88;2;17;496;Vaudoncourt;158;3;161
44;Grand Est;88;1;08;497;Vaxoncourt;446;8;454
44;Grand Est;88;1;15;498;Vecoux;865;21;886
44;Grand Est;88;1;04;499;Velotte-et-Tatignécourt;161;3;164
44;Grand Est;88;3;01;500;Ventron;835;14;849
44;Grand Est;88;3;11;501;Le Vermont;70;0;70
44;Grand Est;88;1;02;502;Vervezelle;132;4;136
44;Grand Est;88;3;11;503;Vexaincourt;151;3;154
44;Grand Est;88;2;09;504;Vicherey;202;4;206
44;Grand Est;88;3;07;505;Vienville;124;2;126
44;Grand Est;88;3;11;506;Vieux-Moulin;316;6;322
44;Grand Est;88;1;04;508;Ville-sur-Illon;550;11;561
44;Grand Est;88;1;09;507;Villers;205;6;211
44;Grand Est;88;1;02;509;Villoncourt;109;1;110
44;Grand Est;88;2;04;510;Villotte;154;0;154
44;Grand Est;88;2;10;511;Villouxel;84;2;86
44;Grand Est;88;1;02;512;Viménil;249;3;252
44;Grand Est;88;1;03;513;Vincey;2183;26;2209
44;Grand Est;88;2;09;514;Viocourt;158;7;165
44;Grand Est;88;2;16;515;Vioménil;149;2;151
44;Grand Est;88;2;17;516;Vittel;4951;141;5092
44;Grand Est;88;2;04;517;Viviers-le-Gras;200;3;203
44;Grand Est;88;2;17;518;Viviers-lès-Offroicourt;36;0;36
44;Grand Est;88;1;16;029;Vôge-les-Bains ;1618;127;1745
44;Grand Est;88;3;13;519;La Voivre;682;22;704
44;Grand Est;88;1;16;520;Les Voivres;304;9;313
44;Grand Est;88;1;03;521;Vomécourt;263;3;266
44;Grand Est;88;1;03;522;Vomécourt-sur-Madon;70;3;73
44;Grand Est;88;2;09;523;Vouxey;146;5;151
44;Grand Est;88;2;17;524;Vrécourt;361;4;365
44;Grand Est;88;1;09;525;Vroville;129;2;131
44;Grand Est;88;3;14;526;Wisembach;414;10;424
44;Grand Est;88;1;11;527;Xaffévillers;149;2;151
44;Grand Est;88;1;02;528;Xamontarupt;156;3;159
44;Grand Est;88;1;03;529;Xaronval;111;4;115
44;Grand Est;88;1;16;530;Xertigny;2598;49;2647
44;Grand Est;88;3;07;531;Xonrupt-Longemer;1522;50;1572
44;Grand Est;88;1;02;532;Zincourt;80;4;84
27;Bourgogne-Franche-Comté;89;1;07;002;Aigremont;78;3;81
27;Bourgogne-Franche-Comté;89;2;19;004;Aisy-sur-Armançon;241;11;252
27;Bourgogne-Franche-Comté;89;2;19;005;Ancy-le-Franc;880;23;903
27;Bourgogne-Franche-Comté;89;2;19;006;Ancy-le-Libre;172;7;179
27;Bourgogne-Franche-Comté;89;1;21;007;Andryes;412;11;423
27;Bourgogne-Franche-Comté;89;2;07;008;Angely;157;7;164
27;Bourgogne-Franche-Comté;89;2;05;009;Annay-la-Côte;351;17;368
27;Bourgogne-Franche-Comté;89;2;07;010;Annay-sur-Serein;210;5;215
27;Bourgogne-Franche-Comté;89;2;05;011;Annéot;124;10;134
27;Bourgogne-Franche-Comté;89;2;07;012;Annoux;85;2;87
27;Bourgogne-Franche-Comté;89;1;02;013;Appoigny;3248;50;3298
27;Bourgogne-Franche-Comté;89;3;06;014;Arces-Dilo;608;8;616
27;Bourgogne-Franche-Comté;89;2;12;015;Arcy-sur-Cure;479;12;491
27;Bourgogne-Franche-Comté;89;2;19;016;Argentenay;79;3;82
27;Bourgogne-Franche-Comté;89;2;19;017;Argenteuil-sur-Armançon;217;2;219
27;Bourgogne-Franche-Comté;89;3;20;018;Armeau;770;6;776
27;Bourgogne-Franche-Comté;89;2;19;019;Arthonnay;151;1;152
27;Bourgogne-Franche-Comté;89;2;12;020;Asnières-sous-Bois;119;2;121
27;Bourgogne-Franche-Comté;89;2;12;021;Asquins;295;13;308
27;Bourgogne-Franche-Comté;89;2;05;022;Athie;134;3;137
27;Bourgogne-Franche-Comté;89;1;03;023;Augy;1034;23;1057
27;Bourgogne-Franche-Comté;89;1;98;024;Auxerre;34764;1178;35942
27;Bourgogne-Franche-Comté;89;2;05;025;Avallon;6513;221;6734
27;Bourgogne-Franche-Comté;89;3;06;027;Bagneaux;207;5;212
27;Bourgogne-Franche-Comté;89;2;19;028;Baon;68;6;74
27;Bourgogne-Franche-Comté;89;1;13;029;Bassou;874;20;894
27;Bourgogne-Franche-Comté;89;1;12;030;Bazarnes;418;9;427
27;Bourgogne-Franche-Comté;89;1;15;031;Beaumont;637;12;649
27;Bourgogne-Franche-Comté;89;2;05;032;Beauvilliers;71;3;74
27;Bourgogne-Franche-Comté;89;1;09;033;Beauvoir;393;11;404
27;Bourgogne-Franche-Comté;89;1;07;034;Beine;478;13;491
27;Bourgogne-Franche-Comté;89;1;06;035;Bellechaume;442;14;456
27;Bourgogne-Franche-Comté;89;3;10;036;La Belliole;249;7;256
27;Bourgogne-Franche-Comté;89;3;11;037;Béon;514;18;532
27;Bourgogne-Franche-Comté;89;2;19;038;Bernouil;110;0;110
27;Bourgogne-Franche-Comté;89;1;07;039;Béru;76;4;80
27;Bourgogne-Franche-Comté;89;1;12;040;Bessy-sur-Cure;190;3;193
27;Bourgogne-Franche-Comté;89;1;15;041;Beugnon;304;15;319
27;Bourgogne-Franche-Comté;89;2;07;042;Bierry-les-Belles-Fontaines;178;5;183
27;Bourgogne-Franche-Comté;89;2;07;043;Blacy;102;1;103
27;Bourgogne-Franche-Comté;89;2;12;044;Blannay;110;1;111
27;Bourgogne-Franche-Comté;89;1;03;045;Bleigny-le-Carreau;289;7;296
27;Bourgogne-Franche-Comté;89;1;09;046;Bléneau;1232;18;1250
27;Bourgogne-Franche-Comté;89;2;12;049;Bois-d'Arcy;22;3;25
27;Bourgogne-Franche-Comté;89;1;13;050;Bonnard;871;11;882
27;Bourgogne-Franche-Comté;89;3;20;051;Les Bordes;547;12;559
27;Bourgogne-Franche-Comté;89;1;02;053;Branches;446;10;456
27;Bourgogne-Franche-Comté;89;3;10;054;Brannay;790;10;800
27;Bourgogne-Franche-Comté;89;1;06;055;Brienon-sur-Armançon;3173;70;3243
27;Bourgogne-Franche-Comté;89;3;13;056;Brion;628;14;642
27;Bourgogne-Franche-Comté;89;2;12;057;Brosses;303;4;307
27;Bourgogne-Franche-Comté;89;2;05;058;Bussières;124;2;126
27;Bourgogne-Franche-Comté;89;3;13;059;Bussy-en-Othe;723;11;734
27;Bourgogne-Franche-Comté;89;3;20;060;Bussy-le-Repos;454;11;465
27;Bourgogne-Franche-Comté;89;1;15;061;Butteaux;252;3;255
27;Bourgogne-Franche-Comté;89;3;06;048;Bœurs-en-Othe;342;7;349
27;Bourgogne-Franche-Comté;89;1;07;062;Carisey;357;4;361
27;Bourgogne-Franche-Comté;89;3;11;063;La Celle-Saint-Cyr;810;19;829
27;Bourgogne-Franche-Comté;89;2;07;064;Censy;56;1;57
27;Bourgogne-Franche-Comté;89;3;06;065;Cérilly;39;1;40
27;Bourgogne-Franche-Comté;89;3;06;066;Cerisiers;978;24;1002
27;Bourgogne-Franche-Comté;89;3;11;067;Cézy;1111;16;1127
27;Bourgogne-Franche-Comté;89;1;07;068;Chablis;2240;39;2279
27;Bourgogne-Franche-Comté;89;1;15;069;Chailley;537;11;548
27;Bourgogne-Franche-Comté;89;2;12;071;Chamoux;102;0;102
27;Bourgogne-Franche-Comté;89;1;09;072;Champcevrais;308;3;311
27;Bourgogne-Franche-Comté;89;1;09;073;Champignelles;957;41;998
27;Bourgogne-Franche-Comté;89;3;14;074;Champigny;2161;42;2203
27;Bourgogne-Franche-Comté;89;3;11;075;Champlay;722;11;733
27;Bourgogne-Franche-Comté;89;1;06;076;Champlost;785;11;796
27;Bourgogne-Franche-Comté;89;1;03;077;Champs-sur-Yonne;1570;92;1662
27;Bourgogne-Franche-Comté;89;3;08;079;Chamvres;660;23;683
27;Bourgogne-Franche-Comté;89;3;18;080;La Chapelle-sur-Oreuse;631;4;635
27;Bourgogne-Franche-Comté;89;1;07;081;La Chapelle-Vaupelteigne;89;0;89
27;Bourgogne-Franche-Comté;89;1;02;083;Charbuy;1860;47;1907
27;Bourgogne-Franche-Comté;89;1;21;084;Charentenay;289;5;294
27;Bourgogne-Franche-Comté;89;1;13;085;Charmoy;1152;24;1176
27;Bourgogne-Franche-Comté;89;1;08;086;Charny Orée de Puisaye;4854;72;4926
27;Bourgogne-Franche-Comté;89;2;19;087;Chassignelles;306;9;315
27;Bourgogne-Franche-Comté;89;1;08;088;Chassy;461;12;473
27;Bourgogne-Franche-Comté;89;2;05;089;Chastellux-sur-Cure;136;5;141
27;Bourgogne-Franche-Comté;89;2;12;091;Châtel-Censoir;622;15;637
27;Bourgogne-Franche-Comté;89;2;07;092;Châtel-Gérard;211;11;222
27;Bourgogne-Franche-Comté;89;3;14;093;Chaumont;650;11;661
27;Bourgogne-Franche-Comté;89;3;20;094;Chaumot;734;16;750
27;Bourgogne-Franche-Comté;89;1;07;095;Chemilly-sur-Serein;144;8;152
27;Bourgogne-Franche-Comté;89;1;15;096;Chemilly-sur-Yonne;908;26;934
27;Bourgogne-Franche-Comté;89;2;19;098;Cheney;229;6;235
27;Bourgogne-Franche-Comté;89;1;13;099;Cheny;2424;39;2463
27;Bourgogne-Franche-Comté;89;3;10;100;Chéroy;1665;16;1681
27;Bourgogne-Franche-Comté;89;1;15;101;Chéu;560;11;571
27;Bourgogne-Franche-Comté;89;1;04;102;Chevannes;2174;64;2238
27;Bourgogne-Franche-Comté;89;1;07;104;Chichée;308;13;321
27;Bourgogne-Franche-Comté;89;1;13;105;Chichery;487;17;504
27;Bourgogne-Franche-Comté;89;1;07;108;Chitry;349;9;358
27;Bourgogne-Franche-Comté;89;3;06;111;Les Clérimois;299;5;304
27;Bourgogne-Franche-Comté;89;2;19;112;Collan;168;8;176
27;Bourgogne-Franche-Comté;89;3;10;113;Collemiers;667;17;684
27;Bourgogne-Franche-Comté;89;3;18;115;Compigny;202;8;210
27;Bourgogne-Franche-Comté;89;3;10;116;Cornant;355;7;362
27;Bourgogne-Franche-Comté;89;1;21;117;Coulangeron;217;1;218
27;Bourgogne-Franche-Comté;89;1;21;118;Coulanges-la-Vineuse;815;19;834
27;Bourgogne-Franche-Comté;89;1;12;119;Coulanges-sur-Yonne;532;10;542
27;Bourgogne-Franche-Comté;89;3;06;120;Coulours;131;3;134
27;Bourgogne-Franche-Comté;89;3;06;122;Courgenay;571;9;580
27;Bourgogne-Franche-Comté;89;1;07;123;Courgis;258;8;266
27;Bourgogne-Franche-Comté;89;3;18;124;Courlon-sur-Yonne;1194;20;1214
27;Bourgogne-Franche-Comté;89;1;21;125;Courson-les-Carrières;940;20;960
27;Bourgogne-Franche-Comté;89;3;10;126;Courtoin;34;1;35
27;Bourgogne-Franche-Comté;89;3;14;127;Courtois-sur-Yonne;784;24;808
27;Bourgogne-Franche-Comté;89;2;12;128;Coutarnoux;138;4;142
27;Bourgogne-Franche-Comté;89;1;12;129;Crain;405;9;414
27;Bourgogne-Franche-Comté;89;2;19;131;Cruzy-le-Châtel;237;4;241
27;Bourgogne-Franche-Comté;89;2;19;132;Cry;167;6;173
27;Bourgogne-Franche-Comté;89;3;11;133;Cudot;348;4;352
27;Bourgogne-Franche-Comté;89;2;05;134;Cussy-les-Forges;333;8;341
27;Bourgogne-Franche-Comté;89;3;18;136;Cuy;861;30;891
27;Bourgogne-Franche-Comté;89;2;19;137;Dannemoine;474;10;484
27;Bourgogne-Franche-Comté;89;1;12;130;Deux Rivières;1263;29;1292
27;Bourgogne-Franche-Comté;89;1;09;139;Diges;1122;36;1158
27;Bourgogne-Franche-Comté;89;2;12;141;Dissangis;119;7;126
27;Bourgogne-Franche-Comté;89;3;20;142;Dixmont;917;26;943
27;Bourgogne-Franche-Comté;89;3;10;143;Dollot;317;3;320
27;Bourgogne-Franche-Comté;89;3;10;144;Domats;815;14;829
27;Bourgogne-Franche-Comté;89;2;12;145;Domecy-sur-Cure;383;12;395
27;Bourgogne-Franche-Comté;89;2;05;146;Domecy-sur-le-Vault;87;3;90
27;Bourgogne-Franche-Comté;89;1;09;147;Dracy;225;2;227
27;Bourgogne-Franche-Comté;89;1;21;148;Druyes-les-Belles-Fontaines;272;4;276
27;Bourgogne-Franche-Comté;89;2;19;149;Dyé;212;6;218
27;Bourgogne-Franche-Comté;89;1;09;150;Égleny;449;9;458
27;Bourgogne-Franche-Comté;89;3;10;151;Égriselles-le-Bocage;1321;21;1342
27;Bourgogne-Franche-Comté;89;1;13;152;Épineau-les-Voves;742;15;757
27;Bourgogne-Franche-Comté;89;2;19;153;Épineuil;576;17;593
27;Bourgogne-Franche-Comté;89;1;21;154;Escamps;887;24;911
27;Bourgogne-Franche-Comté;89;1;21;155;Escolives-Sainte-Camille;695;11;706
27;Bourgogne-Franche-Comté;89;1;06;156;Esnon;393;7;400
27;Bourgogne-Franche-Comté;89;1;21;158;Étais-la-Sauvin;627;15;642
27;Bourgogne-Franche-Comté;89;2;05;159;Étaule;380;10;390
27;Bourgogne-Franche-Comté;89;3;20;160;Étigny;757;25;782
27;Bourgogne-Franche-Comté;89;2;07;161;Étivey;196;5;201
27;Bourgogne-Franche-Comté;89;3;18;162;Évry;386;3;389
27;Bourgogne-Franche-Comté;89;1;08;163;La Ferté-Loupière;530;9;539
27;Bourgogne-Franche-Comté;89;1;12;164;Festigny;90;0;90
27;Bourgogne-Franche-Comté;89;3;06;165;Flacy;110;2;112
27;Bourgogne-Franche-Comté;89;1;08;167;Fleury-la-Vallée;1110;35;1145
27;Bourgogne-Franche-Comté;89;1;07;168;Fleys;177;3;180
27;Bourgogne-Franche-Comté;89;2;19;169;Flogny-la-Chapelle;1001;22;1023
27;Bourgogne-Franche-Comté;89;2;12;170;Foissy-lès-Vézelay;126;2;128
27;Bourgogne-Franche-Comté;89;3;06;171;Foissy-sur-Vanne;311;3;314
27;Bourgogne-Franche-Comté;89;3;06;172;Fontaine-la-Gaillarde;506;25;531
27;Bourgogne-Franche-Comté;89;1;09;173;Fontaines;471;5;476
27;Bourgogne-Franche-Comté;89;1;07;175;Fontenay-près-Chablis;146;6;152
27;Bourgogne-Franche-Comté;89;2;12;176;Fontenay-près-Vézelay;136;2;138
27;Bourgogne-Franche-Comté;89;1;12;177;Fontenay-sous-Fouronnes;72;0;72
27;Bourgogne-Franche-Comté;89;1;21;179;Fontenoy;298;8;306
27;Bourgogne-Franche-Comté;89;3;10;180;Fouchères;479;10;489
27;Bourgogne-Franche-Comté;89;3;06;181;Fournaudin;120;2;122
27;Bourgogne-Franche-Comté;89;1;21;182;Fouronnes;167;4;171
27;Bourgogne-Franche-Comté;89;2;07;183;Fresnes;67;0;67
27;Bourgogne-Franche-Comté;89;2;19;184;Fulvy;131;2;133
27;Bourgogne-Franche-Comté;89;1;15;186;Germigny;538;13;551
27;Bourgogne-Franche-Comté;89;2;19;187;Gigny;94;2;96
27;Bourgogne-Franche-Comté;89;2;05;188;Girolles;168;6;174
27;Bourgogne-Franche-Comté;89;3;18;189;Gisy-les-Nobles;580;19;599
27;Bourgogne-Franche-Comté;89;2;12;190;Givry;177;8;185
27;Bourgogne-Franche-Comté;89;2;19;191;Gland;45;2;47
27;Bourgogne-Franche-Comté;89;2;07;194;Grimault;118;6;124
27;Bourgogne-Franche-Comté;89;3;17;195;Gron;1254;73;1327
27;Bourgogne-Franche-Comté;89;2;07;197;Guillon-Terre-Plaine ;753;8;761
27;Bourgogne-Franche-Comté;89;1;02;198;Gurgy;1705;38;1743
27;Bourgogne-Franche-Comté;89;1;21;199;Gy-l'Évêque;452;10;462
27;Bourgogne-Franche-Comté;89;1;15;200;Hauterive;392;16;408
27;Bourgogne-Franche-Comté;89;1;21;405;Les Hauts de Forterre;496;6;502
27;Bourgogne-Franche-Comté;89;1;15;201;Héry;1797;41;1838
27;Bourgogne-Franche-Comté;89;1;21;202;Irancy;269;7;276
27;Bourgogne-Franche-Comté;89;2;05;203;Island;184;6;190
27;Bourgogne-Franche-Comté;89;2;07;204;L' Isle-sur-Serein;661;14;675
27;Bourgogne-Franche-Comté;89;1;15;205;Jaulges;583;4;587
27;Bourgogne-Franche-Comté;89;3;11;206;Joigny;9479;337;9816
27;Bourgogne-Franche-Comté;89;2;07;207;Jouancy;25;0;25
27;Bourgogne-Franche-Comté;89;2;12;208;Joux-la-Ville;1152;18;1170
27;Bourgogne-Franche-Comté;89;3;10;209;Jouy;518;11;529
27;Bourgogne-Franche-Comté;89;2;19;210;Jully;139;7;146
27;Bourgogne-Franche-Comté;89;2;19;211;Junay;68;0;68
27;Bourgogne-Franche-Comté;89;1;21;212;Jussy;374;15;389
27;Bourgogne-Franche-Comté;89;3;06;214;Lailly;193;2;195
27;Bourgogne-Franche-Comté;89;1;21;215;Lain;184;4;188
27;Bourgogne-Franche-Comté;89;1;21;216;Lainsecq;318;10;328
27;Bourgogne-Franche-Comté;89;1;09;217;Lalande;136;2;138
27;Bourgogne-Franche-Comté;89;1;13;218;Laroche-Saint-Cydroine;1257;22;1279
27;Bourgogne-Franche-Comté;89;1;15;219;Lasson;145;0;145
27;Bourgogne-Franche-Comté;89;1;09;220;Lavau;462;8;470
27;Bourgogne-Franche-Comté;89;1;09;221;Leugny;334;5;339
27;Bourgogne-Franche-Comté;89;1;21;222;Levis;219;6;225
27;Bourgogne-Franche-Comté;89;2;19;223;Lézinnes;666;20;686
27;Bourgogne-Franche-Comté;89;1;07;224;Lichères-près-Aigremont;159;3;162
27;Bourgogne-Franche-Comté;89;2;12;225;Lichères-sur-Yonne;48;0;48
27;Bourgogne-Franche-Comté;89;1;07;226;Lignorelles;191;5;196
27;Bourgogne-Franche-Comté;89;1;07;227;Ligny-le-Châtel;1255;27;1282
27;Bourgogne-Franche-Comté;89;1;01;228;Lindry;1393;43;1436
27;Bourgogne-Franche-Comté;89;3;10;229;Lixy;461;12;473
27;Bourgogne-Franche-Comté;89;3;11;230;Looze;441;18;459
27;Bourgogne-Franche-Comté;89;2;05;232;Lucy-le-Bois;293;16;309
27;Bourgogne-Franche-Comté;89;1;12;233;Lucy-sur-Cure;201;5;206
27;Bourgogne-Franche-Comté;89;1;12;234;Lucy-sur-Yonne;127;2;129
27;Bourgogne-Franche-Comté;89;2;05;235;Magny;870;22;892
27;Bourgogne-Franche-Comté;89;3;17;236;Maillot;1175;31;1206
27;Bourgogne-Franche-Comté;89;1;12;237;Mailly-la-Ville;502;9;511
27;Bourgogne-Franche-Comté;89;1;12;238;Mailly-le-Château;549;6;555
27;Bourgogne-Franche-Comté;89;3;17;239;Malay-le-Grand;1537;44;1581
27;Bourgogne-Franche-Comté;89;3;06;240;Malay-le-Petit;333;9;342
27;Bourgogne-Franche-Comté;89;1;07;242;Maligny;801;19;820
27;Bourgogne-Franche-Comté;89;2;07;244;Marmeaux;90;4;94
27;Bourgogne-Franche-Comté;89;3;20;245;Marsangy;848;19;867
27;Bourgogne-Franche-Comté;89;2;07;246;Massangis;357;5;362
27;Bourgogne-Franche-Comté;89;2;19;247;Mélisey;246;2;248
27;Bourgogne-Franche-Comté;89;2;05;248;Menades;48;2;50
27;Bourgogne-Franche-Comté;89;1;06;249;Mercy;80;1;81
27;Bourgogne-Franche-Comté;89;1;07;250;Méré;198;3;201
27;Bourgogne-Franche-Comté;89;1;08;251;Merry-la-Vallée;374;9;383
27;Bourgogne-Franche-Comté;89;1;21;252;Merry-Sec;177;4;181
27;Bourgogne-Franche-Comté;89;2;12;253;Merry-sur-Yonne;196;1;197
27;Bourgogne-Franche-Comté;89;1;09;254;Mézilles;527;8;535
27;Bourgogne-Franche-Comté;89;3;18;255;Michery;1062;22;1084
27;Bourgogne-Franche-Comté;89;1;21;256;Migé;418;3;421
27;Bourgogne-Franche-Comté;89;1;13;257;Migennes;7247;114;7361
27;Bourgogne-Franche-Comté;89;2;07;259;Môlay;92;2;94
27;Bourgogne-Franche-Comté;89;3;06;261;Molinons;277;6;283
27;Bourgogne-Franche-Comté;89;2;19;262;Molosmes;173;8;181
27;Bourgogne-Franche-Comté;89;1;02;263;Monéteau;4127;79;4206
27;Bourgogne-Franche-Comté;89;1;15;268;Mont-Saint-Sulpice;795;16;811
27;Bourgogne-Franche-Comté;89;3;10;264;Montacher-Villegardin;749;28;777
27;Bourgogne-Franche-Comté;89;1;08;003;Montholon ;2866;60;2926
27;Bourgogne-Franche-Comté;89;1;07;265;Montigny-la-Resle;585;20;605
27;Bourgogne-Franche-Comté;89;2;12;266;Montillot;269;7;276
27;Bourgogne-Franche-Comté;89;2;07;267;Montréal;179;6;185
27;Bourgogne-Franche-Comté;89;1;21;270;Mouffy;127;2;129
27;Bourgogne-Franche-Comté;89;2;07;271;Moulins-en-Tonnerrois;104;1;105
27;Bourgogne-Franche-Comté;89;1;09;272;Moulins-sur-Ouanne;296;2;298
27;Bourgogne-Franche-Comté;89;1;21;273;Moutiers-en-Puisaye;284;4;288
27;Bourgogne-Franche-Comté;89;3;10;274;Nailly;1317;36;1353
27;Bourgogne-Franche-Comté;89;1;15;276;Neuvy-Sautour;892;41;933
27;Bourgogne-Franche-Comté;89;1;07;277;Nitry;368;10;378
27;Bourgogne-Franche-Comté;89;3;06;278;Noé;553;5;558
27;Bourgogne-Franche-Comté;89;2;07;279;Noyers;584;18;602
27;Bourgogne-Franche-Comté;89;2;19;280;Nuits;395;9;404
27;Bourgogne-Franche-Comté;89;1;08;281;Les Ormes;356;2;358
27;Bourgogne-Franche-Comté;89;1;15;282;Ormoy;678;12;690
27;Bourgogne-Franche-Comté;89;1;21;283;Ouanne;603;16;619
27;Bourgogne-Franche-Comté;89;2;19;284;Pacy-sur-Armançon;187;4;191
27;Bourgogne-Franche-Comté;89;3;18;285;Pailly;313;3;316
27;Bourgogne-Franche-Comté;89;1;09;286;Parly;829;15;844
27;Bourgogne-Franche-Comté;89;3;17;287;Paron;4841;118;4959
27;Bourgogne-Franche-Comté;89;1;06;288;Paroy-en-Othe;182;3;185
27;Bourgogne-Franche-Comté;89;3;08;289;Paroy-sur-Tholon;287;12;299
27;Bourgogne-Franche-Comté;89;2;07;290;Pasilly;45;1;46
27;Bourgogne-Franche-Comté;89;3;20;291;Passy;341;10;351
27;Bourgogne-Franche-Comté;89;3;18;469;Perceneige;948;21;969
27;Bourgogne-Franche-Comté;89;1;15;292;Percey;251;5;256
27;Bourgogne-Franche-Comté;89;1;02;295;Perrigny;1266;32;1298
27;Bourgogne-Franche-Comté;89;2;19;296;Perrigny-sur-Armançon;130;1;131
27;Bourgogne-Franche-Comté;89;2;12;297;Pierre-Perthuis;117;1;118
27;Bourgogne-Franche-Comté;89;3;20;298;Piffonds;625;9;634
27;Bourgogne-Franche-Comté;89;2;19;299;Pimelles;62;2;64
27;Bourgogne-Franche-Comté;89;2;07;300;Pisy;79;1;80
27;Bourgogne-Franche-Comté;89;3;18;302;Plessis-Saint-Jean;209;5;214
27;Bourgogne-Franche-Comté;89;1;07;303;Poilly-sur-Serein;262;6;268
27;Bourgogne-Franche-Comté;89;1;08;304;Poilly-sur-Tholon;681;17;698
27;Bourgogne-Franche-Comté;89;3;06;308;Pont-sur-Vanne;192;7;199
27;Bourgogne-Franche-Comté;89;3;14;309;Pont-sur-Yonne;3286;60;3346
27;Bourgogne-Franche-Comté;89;2;05;306;Pontaubert;376;11;387
27;Bourgogne-Franche-Comté;89;1;07;307;Pontigny;751;9;760
27;Bourgogne-Franche-Comté;89;3;06;310;La Postolle;142;3;145
27;Bourgogne-Franche-Comté;89;1;09;311;Pourrain;1395;34;1429
27;Bourgogne-Franche-Comté;89;2;12;312;Précy-le-Sec;251;5;256
27;Bourgogne-Franche-Comté;89;3;11;313;Précy-sur-Vrin;432;16;448
27;Bourgogne-Franche-Comté;89;1;12;314;Prégilbert;181;1;182
27;Bourgogne-Franche-Comté;89;1;07;315;Préhy;151;1;152
27;Bourgogne-Franche-Comté;89;2;05;316;Provency;251;8;259
27;Bourgogne-Franche-Comté;89;2;05;318;Quarré-les-Tombes;639;20;659
27;Bourgogne-Franche-Comté;89;1;03;319;Quenne;478;14;492
27;Bourgogne-Franche-Comté;89;2;19;320;Quincerot;62;2;64
27;Bourgogne-Franche-Comté;89;2;19;321;Ravières;728;17;745
27;Bourgogne-Franche-Comté;89;2;19;323;Roffey;141;4;145
27;Bourgogne-Franche-Comté;89;1;09;324;Rogny-les-Sept-Écluses;666;17;683
27;Bourgogne-Franche-Comté;89;1;09;325;Ronchères;94;1;95
27;Bourgogne-Franche-Comté;89;3;17;326;Rosoy;1106;33;1139
27;Bourgogne-Franche-Comté;89;3;20;327;Rousson;401;10;411
27;Bourgogne-Franche-Comté;89;1;07;328;Rouvray;375;9;384
27;Bourgogne-Franche-Comté;89;2;19;329;Rugny;77;1;78
27;Bourgogne-Franche-Comté;89;1;21;331;Sainpuits;313;12;325
27;Bourgogne-Franche-Comté;89;3;10;332;Saint-Agnan;950;27;977
27;Bourgogne-Franche-Comté;89;2;07;333;Saint-André-en-Terre-Plaine;156;4;160
27;Bourgogne-Franche-Comté;89;3;11;335;Saint-Aubin-sur-Yonne;409;12;421
27;Bourgogne-Franche-Comté;89;2;05;336;Saint-Brancher;287;7;294
27;Bourgogne-Franche-Comté;89;1;03;337;Saint-Bris-le-Vineux;1021;26;1047
27;Bourgogne-Franche-Comté;89;3;16;338;Saint-Clément;2748;79;2827
27;Bourgogne-Franche-Comté;89;1;07;341;Saint-Cyr-les-Colons;449;5;454
27;Bourgogne-Franche-Comté;89;3;18;342;Saint-Denis-lès-Sens;687;24;711
27;Bourgogne-Franche-Comté;89;1;09;344;Saint-Fargeau;1542;15;1557
27;Bourgogne-Franche-Comté;89;1;15;345;Saint-Florentin;4376;63;4439
27;Bourgogne-Franche-Comté;89;1;01;346;Saint-Georges-sur-Baulche;3230;143;3373
27;Bourgogne-Franche-Comté;89;2;05;347;Saint-Germain-des-Champs;354;10;364
27;Bourgogne-Franche-Comté;89;3;11;348;Saint-Julien-du-Sault;2292;51;2343
27;Bourgogne-Franche-Comté;89;2;05;349;Saint-Léger-Vauban;358;6;364
27;Bourgogne-Franche-Comté;89;3;11;350;Saint-Loup-d'Ordon;257;4;261
27;Bourgogne-Franche-Comté;89;3;11;353;Saint-Martin-d'Ordon;416;4;420
27;Bourgogne-Franche-Comté;89;1;09;352;Saint-Martin-des-Champs;273;7;280
27;Bourgogne-Franche-Comté;89;3;16;354;Saint-Martin-du-Tertre;1546;43;1589
27;Bourgogne-Franche-Comté;89;2;19;355;Saint-Martin-sur-Armançon;143;6;149
27;Bourgogne-Franche-Comté;89;3;06;359;Saint-Maurice-aux-Riches-Hommes;421;5;426
27;Bourgogne-Franche-Comté;89;1;08;360;Saint-Maurice-le-Vieil;370;6;376
27;Bourgogne-Franche-Comté;89;1;08;361;Saint-Maurice-Thizouaille;259;2;261
27;Bourgogne-Franche-Comté;89;2;12;362;Saint-Moré;180;5;185
27;Bourgogne-Franche-Comté;89;2;12;364;Saint-Père;303;5;308
27;Bourgogne-Franche-Comté;89;1;09;365;Saint-Privé;525;15;540
27;Bourgogne-Franche-Comté;89;1;21;368;Saint-Sauveur-en-Puisaye;888;20;908
27;Bourgogne-Franche-Comté;89;3;14;369;Saint-Sérotin;564;12;576
27;Bourgogne-Franche-Comté;89;3;10;370;Saint-Valérien;1704;21;1725
27;Bourgogne-Franche-Comté;89;2;12;339;Sainte-Colombe;195;7;202
27;Bourgogne-Franche-Comté;89;2;05;351;Sainte-Magnance;479;8;487
27;Bourgogne-Franche-Comté;89;1;12;363;Sainte-Pallaye;108;2;110
27;Bourgogne-Franche-Comté;89;2;07;371;Sainte-Vertu;87;0;87
27;Bourgogne-Franche-Comté;89;1;21;367;Saints-en-Puisaye;553;11;564
27;Bourgogne-Franche-Comté;89;3;06;373;Saligny;666;10;676
27;Bourgogne-Franche-Comté;89;2;19;374;Sambourg;75;3;78
27;Bourgogne-Franche-Comté;89;2;07;375;Santigny;90;3;93
27;Bourgogne-Franche-Comté;89;2;07;376;Sarry;152;8;160
27;Bourgogne-Franche-Comté;89;2;07;377;Sauvigny-le-Beuréal;71;0;71
27;Bourgogne-Franche-Comté;89;2;05;378;Sauvigny-le-Bois;715;15;730
27;Bourgogne-Franche-Comté;89;2;07;379;Savigny-en-Terre-Plaine;151;3;154
27;Bourgogne-Franche-Comté;89;3;10;380;Savigny-sur-Clairis;456;7;463
27;Bourgogne-Franche-Comté;89;1;15;382;Seignelay;1485;37;1522
27;Bourgogne-Franche-Comté;89;1;21;383;Sementron;106;2;108
27;Bourgogne-Franche-Comté;89;1;08;384;Senan;694;24;718
27;Bourgogne-Franche-Comté;89;2;19;385;Sennevoy-le-Bas;81;3;84
27;Bourgogne-Franche-Comté;89;2;19;386;Sennevoy-le-Haut;117;1;118
27;Bourgogne-Franche-Comté;89;3;99;387;Sens;26586;524;27110
27;Bourgogne-Franche-Comté;89;3;08;388;Sépeaux-Saint Romain;539;14;553
27;Bourgogne-Franche-Comté;89;3;18;390;Serbonnes;653;10;663
27;Bourgogne-Franche-Comté;89;3;18;391;Sergines;1279;26;1305
27;Bourgogne-Franche-Comté;89;2;05;392;Sermizelles;252;3;255
27;Bourgogne-Franche-Comté;89;2;19;393;Serrigny;111;2;113
27;Bourgogne-Franche-Comté;89;1;12;394;Sery;84;1;85
27;Bourgogne-Franche-Comté;89;3;06;395;Les Sièges;413;8;421
27;Bourgogne-Franche-Comté;89;1;08;397;Sommecaise;367;5;372
27;Bourgogne-Franche-Comté;89;1;15;398;Sormery;355;4;359
27;Bourgogne-Franche-Comté;89;3;18;399;Soucy;1593;46;1639
27;Bourgogne-Franche-Comté;89;1;21;400;Sougères-en-Puisaye;317;5;322
27;Bourgogne-Franche-Comté;89;1;15;402;Soumaintrain;219;4;223
27;Bourgogne-Franche-Comté;89;2;19;403;Stigny;91;9;100
27;Bourgogne-Franche-Comté;89;3;10;404;Subligny;518;9;527
27;Bourgogne-Franche-Comté;89;2;07;406;Talcy;74;2;76
27;Bourgogne-Franche-Comté;89;2;19;407;Tanlay;967;32;999
27;Bourgogne-Franche-Comté;89;1;09;408;Tannerre-en-Puisaye;280;7;287
27;Bourgogne-Franche-Comté;89;2;12;409;Tharoiseau;61;1;62
27;Bourgogne-Franche-Comté;89;2;05;410;Tharot;97;1;98
27;Bourgogne-Franche-Comté;89;2;07;412;Thizy;191;8;199
27;Bourgogne-Franche-Comté;89;2;19;413;Thorey;32;1;33
27;Bourgogne-Franche-Comté;89;3;18;414;Thorigny-sur-Oreuse;1428;31;1459
27;Bourgogne-Franche-Comté;89;2;05;415;Thory;202;3;205
27;Bourgogne-Franche-Comté;89;1;21;416;Thury;439;7;446
27;Bourgogne-Franche-Comté;89;2;19;417;Tissey;105;2;107
27;Bourgogne-Franche-Comté;89;2;19;418;Tonnerre;4478;176;4654
27;Bourgogne-Franche-Comté;89;1;09;419;Toucy;2633;141;2774
27;Bourgogne-Franche-Comté;89;1;21;420;Treigny-Perreuse-Sainte-Colombe ;982;21;1003
27;Bourgogne-Franche-Comté;89;2;19;422;Trichey;42;2;44
27;Bourgogne-Franche-Comté;89;2;19;423;Tronchoy;127;3;130
27;Bourgogne-Franche-Comté;89;1;12;424;Trucy-sur-Yonne;136;6;142
27;Bourgogne-Franche-Comté;89;1;15;425;Turny;679;20;699
27;Bourgogne-Franche-Comté;89;1;08;334;Le Val d'Ocre;560;7;567
27;Bourgogne-Franche-Comté;89;1;21;426;Val-de-Mercy;390;12;402
27;Bourgogne-Franche-Comté;89;1;04;427;Vallan;684;19;703
27;Bourgogne-Franche-Comté;89;3;06;411;Les Vallées de la Vanne;1058;21;1079
27;Bourgogne-Franche-Comté;89;3;10;428;Vallery;560;6;566
27;Bourgogne-Franche-Comté;89;1;08;196;Valravillon;1758;53;1811
27;Bourgogne-Franche-Comté;89;1;07;430;Varennes;322;9;331
27;Bourgogne-Franche-Comté;89;2;07;431;Vassy-sous-Pisy;71;1;72
27;Bourgogne-Franche-Comté;89;3;06;432;Vaudeurs;468;8;476
27;Bourgogne-Franche-Comté;89;2;05;433;Vault-de-Lugny;280;5;285
27;Bourgogne-Franche-Comté;89;3;06;434;Vaumort;356;8;364
27;Bourgogne-Franche-Comté;89;1;06;436;Venizy;879;15;894
27;Bourgogne-Franche-Comté;89;1;07;437;Venouse;301;7;308
27;Bourgogne-Franche-Comté;89;1;03;438;Venoy;1768;211;1979
27;Bourgogne-Franche-Comté;89;1;15;439;Vergigny;1536;24;1560
27;Bourgogne-Franche-Comté;89;3;11;440;Verlin;415;6;421
27;Bourgogne-Franche-Comté;89;1;12;441;Vermenton;1259;25;1284
27;Bourgogne-Franche-Comté;89;3;10;442;Vernoy;243;7;250
27;Bourgogne-Franche-Comté;89;3;20;443;Véron;1918;64;1982
27;Bourgogne-Franche-Comté;89;2;19;445;Vézannes;50;2;52
27;Bourgogne-Franche-Comté;89;2;12;446;Vézelay;423;4;427
27;Bourgogne-Franche-Comté;89;2;19;447;Vézinnes;158;5;163
27;Bourgogne-Franche-Comté;89;3;14;449;Villeblevin;1835;36;1871
27;Bourgogne-Franche-Comté;89;3;10;450;Villebougis;629;22;651
27;Bourgogne-Franche-Comté;89;3;06;451;Villechétive;246;4;250
27;Bourgogne-Franche-Comté;89;3;11;452;Villecien;392;14;406
27;Bourgogne-Franche-Comté;89;1;01;453;Villefargeau;1113;30;1143
27;Bourgogne-Franche-Comté;89;3;14;456;Villemanoche;672;8;680
27;Bourgogne-Franche-Comté;89;3;14;458;Villenavotte;171;9;180
27;Bourgogne-Franche-Comté;89;3;06;461;Villeneuve-l'Archevêque;1128;19;1147
27;Bourgogne-Franche-Comté;89;3;10;459;Villeneuve-la-Dondagre;311;0;311
27;Bourgogne-Franche-Comté;89;3;14;460;Villeneuve-la-Guyard;3493;46;3539
27;Bourgogne-Franche-Comté;89;1;09;462;Villeneuve-les-Genêts;289;3;292
27;Bourgogne-Franche-Comté;89;1;07;463;Villeneuve-Saint-Salves;252;4;256
27;Bourgogne-Franche-Comté;89;3;20;464;Villeneuve-sur-Yonne;5179;86;5265
27;Bourgogne-Franche-Comté;89;3;14;465;Villeperrot;322;1;323
27;Bourgogne-Franche-Comté;89;3;10;466;Villeroy;388;9;397
27;Bourgogne-Franche-Comté;89;3;10;467;Villethierry;828;14;842
27;Bourgogne-Franche-Comté;89;3;11;468;Villevallier;420;59;479
27;Bourgogne-Franche-Comté;89;2;19;470;Villiers-les-Hauts;123;7;130
27;Bourgogne-Franche-Comté;89;3;06;471;Villiers-Louis;464;15;479
27;Bourgogne-Franche-Comté;89;1;09;472;Villiers-Saint-Benoît;454;9;463
27;Bourgogne-Franche-Comté;89;1;15;474;Villiers-Vineux;280;6;286
27;Bourgogne-Franche-Comté;89;2;19;475;Villon;109;2;111
27;Bourgogne-Franche-Comté;89;1;07;477;Villy;109;2;111
27;Bourgogne-Franche-Comté;89;1;21;478;Vincelles;917;15;932
27;Bourgogne-Franche-Comté;89;1;21;479;Vincelottes;285;6;291
27;Bourgogne-Franche-Comté;89;3;18;480;Vinneuf;1568;23;1591
27;Bourgogne-Franche-Comté;89;2;19;481;Vireaux;119;6;125
27;Bourgogne-Franche-Comté;89;2;19;482;Viviers;119;1;120
27;Bourgogne-Franche-Comté;89;3;18;483;Voisines;504;18;522
27;Bourgogne-Franche-Comté;89;2;12;485;Voutenay-sur-Cure;209;6;215
27;Bourgogne-Franche-Comté;89;2;19;486;Yrouerre;156;3;159
27;Bourgogne-Franche-Comté;90;1;05;001;Andelnans;1186;21;1207
27;Bourgogne-Franche-Comté;90;1;08;002;Angeot;349;8;357
27;Bourgogne-Franche-Comté;90;1;07;003;Anjoutey;595;22;617
27;Bourgogne-Franche-Comté;90;1;05;004;Argiésans;508;15;523
27;Bourgogne-Franche-Comté;90;1;08;082;Autrechêne;277;9;286
27;Bourgogne-Franche-Comté;90;1;07;005;Auxelles-Bas;458;13;471
27;Bourgogne-Franche-Comté;90;1;07;006;Auxelles-Haut;287;7;294
27;Bourgogne-Franche-Comté;90;1;05;007;Banvillars;285;12;297
27;Bourgogne-Franche-Comté;90;1;01;008;Bavilliers;4680;108;4788
27;Bourgogne-Franche-Comté;90;1;06;009;Beaucourt;5014;64;5078
27;Bourgogne-Franche-Comté;90;1;99;010;Belfort;46954;809;47763
27;Bourgogne-Franche-Comté;90;1;05;011;Bermont;384;9;393
27;Bourgogne-Franche-Comté;90;1;08;012;Bessoncourt;1264;45;1309
27;Bourgogne-Franche-Comté;90;1;08;013;Bethonvilliers;244;11;255
27;Bourgogne-Franche-Comté;90;1;08;014;Boron;484;8;492
27;Bourgogne-Franche-Comté;90;1;05;015;Botans;237;9;246
27;Bourgogne-Franche-Comté;90;1;07;016;Bourg-sous-Châtelet;122;2;124
27;Bourgogne-Franche-Comté;90;1;05;017;Bourogne;1888;26;1914
27;Bourgogne-Franche-Comté;90;1;08;018;Brebotte;389;7;396
27;Bourgogne-Franche-Comté;90;1;08;019;Bretagne;268;6;274
27;Bourgogne-Franche-Comté;90;1;05;020;Buc;279;9;288
27;Bourgogne-Franche-Comté;90;1;05;021;Charmois;344;4;348
27;Bourgogne-Franche-Comté;90;1;05;022;Châtenois-les-Forges;2709;51;2760
27;Bourgogne-Franche-Comté;90;1;07;023;Chaux;1157;32;1189
27;Bourgogne-Franche-Comté;90;1;08;024;Chavanatte;147;3;150
27;Bourgogne-Franche-Comté;90;1;08;025;Chavannes-les-Grands;341;4;345
27;Bourgogne-Franche-Comté;90;1;05;026;Chèvremont;1585;38;1623
27;Bourgogne-Franche-Comté;90;1;06;027;Courcelles;118;0;118
27;Bourgogne-Franche-Comté;90;1;06;028;Courtelevant;403;7;410
27;Bourgogne-Franche-Comté;90;1;01;029;Cravanche;1959;52;2011
27;Bourgogne-Franche-Comté;90;1;06;030;Croix;167;3;170
27;Bourgogne-Franche-Comté;90;1;08;031;Cunelières;349;9;358
27;Bourgogne-Franche-Comté;90;1;01;032;Danjoutin;3668;69;3737
27;Bourgogne-Franche-Comté;90;1;06;033;Delle;5678;86;5764
27;Bourgogne-Franche-Comté;90;1;09;034;Denney;764;26;790
27;Bourgogne-Franche-Comté;90;1;05;035;Dorans;774;10;784
27;Bourgogne-Franche-Comté;90;1;08;036;Eguenigue;271;9;280
27;Bourgogne-Franche-Comté;90;1;09;037;Éloie;944;26;970
27;Bourgogne-Franche-Comté;90;1;01;039;Essert;3325;102;3427
27;Bourgogne-Franche-Comté;90;1;07;041;Étueffont;1458;57;1515
27;Bourgogne-Franche-Comté;90;1;09;042;Évette-Salbert;2044;69;2113
27;Bourgogne-Franche-Comté;90;1;06;043;Faverois;578;2;580
27;Bourgogne-Franche-Comté;90;1;06;045;Fêche-l'Église;765;13;778
27;Bourgogne-Franche-Comté;90;1;07;044;Felon;240;5;245
27;Bourgogne-Franche-Comté;90;1;06;046;Florimont;450;6;456
27;Bourgogne-Franche-Comté;90;1;08;047;Fontaine;598;14;612
27;Bourgogne-Franche-Comté;90;1;08;048;Fontenelle;124;3;127
27;Bourgogne-Franche-Comté;90;1;08;049;Foussemagne;919;18;937
27;Bourgogne-Franche-Comté;90;1;08;050;Frais;230;7;237
27;Bourgogne-Franche-Comté;90;1;08;051;Froidefontaine;458;8;466
27;Bourgogne-Franche-Comté;90;1;07;052;Giromagny;2997;83;3080
27;Bourgogne-Franche-Comté;90;1;08;053;Grandvillars;2991;61;3052
27;Bourgogne-Franche-Comté;90;1;07;054;Grosmagny;525;9;534
27;Bourgogne-Franche-Comté;90;1;08;055;Grosne;335;2;337
27;Bourgogne-Franche-Comté;90;1;06;056;Joncherey;1398;29;1427
27;Bourgogne-Franche-Comté;90;1;07;057;Lachapelle-sous-Chaux;747;26;773
27;Bourgogne-Franche-Comté;90;1;07;058;Lachapelle-sous-Rougemont;578;6;584
27;Bourgogne-Franche-Comté;90;1;08;059;Lacollonge;228;10;238
27;Bourgogne-Franche-Comté;90;1;08;060;Lagrange;137;3;140
27;Bourgogne-Franche-Comté;90;1;07;061;Lamadeleine-Val-des-Anges;42;2;44
27;Bourgogne-Franche-Comté;90;1;08;062;Larivière;289;10;299
27;Bourgogne-Franche-Comté;90;1;06;063;Lebetain;418;9;427
27;Bourgogne-Franche-Comté;90;1;07;065;Lepuix;1157;21;1178
27;Bourgogne-Franche-Comté;90;1;06;064;Lepuix-Neuf;300;4;304
27;Bourgogne-Franche-Comté;90;1;07;066;Leval;239;1;240
27;Bourgogne-Franche-Comté;90;1;08;067;Menoncourt;393;18;411
27;Bourgogne-Franche-Comté;90;1;05;068;Meroux-Moval ;1310;30;1340
27;Bourgogne-Franche-Comté;90;1;08;069;Méziré;1318;24;1342
27;Bourgogne-Franche-Comté;90;1;06;070;Montbouton;404;9;413
27;Bourgogne-Franche-Comté;90;1;08;071;Montreux-Château;1178;21;1199
27;Bourgogne-Franche-Comté;90;1;08;072;Morvillars;1078;22;1100
27;Bourgogne-Franche-Comté;90;1;08;074;Novillard;301;4;305
27;Bourgogne-Franche-Comté;90;1;09;075;Offemont;4179;98;4277
27;Bourgogne-Franche-Comté;90;1;01;076;Pérouse;1173;41;1214
27;Bourgogne-Franche-Comté;90;1;08;077;Petit-Croix;298;7;305
27;Bourgogne-Franche-Comté;90;1;07;078;Petitefontaine;189;5;194
27;Bourgogne-Franche-Comté;90;1;07;079;Petitmagny;306;6;312
27;Bourgogne-Franche-Comté;90;1;08;080;Phaffans;445;13;458
27;Bourgogne-Franche-Comté;90;1;06;081;Réchésy;779;13;792
27;Bourgogne-Franche-Comté;90;1;08;083;Recouvrance;116;0;116
27;Bourgogne-Franche-Comté;90;1;08;084;Reppe;344;10;354
27;Bourgogne-Franche-Comté;90;1;07;085;Riervescemont;98;2;100
27;Bourgogne-Franche-Comté;90;1;07;086;Romagny-sous-Rougemont;220;6;226
27;Bourgogne-Franche-Comté;90;1;09;087;Roppe;1042;31;1073
27;Bourgogne-Franche-Comté;90;1;07;088;Rougegoutte;971;25;996
27;Bourgogne-Franche-Comté;90;1;07;089;Rougemont-le-Château;1494;65;1559
27;Bourgogne-Franche-Comté;90;1;06;090;Saint-Dizier-l'Évêque;431;11;442
27;Bourgogne-Franche-Comté;90;1;07;091;Saint-Germain-le-Châtelet;644;23;667
27;Bourgogne-Franche-Comté;90;1;09;093;Sermamagny;888;19;907
27;Bourgogne-Franche-Comté;90;1;05;094;Sevenans;702;27;729
27;Bourgogne-Franche-Comté;90;1;08;095;Suarce;435;3;438
27;Bourgogne-Franche-Comté;90;1;06;096;Thiancourt;284;8;292
27;Bourgogne-Franche-Comté;90;1;05;097;Trévenans;1266;32;1298
27;Bourgogne-Franche-Comté;90;1;05;098;Urcerey;233;10;243
27;Bourgogne-Franche-Comté;90;1;09;099;Valdoie;5260;239;5499
27;Bourgogne-Franche-Comté;90;1;08;100;Vauthiermont;204;12;216
27;Bourgogne-Franche-Comté;90;1;08;101;Vellescot;248;6;254
27;Bourgogne-Franche-Comté;90;1;07;102;Vescemont;733;23;756
27;Bourgogne-Franche-Comté;90;1;09;103;Vétrigne;635;21;656
27;Bourgogne-Franche-Comté;90;1;05;104;Vézelois;973;22;995
27;Bourgogne-Franche-Comté;90;1;06;105;Villars-le-Sec;180;5;185
11;Île-de-France;91;1;08;001;Abbéville-la-Rivière;314;8;322
11;Île-de-France;91;1;08;016;Angerville;4310;69;4379
11;Île-de-France;91;3;05;017;Angervilliers;1666;24;1690
11;Île-de-France;91;3;01;021;Arpajon;10920;91;11011
11;Île-de-France;91;1;08;022;Arrancourt;143;6;149
11;Île-de-France;91;3;02;027;Athis-Mons;35101;347;35448
11;Île-de-France;91;1;08;035;Authon-la-Plaine;372;6;378
11;Île-de-France;91;2;13;037;Auvernaux;323;1;324
11;Île-de-France;91;1;08;038;Auvers-Saint-Georges;1272;22;1294
11;Île-de-France;91;3;01;041;Avrainville;973;7;980
11;Île-de-France;91;3;11;044;Ballainvilliers;4575;42;4617
11;Île-de-France;91;2;13;045;Ballancourt-sur-Essonne;7595;100;7695
11;Île-de-France;91;1;13;047;Baulne;1310;13;1323
11;Île-de-France;91;3;10;064;Bièvres;4662;109;4771
11;Île-de-France;91;1;08;067;Blandy;118;4;122
11;Île-de-France;91;2;13;069;Boigneville;387;10;397
11;Île-de-France;91;1;08;075;Bois-Herpin;79;1;80
11;Île-de-France;91;1;08;079;Boissy-la-Rivière;517;7;524
11;Île-de-France;91;1;08;080;Boissy-le-Cutté;1318;15;1333
11;Île-de-France;91;1;08;081;Boissy-le-Sec;686;17;703
11;Île-de-France;91;1;01;085;Boissy-sous-Saint-Yon;3860;47;3907
11;Île-de-France;91;2;15;086;Bondoufle;9765;96;9861
11;Île-de-France;91;3;10;093;Boullay-les-Troux;647;21;668
11;Île-de-France;91;1;01;095;Bouray-sur-Juine;2148;26;2174
11;Île-de-France;91;2;07;097;Boussy-Saint-Antoine;7767;73;7840
11;Île-de-France;91;1;08;098;Boutervilliers;426;5;431
11;Île-de-France;91;1;13;099;Boutigny-sur-Essonne;2974;41;3015
11;Île-de-France;91;1;08;100;Bouville;647;16;663
11;Île-de-France;91;3;03;103;Brétigny-sur-Orge;26878;315;27193
11;Île-de-France;91;3;05;105;Breuillet;8347;117;8464
11;Île-de-France;91;1;05;106;Breux-Jouy;1249;11;1260
11;Île-de-France;91;1;08;109;Brières-les-Scellés;1254;9;1263
11;Île-de-France;91;3;05;111;Briis-sous-Forges;3316;38;3354
11;Île-de-France;91;1;08;112;Brouy;127;4;131
11;Île-de-France;91;2;98;114;Brunoy;25354;424;25778
11;Île-de-France;91;3;01;115;Bruyères-le-Châtel;3399;43;3442
11;Île-de-France;91;2;13;121;Buno-Bonnevaux;437;7;444
11;Île-de-France;91;3;10;122;Bures-sur-Yvette;9577;234;9811
11;Île-de-France;91;1;08;129;Cerny;3354;165;3519
11;Île-de-France;91;1;08;130;Chalo-Saint-Mars;1044;28;1072
11;Île-de-France;91;1;08;131;Chalou-Moulineux;417;9;426
11;Île-de-France;91;1;05;132;Chamarande;1139;12;1151
11;Île-de-France;91;2;13;135;Champcueil;2864;56;2920
11;Île-de-France;91;3;11;136;Champlan;2758;18;2776
11;Île-de-France;91;1;08;137;Champmotteux;367;6;373
11;Île-de-France;91;1;08;145;Chatignonville;67;0;67
11;Île-de-France;91;1;05;148;Chauffour-lès-Étréchy;137;0;137
11;Île-de-France;91;3;01;156;Cheptainville;2125;29;2154
11;Île-de-France;91;2;13;159;Chevannes;1614;28;1642
11;Île-de-France;91;3;12;161;Chilly-Mazarin;19858;134;19992
11;Île-de-France;91;1;08;613;Congerville-Thionville;217;8;225
11;Île-de-France;91;2;04;174;Corbeil-Essonnes;50954;291;51245
11;Île-de-France;91;1;05;175;Corbreuse;1731;31;1762
11;Île-de-France;91;2;13;179;Le Coudray-Montceaux;4831;45;4876
11;Île-de-France;91;2;13;180;Courances;341;10;351
11;Île-de-France;91;2;13;184;Courdimanche-sur-Essonne;271;7;278
11;Île-de-France;91;3;05;186;Courson-Monteloup;573;8;581
11;Île-de-France;91;2;19;191;Crosne;9285;57;9342
11;Île-de-France;91;1;08;198;D'Huison-Longueville;1502;24;1526
11;Île-de-France;91;2;13;195;Dannemois;820;6;826
11;Île-de-France;91;1;05;200;Dourdan;10559;189;10748
11;Île-de-France;91;2;06;201;Draveil;28741;264;29005
11;Île-de-France;91;2;04;204;Écharcon;798;17;815
11;Île-de-France;91;3;01;207;Égly;6094;51;6145
11;Île-de-France;91;2;07;215;Épinay-sous-Sénart;12279;84;12363
11;Île-de-France;91;3;11;216;Épinay-sur-Orge;11160;156;11316
11;Île-de-France;91;1;08;223;Étampes;25287;184;25471
11;Île-de-France;91;2;06;225;Étiolles;3165;150;3315
11;Île-de-France;91;1;05;226;Étréchy;6642;91;6733
11;Île-de-France;91;2;09;228;Évry-Courcouronnes ;67131;460;67591
11;Île-de-France;91;1;13;232;La Ferté-Alais;3730;56;3786
11;Île-de-France;91;2;15;235;Fleury-Mérogis;13917;19;13936
11;Île-de-France;91;1;08;240;Fontaine-la-Rivière;193;4;197
11;Île-de-France;91;2;13;244;Fontenay-le-Vicomte;1561;26;1587
11;Île-de-France;91;3;05;243;Fontenay-lès-Briis;2184;32;2216
11;Île-de-France;91;1;05;247;La Forêt-le-Roi;521;7;528
11;Île-de-France;91;1;08;248;La Forêt-Sainte-Croix;162;1;163
11;Île-de-France;91;3;05;249;Forges-les-Bains;3887;74;3961
11;Île-de-France;91;3;10;272;Gif-sur-Yvette;21308;602;21910
11;Île-de-France;91;2;13;273;Gironville-sur-Essonne;765;18;783
11;Île-de-France;91;3;10;274;Gometz-la-Ville;1492;24;1516
11;Île-de-France;91;3;18;275;Gometz-le-Châtel;2711;51;2762
11;Île-de-France;91;1;05;284;Les Granges-le-Roi;1187;23;1210
11;Île-de-France;91;2;20;286;Grigny;28265;96;28361
11;Île-de-France;91;3;01;292;Guibeville;698;12;710
11;Île-de-France;91;1;13;293;Guigneville-sur-Essonne;916;17;933
11;Île-de-France;91;1;08;294;Guillerval;823;11;834
11;Île-de-France;91;3;14;312;Igny;9744;333;10077
11;Île-de-France;91;1;13;315;Itteville;6537;61;6598
11;Île-de-France;91;1;01;318;Janville-sur-Juine;1965;49;2014
11;Île-de-France;91;3;05;319;Janvry;636;10;646
11;Île-de-France;91;3;02;326;Juvisy-sur-Orge;17007;125;17132
11;Île-de-France;91;1;01;330;Lardy;5505;103;5608
11;Île-de-France;91;3;03;332;Leudeville;1476;24;1500
11;Île-de-France;91;3;01;333;Leuville-sur-Orge;4405;43;4448
11;Île-de-France;91;3;05;338;Limours;6558;123;6681
11;Île-de-France;91;3;11;339;Linas;6813;51;6864
11;Île-de-France;91;2;04;340;Lisses;7350;62;7412
11;Île-de-France;91;3;11;345;Longjumeau;20964;142;21106
11;Île-de-France;91;3;03;347;Longpont-sur-Orge;6277;52;6329
11;Île-de-France;91;2;13;359;Maisse;2751;39;2790
11;Île-de-France;91;3;18;363;Marcoussis;8171;157;8328
11;Île-de-France;91;1;08;374;Marolles-en-Beauce;235;3;238
11;Île-de-France;91;3;03;376;Marolles-en-Hurepoix;5588;53;5641
11;Île-de-France;91;3;12;377;Massy;50632;353;50985
11;Île-de-France;91;1;05;378;Mauchamps;278;3;281
11;Île-de-France;91;2;13;386;Mennecy;14679;282;14961
11;Île-de-France;91;1;08;390;Mérévillois ;3312;43;3355
11;Île-de-France;91;1;08;393;Mérobert;619;8;627
11;Île-de-France;91;1;08;399;Mespuits;214;5;219
11;Île-de-France;91;2;13;405;Milly-la-Forêt;4606;91;4697
11;Île-de-France;91;2;13;408;Moigny-sur-École;1253;30;1283
11;Île-de-France;91;3;10;411;Les Molières;1895;48;1943
11;Île-de-France;91;1;13;412;Mondeville;728;15;743
11;Île-de-France;91;1;08;414;Monnerville;378;5;383
11;Île-de-France;91;2;99;421;Montgeron;23775;294;24069
11;Île-de-France;91;3;11;425;Montlhéry;7624;222;7846
11;Île-de-France;91;3;17;432;Morangis;13453;77;13530
11;Île-de-France;91;1;08;433;Morigny-Champigny;4340;106;4446
11;Île-de-France;91;2;16;434;Morsang-sur-Orge;20619;169;20788
11;Île-de-France;91;2;07;435;Morsang-sur-Seine;538;36;574
11;Île-de-France;91;2;13;441;Nainville-les-Roches;487;11;498
11;Île-de-France;91;3;01;457;La Norville;4313;47;4360
11;Île-de-France;91;3;18;458;Nozay;4577;73;4650
11;Île-de-France;91;3;01;461;Ollainville;4712;58;4770
11;Île-de-France;91;2;13;463;Oncy-sur-École;1053;21;1074
11;Île-de-France;91;2;13;468;Ormoy;2076;20;2096
11;Île-de-France;91;1;08;469;Ormoy-la-Rivière;916;54;970
11;Île-de-France;91;3;14;471;Orsay;15844;335;16179
11;Île-de-France;91;1;08;473;Orveau;180;2;182
11;Île-de-France;91;3;14;477;Palaiseau;35590;333;35923
11;Île-de-France;91;3;02;479;Paray-Vieille-Poste;7503;58;7561
11;Île-de-France;91;3;10;482;Pecqueuse;548;11;559
11;Île-de-France;91;3;15;494;Le Plessis-Pâté;4121;57;4178
11;Île-de-France;91;1;08;495;Plessis-Saint-Benoist;330;3;333
11;Île-de-France;91;2;13;507;Prunay-sur-Essonne;292;5;297
11;Île-de-France;91;1;08;508;Puiselet-le-Marais;258;4;262
11;Île-de-France;91;1;08;511;Pussay;2153;30;2183
11;Île-de-France;91;2;07;514;Quincy-sous-Sénart;9018;45;9063
11;Île-de-France;91;1;05;519;Richarville;395;11;406
11;Île-de-France;91;2;15;521;Ris-Orangis;29589;180;29769
11;Île-de-France;91;1;05;525;Roinville;1366;25;1391
11;Île-de-France;91;1;08;526;Roinvilliers;107;1;108
11;Île-de-France;91;1;08;533;Saclas;1832;24;1856
11;Île-de-France;91;3;10;534;Saclay;4098;55;4153
11;Île-de-France;91;3;10;538;Saint-Aubin;703;20;723
11;Île-de-France;91;1;05;540;Saint-Chéron;5134;77;5211
11;Île-de-France;91;1;08;544;Saint-Cyr-la-Rivière;517;9;526
11;Île-de-France;91;1;05;546;Saint-Cyr-sous-Dourdan;957;22;979
11;Île-de-France;91;1;08;547;Saint-Escobille;534;18;552
11;Île-de-France;91;3;01;552;Saint-Germain-lès-Arpajon;10877;76;10953
11;Île-de-France;91;2;06;553;Saint-Germain-lès-Corbeil;7484;97;7581
11;Île-de-France;91;1;08;556;Saint-Hilaire;408;9;417
11;Île-de-France;91;3;18;560;Saint-Jean-de-Beauregard;461;7;468
11;Île-de-France;91;3;05;568;Saint-Maurice-Montcouronne;1555;37;1592
11;Île-de-France;91;3;03;570;Saint-Michel-sur-Orge;19965;145;20110
11;Île-de-France;91;2;07;573;Saint-Pierre-du-Perray;10930;107;11037
11;Île-de-France;91;1;05;578;Saint-Sulpice-de-Favières;286;5;291
11;Île-de-France;91;3;03;579;Saint-Vrain;3059;52;3111
11;Île-de-France;91;1;01;581;Saint-Yon;901;10;911
11;Île-de-France;91;3;16;549;Sainte-Geneviève-des-Bois;36015;310;36325
11;Île-de-France;91;2;07;577;Saintry-sur-Seine;5758;65;5823
11;Île-de-France;91;3;11;587;Saulx-les-Chartreux;6240;54;6294
11;Île-de-France;91;3;17;589;Savigny-sur-Orge;36734;244;36978
11;Île-de-France;91;1;05;593;Sermaise;1611;39;1650
11;Île-de-France;91;2;13;599;Soisy-sur-École;1276;23;1299
11;Île-de-France;91;2;06;600;Soisy-sur-Seine;7235;138;7373
11;Île-de-France;91;1;05;602;Souzy-la-Briche;438;9;447
11;Île-de-France;91;2;07;617;Tigery;4209;75;4284
11;Île-de-France;91;1;01;619;Torfou;273;10;283
11;Île-de-France;91;3;18;692;Les Ulis;24764;147;24911
11;Île-de-France;91;1;05;630;Le Val-Saint-Germain;1492;32;1524
11;Île-de-France;91;1;08;629;Valpuiseaux;614;12;626
11;Île-de-France;91;2;07;631;Varennes-Jarcy;2307;31;2338
11;Île-de-France;91;3;05;634;Vaugrigneuse;1321;30;1351
11;Île-de-France;91;3;10;635;Vauhallan;2072;32;2104
11;Île-de-France;91;1;08;639;Vayres-sur-Essonne;945;67;1012
11;Île-de-France;91;3;10;645;Verrières-le-Buisson;14941;360;15301
11;Île-de-France;91;2;15;648;Vert-le-Grand;2270;27;2297
11;Île-de-France;91;2;15;649;Vert-le-Petit;2800;38;2838
11;Île-de-France;91;1;13;654;Videlles;599;17;616
11;Île-de-France;91;2;19;657;Vigneux-sur-Seine;31463;184;31647
11;Île-de-France;91;2;04;659;Villabé;5491;42;5533
11;Île-de-France;91;3;11;665;La Ville-du-Bois;7970;65;8035
11;Île-de-France;91;3;18;661;Villebon-sur-Yvette;10546;165;10711
11;Île-de-France;91;1;05;662;Villeconin;731;22;753
11;Île-de-France;91;3;18;666;Villejust;2405;18;2423
11;Île-de-France;91;3;16;667;Villemoisson-sur-Orge;7038;90;7128
11;Île-de-France;91;1;08;671;Villeneuve-sur-Auvers;611;7;618
11;Île-de-France;91;3;10;679;Villiers-le-Bâcle;1223;17;1240
11;Île-de-France;91;3;16;685;Villiers-sur-Orge;4592;39;4631
11;Île-de-France;91;2;20;687;Viry-Châtillon;30706;212;30918
11;Île-de-France;91;3;17;689;Wissous;7301;70;7371
11;Île-de-France;91;2;21;691;Yerres;29338;208;29546
11;Île-de-France;92;1;01;002;Antony;62858;816;63674
11;Île-de-France;92;2;95;004;Asnières-sur-Seine;85946;659;86605
11;Île-de-France;92;1;03;007;Bagneux;40812;134;40946
11;Île-de-France;92;2;11;009;Bois-Colombes;28468;238;28706
11;Île-de-France;92;3;96;012;Boulogne-Billancourt;121334;1243;122577
11;Île-de-France;92;1;03;014;Bourg-la-Reine;20769;351;21120
11;Île-de-France;92;1;06;019;Châtenay-Malabry;34170;357;34527
11;Île-de-France;92;1;07;020;Châtillon;37010;293;37303
11;Île-de-France;92;3;17;022;Chaville;20702;310;21012
11;Île-de-France;92;1;08;023;Clamart;52926;503;53429
11;Île-de-France;92;2;09;024;Clichy;62485;258;62743
11;Île-de-France;92;2;97;025;Colombes;86052;581;86633
11;Île-de-France;92;2;98;026;Courbevoie;82198;658;82856
11;Île-de-France;92;1;07;032;Fontenay-aux-Roses;25342;236;25578
11;Île-de-France;92;2;23;033;Garches;17762;435;18197
11;Île-de-France;92;2;11;035;La Garenne-Colombes;29430;245;29675
11;Île-de-France;92;2;14;036;Gennevilliers;47702;219;47921
11;Île-de-France;92;3;15;040;Issy-les-Moulineaux;68260;720;68980
11;Île-de-France;92;2;16;044;Levallois-Perret;65817;573;66390
11;Île-de-France;92;1;18;046;Malakoff;30711;200;30911
11;Île-de-France;92;3;23;047;Marnes-la-Coquette;1792;62;1854
11;Île-de-France;92;3;17;048;Meudon;45748;682;46430
11;Île-de-France;92;1;18;049;Montrouge;48734;231;48965
11;Île-de-France;92;2;99;050;Nanterre;96807;646;97453
11;Île-de-France;92;2;21;051;Neuilly-sur-Seine;59940;990;60930
11;Île-de-France;92;1;06;060;Le Plessis-Robinson;29665;154;29819
11;Île-de-France;92;2;13;062;Puteaux;44837;281;45118
11;Île-de-France;92;2;22;063;Rueil-Malmaison;77986;1469;79455
11;Île-de-France;92;2;23;064;Saint-Cloud;30038;598;30636
11;Île-de-France;92;1;06;071;Sceaux;19606;369;19975
11;Île-de-France;92;3;05;072;Sèvres;23251;387;23638
11;Île-de-France;92;2;20;073;Suresnes;48763;494;49257
11;Île-de-France;92;3;08;075;Vanves;27466;278;27744
11;Île-de-France;92;2;23;076;Vaucresson;8660;325;8985
11;Île-de-France;92;3;23;077;Ville-d'Avray;11050;295;11345
11;Île-de-France;92;2;14;078;Villeneuve-la-Garenne;24023;89;24112
11;Île-de-France;93;3;01;001;Aubervilliers;87572;190;87762
11;Île-de-France;93;2;02;005;Aulnay-sous-Bois;86278;405;86683
11;Île-de-France;93;1;03;006;Bagnolet;35442;104;35546
11;Île-de-France;93;2;04;007;Le Blanc-Mesnil;57150;167;57317
11;Île-de-France;93;1;95;008;Bobigny;54272;164;54436
11;Île-de-France;93;1;06;010;Bondy;54055;152;54207
11;Île-de-France;93;2;07;013;Le Bourget;16139;44;16183
11;Île-de-France;93;2;11;014;Clichy-sous-Bois;28992;93;29085
11;Île-de-France;93;2;20;015;Coubron;4866;41;4907
11;Île-de-France;93;3;07;027;La Courneuve;43946;127;44073
11;Île-de-France;93;2;96;029;Drancy;72109;282;72391
11;Île-de-France;93;2;07;030;Dugny;10757;41;10798
11;Île-de-France;93;3;97;031;Épinay-sur-Seine;54771;157;54928
11;Île-de-France;93;2;10;032;Gagny;39618;198;39816
11;Île-de-France;93;2;14;033;Gournay-sur-Marne;6878;61;6939
11;Île-de-France;93;3;18;039;L' Île-Saint-Denis;8012;40;8052
11;Île-de-France;93;1;03;045;Les Lilas;23402;131;23533
11;Île-de-France;93;2;11;046;Livry-Gargan;45012;209;45221
11;Île-de-France;93;2;20;047;Montfermeil;27201;124;27325
11;Île-de-France;93;1;98;048;Montreuil;109914;551;110465
11;Île-de-France;93;2;21;049;Neuilly-Plaisance;20915;128;21043
11;Île-de-France;93;2;10;050;Neuilly-sur-Marne;35680;120;35800
11;Île-de-France;93;2;14;051;Noisy-le-Grand;68126;385;68511
11;Île-de-France;93;1;05;053;Noisy-le-Sec;44223;130;44353
11;Île-de-France;93;1;15;055;Pantin;59060;177;59237
11;Île-de-France;93;2;06;057;Les Pavillons-sous-Bois;23960;97;24057
11;Île-de-France;93;3;09;059;Pierrefitte-sur-Seine;30828;46;30874
11;Île-de-France;93;1;15;061;Le Pré-Saint-Gervais;17485;72;17557
11;Île-de-France;93;2;21;062;Le Raincy;14708;195;14903
11;Île-de-France;93;1;03;063;Romainville;28536;79;28615
11;Île-de-France;93;2;12;064;Rosny-sous-Bois;46043;177;46220
11;Île-de-France;93;3;99;066;Saint-Denis;112091;891;112982
11;Île-de-France;93;3;18;070;Saint-Ouen-sur-Seine;50670;127;50797
11;Île-de-France;93;2;19;071;Sevran;51225;171;51396
11;Île-de-France;93;3;17;072;Stains;38666;77;38743
11;Île-de-France;93;2;20;073;Tremblay-en-France;36230;159;36389
11;Île-de-France;93;2;20;074;Vaujours;7003;87;7090
11;Île-de-France;93;2;21;077;Villemomble;30005;182;30187
11;Île-de-France;93;2;19;078;Villepinte;37280;82;37362
11;Île-de-France;93;3;09;079;Villetaneuse;13557;76;13633
11;Île-de-France;94;3;15;001;Ablon-sur-Seine;5818;27;5845
11;Île-de-France;94;1;01;002;Alfortville;44287;159;44446
11;Île-de-France;94;3;02;003;Arcueil;21721;124;21845
11;Île-de-France;94;1;16;004;Boissy-Saint-Léger;16487;54;16541
11;Île-de-France;94;1;18;011;Bonneuil-sur-Marne;18045;72;18117
11;Île-de-France;94;2;22;015;Bry-sur-Marne;16919;196;17115
11;Île-de-France;94;3;02;016;Cachan;30884;364;31248
11;Île-de-France;94;2;93;017;Champigny-sur-Marne;77039;342;77381
11;Île-de-France;94;2;05;018;Charenton-le-Pont;30053;202;30255
11;Île-de-France;94;1;04;019;Chennevières-sur-Marne;18142;115;18257
11;Île-de-France;94;3;19;021;Chevilly-Larue;19863;67;19930
11;Île-de-France;94;3;06;022;Choisy-le-Roi;46154;212;46366
11;Île-de-France;94;1;94;028;Créteil;92265;472;92737
11;Île-de-France;94;2;09;033;Fontenay-sous-Bois;52256;429;52685
11;Île-de-France;94;3;10;034;Fresnes;28230;112;28342
11;Île-de-France;94;3;12;037;Gentilly;18577;108;18685
11;Île-de-France;94;3;10;038;L' Haÿ-les-Roses;31417;172;31589
11;Île-de-France;94;3;11;041;Ivry-sur-Seine;63309;253;63562
11;Île-de-France;94;2;05;042;Joinville-le-Pont;19516;157;19673
11;Île-de-France;94;3;12;043;Le Kremlin-Bicêtre;24850;119;24969
11;Île-de-France;94;1;21;044;Limeil-Brévannes;27684;112;27796
11;Île-de-France;94;2;13;046;Maisons-Alfort;55899;289;56188
11;Île-de-France;94;1;16;047;Mandres-les-Roses;4766;48;4814
11;Île-de-France;94;1;16;048;Marolles-en-Brie;4839;105;4944
11;Île-de-France;94;2;95;052;Nogent-sur-Marne;32922;224;33146
11;Île-de-France;94;1;16;053;Noiseau;4622;42;4664
11;Île-de-France;94;3;15;054;Orly;23853;177;24030
11;Île-de-France;94;1;18;055;Ormesson-sur-Marne;10403;89;10492
11;Île-de-France;94;1;16;056;Périgny;2672;24;2696
11;Île-de-France;94;2;14;058;Le Perreux-sur-Marne;33793;304;34097
11;Île-de-France;94;1;22;059;Le Plessis-Trévise;20025;79;20104
11;Île-de-France;94;1;16;060;La Queue-en-Brie;11909;131;12040
11;Île-de-France;94;3;19;065;Rungis;5705;67;5772
11;Île-de-France;94;2;23;067;Saint-Mandé;22248;198;22446
11;Île-de-France;94;2;96;068;Saint-Maur-des-Fossés;75298;916;76214
11;Île-de-France;94;2;05;069;Saint-Maurice;14001;115;14116
11;Île-de-France;94;1;16;070;Santeny;4045;61;4106
11;Île-de-France;94;1;18;071;Sucy-en-Brie;26974;249;27223
11;Île-de-France;94;3;19;073;Thiais;29806;222;30028
11;Île-de-France;94;3;21;074;Valenton;14837;50;14887
11;Île-de-France;94;1;16;075;Villecresnes;11119;62;11181
11;Île-de-France;94;3;20;076;Villejuif;54964;248;55212
11;Île-de-France;94;3;15;077;Villeneuve-le-Roi;21214;94;21308
11;Île-de-France;94;3;97;078;Villeneuve-Saint-Georges;34607;104;34711
11;Île-de-France;94;2;22;079;Villiers-sur-Marne;28592;117;28709
11;Île-de-France;94;2;98;080;Vincennes;49635;448;50083
11;Île-de-France;94;3;99;081;Vitry-sur-Seine;94649;456;95105
11;Île-de-France;95;3;16;002;Ableiges;1142;14;1156
11;Île-de-France;95;3;20;008;Aincourt;901;12;913
11;Île-de-France;95;3;20;011;Ambleville;379;3;382
11;Île-de-France;95;3;20;012;Amenucourt;208;6;214
11;Île-de-France;95;2;15;014;Andilly;2581;54;2635
11;Île-de-France;95;1;98;018;Argenteuil;110213;553;110766
11;Île-de-France;95;2;11;019;Arnouville;14329;80;14409
11;Île-de-France;95;3;16;023;Arronville;647;3;650
11;Île-de-France;95;3;20;024;Arthies;274;5;279
11;Île-de-France;95;2;14;026;Asnières-sur-Oise;2795;37;2832
11;Île-de-France;95;2;09;028;Attainville;1693;8;1701
11;Île-de-France;95;3;17;039;Auvers-sur-Oise;6860;103;6963
11;Île-de-France;95;3;20;040;Avernes;855;14;869
11;Île-de-France;95;2;07;042;Baillet-en-France;1928;15;1943
11;Île-de-France;95;3;20;046;Banthelu;151;2;153
11;Île-de-France;95;1;19;051;Beauchamp;8675;94;8769
11;Île-de-France;95;3;14;052;Beaumont-sur-Oise;9555;105;9660
11;Île-de-France;95;3;16;054;Le Bellay-en-Vexin;223;5;228
11;Île-de-France;95;2;09;055;Bellefontaine;481;3;484
11;Île-de-France;95;2;09;056;Belloy-en-France;2211;9;2220
11;Île-de-France;95;3;14;058;Bernes-sur-Oise;2718;24;2742
11;Île-de-France;95;3;16;059;Berville;351;3;354
11;Île-de-France;95;1;19;060;Bessancourt;7528;58;7586
11;Île-de-France;95;3;07;061;Béthemont-la-Forêt;413;2;415
11;Île-de-France;95;1;03;063;Bezons;30484;124;30608
11;Île-de-France;95;3;05;074;Boisemont;782;14;796
11;Île-de-France;95;3;16;078;Boissy-l'Aillerie;1838;31;1869
11;Île-de-France;95;2;21;088;Bonneuil-en-France;1101;2;1103
11;Île-de-France;95;2;07;091;Bouffémont;6453;56;6509
11;Île-de-France;95;2;21;094;Bouqueval;304;3;307
11;Île-de-France;95;3;20;101;Bray-et-Lû;961;12;973
11;Île-de-France;95;3;16;102;Bréançon;389;8;397
11;Île-de-France;95;3;16;110;Brignancourt;210;3;213
11;Île-de-France;95;3;14;116;Bruyères-sur-Oise;4326;34;4360
11;Île-de-France;95;3;20;119;Buhy;323;3;326
11;Île-de-France;95;3;17;120;Butry-sur-Oise;2274;24;2298
11;Île-de-France;95;3;99;127;Cergy;66322;516;66838
11;Île-de-France;95;3;14;134;Champagne-sur-Oise;5024;42;5066
11;Île-de-France;95;3;20;139;La Chapelle-en-Vexin;324;5;329
11;Île-de-France;95;3;20;141;Charmont;36;0;36
11;Île-de-France;95;3;16;142;Chars;2078;17;2095
11;Île-de-France;95;2;09;144;Châtenay-en-France;76;1;77
11;Île-de-France;95;2;09;149;Chaumontel;3251;54;3305
11;Île-de-France;95;3;20;150;Chaussy;586;15;601
11;Île-de-France;95;3;07;151;Chauvry;298;5;303
11;Île-de-France;95;2;12;154;Chennevières-lès-Louvres;305;3;308
11;Île-de-France;95;3;20;157;Chérence;127;4;131
11;Île-de-France;95;3;20;166;Cléry-en-Vexin;462;7;469
11;Île-de-France;95;3;16;169;Commeny;493;3;496
11;Île-de-France;95;3;20;170;Condécourt;551;1;552
11;Île-de-France;95;1;10;176;Cormeilles-en-Parisis;24681;211;24892
11;Île-de-France;95;3;16;177;Cormeilles-en-Vexin;1367;15;1382
11;Île-de-France;95;3;16;181;Courcelles-sur-Viosne;278;3;281
11;Île-de-France;95;3;20;183;Courdimanche;6650;110;6760
11;Île-de-France;95;2;06;197;Deuil-la-Barre;22165;181;22346
11;Île-de-France;95;2;07;199;Domont;15418;193;15611
11;Île-de-France;95;1;08;203;Eaubonne;25139;315;25454
11;Île-de-France;95;2;09;205;Écouen;7145;44;7189
11;Île-de-France;95;2;15;210;Enghien-les-Bains;11285;154;11439
11;Île-de-France;95;3;16;211;Ennery;2426;24;2450
11;Île-de-France;95;2;12;212;Épiais-lès-Louvres;107;0;107
11;Île-de-France;95;3;16;213;Épiais-Rhus;615;15;630
11;Île-de-France;95;2;09;214;Épinay-Champlâtreux;69;0;69
11;Île-de-France;95;3;05;218;Éragny;18162;121;18283
11;Île-de-France;95;1;08;219;Ermont;29079;235;29314
11;Île-de-France;95;2;09;229;Ézanville;9719;57;9776
11;Île-de-France;95;2;09;241;Fontenay-en-Parisis;1988;16;2004
11;Île-de-France;95;2;09;250;Fosses;9737;61;9798
11;Île-de-France;95;1;10;252;Franconville;37010;169;37179
11;Île-de-France;95;3;20;253;Frémainville;510;11;521
11;Île-de-France;95;3;16;254;Frémécourt;565;7;572
11;Île-de-France;95;1;17;256;Frépillon;3339;44;3383
11;Île-de-France;95;1;13;257;La Frette-sur-Seine;4697;41;4738
11;Île-de-France;95;3;17;258;Frouville;354;8;362
11;Île-de-France;95;2;11;268;Garges-lès-Gonesse;42956;95;43051
11;Île-de-France;95;3;20;270;Genainville;542;19;561
11;Île-de-France;95;3;16;271;Génicourt;523;9;532
11;Île-de-France;95;2;21;277;Gonesse;26019;120;26139
11;Île-de-France;95;2;12;280;Goussainville;30642;142;30784
11;Île-de-France;95;3;16;282;Gouzangrez;163;1;164
11;Île-de-France;95;3;16;287;Grisy-les-Plâtres;696;12;708
11;Île-de-France;95;2;06;288;Groslay;8545;52;8597
11;Île-de-France;95;3;20;295;Guiry-en-Vexin;145;3;148
11;Île-de-France;95;3;16;298;Haravilliers;555;7;562
11;Île-de-France;95;3;20;301;Haute-Isle;282;6;288
11;Île-de-France;95;3;16;303;Le Heaulme;208;1;209
11;Île-de-France;95;3;17;304;Hédouville;282;2;284
11;Île-de-France;95;1;13;306;Herblay-sur-Seine;30095;220;30315
11;Île-de-France;95;3;17;308;Hérouville-en-Vexin;590;12;602
11;Île-de-France;95;3;20;309;Hodent;210;3;213
11;Île-de-France;95;3;14;313;L' Isle-Adam;11986;215;12201
11;Île-de-France;95;2;09;316;Jagny-sous-Bois;267;2;269
11;Île-de-France;95;3;05;323;Jouy-le-Moutier;16214;129;16343
11;Île-de-France;95;3;17;328;Labbeville;634;7;641
11;Île-de-France;95;2;09;331;Lassy;183;3;186
11;Île-de-France;95;3;16;341;Livilliers;385;9;394
11;Île-de-France;95;3;20;348;Longuesse;551;6;557
11;Île-de-France;95;2;12;351;Louvres;10478;79;10557
11;Île-de-France;95;2;09;352;Luzarches;4637;77;4714
11;Île-de-France;95;2;09;353;Maffliers;1839;17;1856
11;Île-de-France;95;3;20;355;Magny-en-Vexin;5750;57;5807
11;Île-de-France;95;2;09;365;Mareil-en-France;702;8;710
11;Île-de-France;95;2;15;369;Margency;2859;50;2909
11;Île-de-France;95;3;16;370;Marines;3459;52;3511
11;Île-de-France;95;2;12;371;Marly-la-Ville;5657;43;5700
11;Île-de-France;95;3;20;379;Maudétour-en-Vexin;188;2;190
11;Île-de-France;95;3;16;387;Menouville;61;0;61
11;Île-de-France;95;3;20;388;Menucourt;5753;51;5804
11;Île-de-France;95;3;17;392;Mériel;5124;52;5176
11;Île-de-France;95;3;17;394;Méry-sur-Oise;9900;97;9997
11;Île-de-France;95;2;09;395;Le Mesnil-Aubry;910;9;919
11;Île-de-France;95;2;07;409;Moisselles;1308;3;1311
11;Île-de-France;95;3;16;422;Montgeroult;356;3;359
11;Île-de-France;95;1;13;424;Montigny-lès-Cormeilles;21638;110;21748
11;Île-de-France;95;2;15;426;Montlignon;2963;75;3038
11;Île-de-France;95;2;06;427;Montmagny;14145;64;14209
11;Île-de-France;95;2;15;428;Montmorency;21647;250;21897
11;Île-de-France;95;3;20;429;Montreuil-sur-Epte;411;10;421
11;Île-de-France;95;2;07;430;Montsoult;3558;35;3593
11;Île-de-France;95;3;14;436;Mours;1609;9;1618
11;Île-de-France;95;3;16;438;Moussy;125;2;127
11;Île-de-France;95;3;14;445;Nerville-la-Forêt;705;3;708
11;Île-de-France;95;3;17;446;Nesles-la-Vallée;1824;33;1857
11;Île-de-France;95;3;16;447;Neuilly-en-Vexin;220;4;224
11;Île-de-France;95;3;05;450;Neuville-sur-Oise;2046;28;2074
11;Île-de-France;95;3;14;452;Nointel;839;7;846
11;Île-de-France;95;3;14;456;Noisy-sur-Oise;659;4;663
11;Île-de-France;95;3;16;459;Nucourt;704;15;719
11;Île-de-France;95;3;20;462;Omerville;324;8;332
11;Île-de-France;95;3;04;476;Osny;17402;239;17641
11;Île-de-France;95;3;14;480;Parmain;5575;112;5687
11;Île-de-France;95;3;16;483;Le Perchay;537;4;541
11;Île-de-France;95;3;14;487;Persan;13386;54;13440
11;Île-de-France;95;1;19;488;Pierrelaye;8908;38;8946
11;Île-de-France;95;2;07;489;Piscop;670;69;739
11;Île-de-France;95;1;07;491;Le Plessis-Bouchard;8488;74;8562
11;Île-de-France;95;2;09;492;Le Plessis-Gassot;70;0;70
11;Île-de-France;95;2;09;493;Le Plessis-Luzarches;130;1;131
11;Île-de-France;95;3;16;500;Pontoise;31422;570;31992
11;Île-de-France;95;3;14;504;Presles;3921;51;3972
11;Île-de-France;95;2;09;509;Puiseux-en-France;3543;32;3575
11;Île-de-France;95;3;04;510;Puiseux-Pontoise;593;11;604
11;Île-de-France;95;3;20;523;La Roche-Guyon;479;37;516
11;Île-de-France;95;2;21;527;Roissy-en-France;2858;26;2884
11;Île-de-France;95;3;14;529;Ronquerolles;870;8;878
11;Île-de-France;95;3;20;535;Sagy;1106;26;1132
11;Île-de-France;95;2;06;539;Saint-Brice-sous-Forêt;14875;78;14953
11;Île-de-France;95;3;20;541;Saint-Clair-sur-Epte;996;14;1010
11;Île-de-France;95;3;20;543;Saint-Cyr-en-Arthies;242;1;243
11;Île-de-France;95;3;20;554;Saint-Gervais;908;19;927
11;Île-de-France;95;2;01;555;Saint-Gratien;20893;167;21060
11;Île-de-France;95;1;07;563;Saint-Leu-la-Forêt;15829;172;16001
11;Île-de-France;95;2;09;566;Saint-Martin-du-Tertre;2737;24;2761
11;Île-de-France;95;3;17;572;Saint-Ouen-l'Aumône;24385;113;24498
11;Île-de-France;95;2;07;574;Saint-Prix;7123;108;7231
11;Île-de-France;95;2;12;580;Saint-Witz;2381;104;2485
11;Île-de-France;95;1;01;582;Sannois;26484;337;26821
11;Île-de-France;95;3;16;584;Santeuil;664;7;671
11;Île-de-France;95;2;18;585;Sarcelles;58811;252;59063
11;Île-de-France;95;3;20;592;Seraincourt;1295;14;1309
11;Île-de-France;95;2;09;594;Seugy;1012;14;1026
11;Île-de-France;95;2;15;598;Soisy-sous-Montmorency;18243;163;18406
11;Île-de-France;95;2;12;604;Survilliers;4198;25;4223
11;Île-de-France;95;1;19;607;Taverny;26576;189;26765
11;Île-de-France;95;3;20;610;Théméricourt;298;7;305
11;Île-de-France;95;3;16;611;Theuville;47;0;47
11;Île-de-France;95;2;21;612;Le Thillay;4534;21;4555
11;Île-de-France;95;3;16;625;Us;1331;12;1343
11;Île-de-France;95;3;16;627;Vallangoujard;605;13;618
11;Île-de-France;95;3;17;628;Valmondois;1205;25;1230
11;Île-de-France;95;2;21;633;Vaudherland;99;0;99
11;Île-de-France;95;3;20;637;Vauréal;16575;214;16789
11;Île-de-France;95;2;12;641;Vémars;2684;22;2706
11;Île-de-France;95;3;20;651;Vétheuil;871;19;890
11;Île-de-France;95;2;09;652;Viarmes;5220;74;5294
11;Île-de-France;95;3;20;656;Vienne-en-Arthies;397;6;403
11;Île-de-France;95;3;20;658;Vigny;1087;22;1109
11;Île-de-France;95;2;09;660;Villaines-sous-Bois;782;7;789
11;Île-de-France;95;2;12;675;Villeron;1253;12;1265
11;Île-de-France;95;3;20;676;Villers-en-Arthies;497;10;507
11;Île-de-France;95;3;14;678;Villiers-Adam;861;11;872
11;Île-de-France;95;2;21;680;Villiers-le-Bel;28041;116;28157
11;Île-de-France;95;2;09;682;Villiers-le-Sec;187;3;190
11;Île-de-France;95;3;20;690;Wy-dit-Joli-Village;332;7;339
01;Guadeloupe;971;2;93;101;Les Abymes;53082;508;53590
01;Guadeloupe;971;2;14;102;Anse-Bertrand;4136;65;4201
01;Guadeloupe;971;1;94;103;Baie-Mahault;31193;498;31691
01;Guadeloupe;971;1;21;104;Baillif;5404;95;5499
01;Guadeloupe;971;1;06;105;Basse-Terre;10046;245;10291
01;Guadeloupe;971;1;95;106;Bouillante;6935;111;7046
01;Guadeloupe;971;1;07;107;Capesterre-Belle-Eau;18131;173;18304
01;Guadeloupe;971;2;10;108;Capesterre-de-Marie-Galante;3293;43;3336
01;Guadeloupe;971;1;18;111;Deshaies;4033;64;4097
01;Guadeloupe;971;2;16;110;La Désirade;1432;34;1466
01;Guadeloupe;971;2;96;113;Le Gosier;26692;348;27040
01;Guadeloupe;971;1;20;109;Gourbeyre;7778;184;7962
01;Guadeloupe;971;1;13;114;Goyave;7588;137;7725
01;Guadeloupe;971;2;10;112;Grand-Bourg;4941;134;5075
01;Guadeloupe;971;1;09;115;Lamentin;16536;299;16835
01;Guadeloupe;971;2;12;116;Morne-à-l'Eau;16875;199;17074
01;Guadeloupe;971;2;11;117;Le Moule;22315;274;22589
01;Guadeloupe;971;1;97;118;Petit-Bourg;24522;416;24938
01;Guadeloupe;971;2;14;119;Petit-Canal;8212;123;8335
01;Guadeloupe;971;2;15;120;Pointe-à-Pitre;15410;110;15520
01;Guadeloupe;971;1;18;121;Pointe-Noire;6069;139;6208
01;Guadeloupe;971;2;14;122;Port-Louis;5635;70;5705
01;Guadeloupe;971;1;06;124;Saint-Claude;10659;269;10928
01;Guadeloupe;971;2;16;125;Saint-François;12348;170;12518
01;Guadeloupe;971;2;10;126;Saint-Louis;2421;54;2475
01;Guadeloupe;971;2;98;128;Sainte-Anne;23767;267;24034
01;Guadeloupe;971;1;99;129;Sainte-Rose;18650;298;18948
01;Guadeloupe;971;1;20;130;Terre-de-Bas;1011;24;1035
01;Guadeloupe;971;1;20;131;Terre-de-Haut;1526;51;1577
01;Guadeloupe;971;1;20;132;Trois-Rivières;7991;149;8140
01;Guadeloupe;971;1;20;133;Vieux-Fort;1844;31;1875
01;Guadeloupe;971;1;21;134;Vieux-Habitants;7154;190;7344
02;Martinique;972;2;null;201;L' Ajoupa-Bouillon;1815;31;1846
02;Martinique;972;3;null;202;Les Anses-d'Arlet;3541;53;3594
02;Martinique;972;2;null;203;Basse-Pointe;2923;43;2966
02;Martinique;972;4;null;234;Bellefontaine;1770;125;1895
02;Martinique;972;4;null;204;Le Carbet;3498;48;3546
02;Martinique;972;4;null;205;Case-Pilote;4454;68;4522
02;Martinique;972;3;null;206;Le Diamant;5576;74;5650
02;Martinique;972;3;null;207;Ducos;17270;272;17542
02;Martinique;972;4;null;208;Fonds-Saint-Denis;700;12;712
02;Martinique;972;1;null;209;Fort-de-France;78126;929;79055
02;Martinique;972;3;null;210;Le François;16423;227;16650
02;Martinique;972;2;null;211;Grand'Rivière;666;12;678
02;Martinique;972;2;null;212;Gros-Morne;9755;89;9844
02;Martinique;972;1;null;213;Le Lamentin;40581;622;41203
02;Martinique;972;2;null;214;Le Lorrain;6824;76;6900
02;Martinique;972;2;null;215;Macouba;1062;8;1070
02;Martinique;972;2;null;216;Le Marigot;3156;49;3205
02;Martinique;972;3;null;217;Le Marin;8771;144;8915
02;Martinique;972;4;null;218;Le Morne-Rouge;4955;54;5009
02;Martinique;972;4;null;233;Le Morne-Vert;1825;26;1851
02;Martinique;972;4;null;219;Le Prêcheur;1252;24;1276
02;Martinique;972;3;null;220;Rivière-Pilote;11972;143;12115
02;Martinique;972;3;null;221;Rivière-Salée;11857;237;12094
02;Martinique;972;2;null;222;Le Robert;22429;185;22614
02;Martinique;972;3;null;223;Saint-Esprit;9660;95;9755
02;Martinique;972;1;null;224;Saint-Joseph;16152;250;16402
02;Martinique;972;4;null;225;Saint-Pierre;4122;55;4177
02;Martinique;972;3;null;226;Sainte-Anne;4371;58;4429
02;Martinique;972;3;null;227;Sainte-Luce;9651;212;9863
02;Martinique;972;2;null;228;Sainte-Marie;15571;160;15731
02;Martinique;972;1;null;229;Schœlcher;19847;222;20069
02;Martinique;972;2;null;230;La Trinité;12232;156;12388
02;Martinique;972;3;null;231;Les Trois-Îlets;7290;125;7415
02;Martinique;972;3;null;232;Le Vauclin;8686;95;8781
03;Guyane;973;2;null;360;Apatou;9381;9;9390
03;Guyane;973;2;null;361;Awala-Yalimapo;1430;12;1442
03;Guyane;973;1;null;356;Camopi;1834;23;1857
03;Guyane;973;1;null;302;Cayenne;63652;366;64018
03;Guyane;973;2;null;357;Grand-Santi;8698;5;8703
03;Guyane;973;1;null;303;Iracoubo;1773;20;1793
03;Guyane;973;1;null;304;Kourou;24959;252;25211
03;Guyane;973;1;null;305;Macouria;15602;174;15776
03;Guyane;973;2;null;306;Mana;11234;167;11401
03;Guyane;973;2;null;353;Maripasoula;11994;125;12119
03;Guyane;973;1;null;307;Matoury;32942;236;33178
03;Guyane;973;1;null;313;Montsinéry-Tonnegrande;2772;17;2789
03;Guyane;973;1;null;314;Ouanary;220;1;221
03;Guyane;973;2;null;362;Papaichton;6212;19;6231
03;Guyane;973;1;null;301;Régina;865;26;891
03;Guyane;973;1;null;309;Remire-Montjoly;26143;376;26519
03;Guyane;973;1;null;310;Roura;3390;56;3446
03;Guyane;973;1;null;358;Saint-Élie;216;1;217
03;Guyane;973;1;null;308;Saint-Georges;4188;89;4277
03;Guyane;973;2;null;311;Saint-Laurent-du-Maroni;45576;320;45896
03;Guyane;973;2;null;352;Saül;152;7;159
03;Guyane;973;1;null;312;Sinnamary;2895;43;2938
04;La Réunion;974;2;01;401;Les Avirons;11246;205;11451
04;La Réunion;974;3;06;402;Bras-Panon;12768;199;12967
04;La Réunion;974;2;16;424;Cilaos;5492;83;5575
04;La Réunion;974;2;16;403;Entre-Deux;6914;65;6979
04;La Réunion;974;2;01;404;L' Étang-Salé;14108;200;14308
04;La Réunion;974;2;22;405;Petite-Île;12308;122;12430
04;La Réunion;974;3;07;406;La Plaine-des-Palmistes;6568;97;6665
04;La Réunion;974;4;02;407;Le Port;33531;264;33795
04;La Réunion;974;4;03;408;La Possession;32633;401;33034
04;La Réunion;974;3;91;409;Saint-André;56747;460;57207
04;La Réunion;974;3;92;410;Saint-Benoît;37274;249;37523
04;La Réunion;974;1;93;411;Saint-Denis;150535;1462;151997
04;La Réunion;974;2;94;412;Saint-Joseph;37517;501;38018
04;La Réunion;974;4;95;413;Saint-Leu;34196;470;34666
04;La Réunion;974;2;96;414;Saint-Louis;53589;569;54158
04;La Réunion;974;4;97;415;Saint-Paul;103492;1339;104831
04;La Réunion;974;2;08;417;Saint-Philippe;5149;66;5215
04;La Réunion;974;2;98;416;Saint-Pierre;84961;907;85868
04;La Réunion;974;1;23;418;Sainte-Marie;33234;423;33657
04;La Réunion;974;3;08;419;Sainte-Rose;6296;76;6372
04;La Réunion;974;1;04;420;Sainte-Suzanne;23718;221;23939
04;La Réunion;974;3;06;421;Salazie;7224;74;7298
04;La Réunion;974;2;99;422;Le Tampon;79385;1001;80386
04;La Réunion;974;4;14;423;Les Trois-Bassins;7076;92;7168
